TGTGCCAGCAGCGGAACGGGGGGGCGGGGTACGGGTGAGCAGTTCTTC	CASSGTGGRGTGEQFF	TRBV9	TRBJ2-1
TGTGCCAGCAGCCAAGCCGTTAAAATGTGGGTGAACACTGAAGCTTTCTTT	CASSQAVKMWVNTEAFF	TRBV3-1	TRBJ1-1
TGCGCCAGCAGCCTCACGACAGCTCCTCAAGAGACCCAGTACTTC	CASSLTTAPQETQYF	TRBV4-1	TRBJ2-5
TGTGCCAGCAGTTACATTATGGGTCTAGGGGATACGCAGTATTTT	CASSYIMGLGDTQYF	TRBV6-3	TRBJ2-3
TGTGCCACCGACAGGGGGTTCAATCAGCCCCAGCATTTT	CATDRGFNQPQHF	TRBV12-4	TRBJ1-5
TGTGCCAGCTTTGGGGGCCCCCCGATGTTACAAGAGACCCAGTACTTC	CASFGGPPMLQETQYF	TRBV6-1	TRBJ2-5
TGTGCCACCAGTGGGGCGACAGGGTACGAGCAGTACTTC	CATSGATGYEQYF	TRBV24-1	TRBJ2-7
TGCAGTGCATGGGCGTACGAGCAGTACTTC	CSAWAYEQYF	TRBV20-1	TRBJ2-7
TGCAGTGCTCCCAGGGTCACCGAGCAGTACTTC	CSAPRVTEQYF	TRBV20-1	TRBJ2-7
TGCAGTGCACCGGGGGGCCGCAATCAGCCCCAGCATTTT	CSAPGGRNQPQHF	TRBV20-1	TRBJ1-5
TGTGCCACCAGCAGAGATGGGGGGTCACCCCTCCACTTT	CATSRDGGSPLHF	TRBV15	TRBJ1-6
TGTGCCAGCAGTTCCGGCGGTGAGACCCAGTACTTC	CASSSGGETQYF	TRBV28	TRBJ2-5
TGCAGTGCTACAGGGAATTCCTCACCCCTCCACTTT	CSATGNSSPLHF	TRBV20-1	TRBJ1-6
TGTGCCAGCAGCGTCAGGGATCTTGGCACTGAAGCTTTCTTT	CASSVRDLGTEAFF	TRBV7-9	TRBJ1-1
TGTGCCATCAGTGATCTCGCGGACAGGGAGGAAAAATCCTACGAGCAGTACTTC	CAISDLADREEKSYEQYF	TRBV10-3	TRBJ2-7
TGCGCCAGCAGCCCGAGGAACTTTTTAGGTGATTCCAATGAAAAACTGTTTTTT	CASSPRNFLGDSNEKLFF	TRBV4-1	TRBJ1-4
TGTGCCAGCAGCTGGCGCAGGGGTGGGACAACATTCTGGCCCTTTTTGCAGCCCCAGCATTTT	CASSWRRGGTTFWPFLQPQHF	TRBV7-9	TRBJ1-5
TGTGCCAGCAGTTGCAGGGAGGAAAAACTGTTTTTT	CASSCREEKLFF	TRBV25-1	TRBJ1-4
TGTGCCAGCAGTCGTAGGGGAGGGGACACAGATACGCAGTATTTT	CASSRRGGDTDTQYF	TRBV2	TRBJ2-3
TGCGCCAGCAGCTTGCCCCTACTGCGACAGGATCTAACTGGGGCCAACGTCCTGACTTTC	CASSLPLLRQDLTGANVLTF	TRBV5-1	TRBJ2-6
TGTGCCAGCAGCCCATGGAACAGACAGCCCCAGCATTTT	CASSPWNRQPQHF	TRBV5-4	TRBJ1-5
TGTGCCAGCAGCAGTATACGCTCCCAAGAGACCCAGTACTTC	CASSSIRSQETQYF	TRBV11-2	TRBJ2-5
TGTGCCAGCCGGATTCAGCCCCAGCATTTT	CASRIQPQHF	TRBV6-4	TRBJ1-5
TGCAGCGTTAAGAGGGGGGCCCGCGGGAAAAGCTCCTACAATGAGCAGTTCTTC	CSVKRGARGKSSYNEQFF	TRBV29-1	TRBJ2-1
TGTGCTAGTGGTTTGCCGGGACAGGGGGGGTGCTACGAGCAGTACTTC	CASGLPGQGGCYEQYF	TRBV12-5	TRBJ2-7
TGTGCCACCAAGACCCGGGACAGGGGGAGTATCCACACCATATATTTT	CATKTRDRGSIHTIYF	TRBV24-1	TRBJ1-3
TGTGCCAGCAGGCCGGCAGCAAACTACTCCTACGAGCAGTACTTC	CASRPAANYSYEQYF	TRBV2	TRBJ2-7
TGTGCTAGTGGTTTGGTACTGCAGGGGAGATACTTC	CASGLVLQGRYF	TRBV12-5	TRBJ2-4
TGTGCCACCAGTGTTCACGGGAAAGAGTTCCACGAAAAACTGTTTTTT	CATSVHGKEFHEKLFF	TRBV24-1	TRBJ1-4
TGTGCCAGCAGCCAAGTTCGTGAGGGCAACGAGCAGTACTTC	CASSQVREGNEQYF	TRBV3-1	TRBJ2-7
TGCAGTGCTGTGCGGGATGGAGATACGCAGTATTTT	CSAVRDGDTQYF	TRBV20-1	TRBJ2-3
TGTGCCAGTAGTATAGCAAGGCGGGTCTCCTACGAGCAGTACTTC	CASSIARRVSYEQYF	TRBV19	TRBJ2-7
TGTGCCAGCAGCCAAGTTAGGGACCAGGAGGAGGACCTGAACACTGAAGCTTTCTTT	CASSQVRDQEEDLNTEAFF	TRBV3-1	TRBJ1-1
TGTGCCAGCAGCCCTCGGCGGGACGAGTCCACTGAAGCTTTCTTT	CASSPRRDESTEAFF	TRBV7-3	TRBJ1-1
TGTGCCAGCAGTCTAGGCACTCCCTACGAGCAGTACTTC	CASSLGTPYEQYF	TRBV27	TRBJ2-7
TGCGCCAGCAGCCAAGATTCCGGGACGAACACTGAAGCTTTCTTT	CASSQDSGTNTEAFF	TRBV4-1	TRBJ1-1
TGCAGCGTTGAAGGCACAGGGCCGAATGAAAAACTGTTTTTT	CSVEGTGPNEKLFF	TRBV29-1	TRBJ1-4
TGTGCCAGCAGCCCCGCTCGGCCAGGGACTGGCTACACCTTC	CASSPARPGTGYTF	TRBV7-4	TRBJ1-2
TGTGCCAGCAGTGGGGGCTTGTCCTACGAGCAGTACTTC	CASSGGLSYEQYF	TRBV6-8	TRBJ2-7
TGCAGTGCTAGCCGGACTAGCGGGAAGTCTCCGTCCTACAATGAGCAGTTCTTC	CSASRTSGKSPSYNEQFF	TRBV20-1	TRBJ2-1
TGTGCCAGCAGAGACCTCGCCGGCAGCACAGATACGCAGTATTTT	CASRDLAGSTDTQYF	TRBV6-6	TRBJ2-3
TGTGCCAGCAGTAGTGGGGTGCAGGGGGGGTACCAAGAGACCCAGTACTTC	CASSSGVQGGYQETQYF	TRBV6-1	TRBJ2-5
TGTGCCACCAGTGATTTCGAAACAGGGGGTAATGAAAAACTGTTTTTT	CATSDFETGGNEKLFF	TRBV24-1	TRBJ1-4
TGTGCCACCGGTTACCCTACGGTTCAGCCCCAGCATTTT	CATGYPTVQPQHF	TRBV24-1	TRBJ1-5
TGTGCCAGCAGCTTAGAACAGTACCTTTGGGGGGTGGCCCAGTACTTC	CASSLEQYLWGVAQYF	TRBV7-9	TRBJ2-5
TGCGCCAGCGTGTTTACCGGGACAGCCGGTAAATTGAGCTACGAGCAGTACTTC	CASVFTGTAGKLSYEQYF	TRBV5-1	TRBJ2-7
TGTGCCAGCAGCGTAGATAAGGGGTGGGACCCGAAAGAGACCCAGTACTTC	CASSVDKGWDPKETQYF	TRBV9	TRBJ2-5
TGTGCCACGCTGGATAAAGTTACAGGGGCAACTAATGAAAAACTGTTTTTT	CATLDKVTGATNEKLFF	TRBV28	TRBJ1-4
TGCAGTGCTAGGGAGATGAACACTGAAGCTTTCTTT	CSAREMNTEAFF	TRBV20-1	TRBJ1-1
TGCGCCAGCAGCTTGGTCAAACCTTGTATCCAGGGGCCCGAAATTTCACCCCTCCACTTT	CASSLVKPCIQGPEISPLHF	TRBV5-1	TRBJ1-6
TGTGCCAGCAGCCAAGGGGCCTATAGGAGTACCTACAATGAGCAGTTCTTC	CASSQGAYRSTYNEQFF	TRBV4-2	TRBJ2-1
TGCGCCAGCAGCTTCCGTCGGAGCCCTCAGGGGGGCGGGGAGCTGTTTTTT	CASSFRRSPQGGGELFF	TRBV5-1	TRBJ2-2
TGCGCCAGCAGCCCCAGGCCCCCGGGACAGTCGGCTAATGAAAAACTGTTTTTT	CASSPRPPGQSANEKLFF	TRBV5-1	TRBJ1-4
TGTGCCAGCTCACCCTATCGGACTTCCTATTCCCAACGGGACAGGGGGGGGAACACTGAAGCTTTCTTT	CASSPYRTSYSQRDRGGNTEAFF	TRBV18	TRBJ1-1
TGTGCCGGAGGCCACTCCTACGAGCAGTACTTC	CAGGHSYEQYF	TRBV19	TRBJ2-7
TGTGCCACCAGTGCTAATCAACAGGGGGAGCGCATTTACGAGCAGTACTTC	CATSANQQGERIYEQYF	TRBV24-1	TRBJ2-7
TGCGCCAGCAGCACAAAGGGGTTGGGAGTGGAGACCCAGTACTTC	CASSTKGLGVETQYF	TRBV5-1	TRBJ2-5
TGCGCCAGCACCCCGACTAGCGGCGAAGAGACCCAGTACTTC	CASTPTSGEETQYF	TRBV10-1	TRBJ2-5
TGTGCCAGCAGCGCGGGGGCCCAATACGAGCAGTACTTC	CASSAGAQYEQYF	TRBV11-2	TRBJ2-7
TGTGCCAGCAGCTCAGAGGACAGTGTAGACTACGAGCAGTACTTC	CASSSEDSVDYEQYF	TRBV11-3	TRBJ2-7
TGTGCCAGCAGATTCATCCGGGGCGCAAAGCAGTACTTC	CASRFIRGAKQYF	TRBV28	TRBJ2-7
TGTGCCACCAGTGAACACCTCGGGACTAGCGGGGGGGCAGATACGCAGTATTTT	CATSEHLGTSGGADTQYF	TRBV24-1	TRBJ2-3
TGTGCCAGCAGCTTAGATAGACATCGGACTAGCGGGTTTCTCTCCTACGAGCAGTACTTC	CASSLDRHRTSGFLSYEQYF	TRBV11-3	TRBJ2-7
TGCAGTGCTAGGGTTGGACAGGGGTTGAACACTGAAGCTTTCTTT	CSARVGQGLNTEAFF	TRBV20-1	TRBJ1-1
TGCAGTATCATACCCCATCGGGTCGACGAGCAGTACTTC	CSIIPHRVDEQYF	TRBV20-1	TRBJ2-7
TGCGCCAGCAGCAGGGGAAGGCTAGACAATGAGCAGTTCTTC	CASSRGRLDNEQFF	TRBV5-1	TRBJ2-1
TGTGCCAGCAGCCCTATACGGGACAGGGGGCTCGAGCAGTACTTC	CASSPIRDRGLEQYF	TRBV14	TRBJ2-7
TGTGCCAGCAGCGTGCCTTACTTCGGGGGTGAAGCTTTCTTT	CASSVPYFGGEAFF	TRBV9	TRBJ1-1
TGTGCCACCGAACTCCCCGGGCAATCGTGCAATTCACCCCTCCACTTT	CATELPGQSCNSPLHF	TRBV24-1	TRBJ1-6
TGTGCCAGCAGCTTACGGGACACTCAAGGGACAGGGGGCCAAGAGACCCAGTACTTC	CASSLRDTQGTGGQETQYF	TRBV5-5	TRBJ2-5
TGTGCCAGCAGCCATGAGAATCAGCCCCAGCATTTT	CASSHENQPQHF	TRBV28	TRBJ1-5
TGCAGTGCTAGAGCTTCCCACAGGACTAGCGGGGTTCACACAGATACGCAGTATTTT	CSARASHRTSGVHTDTQYF	TRBV20-1	TRBJ2-3
TGTGCCAGCAGCCAACAGGGTTGGAACACTGAAGCTTTCTTT	CASSQQGWNTEAFF	TRBV3-1	TRBJ1-1
TGTGCCAGCAGTCTATGCCGAGCAGGGAGAGACGTATATGGCTACACCTTC	CASSLCRAGRDVYGYTF	TRBV6-1	TRBJ1-2
TGTGCCAGCAGCCCCTCCTGGACCCGGAAAGAGCAGTACTTC	CASSPSWTRKEQYF	TRBV11-2	TRBJ2-7
TGTGCCAGCAGTTACCCGCCGGGACAGGGCTCCTACGAGCAGTACTTC	CASSYPPGQGSYEQYF	TRBV6-2	TRBJ2-7
TGTGCCAGCAGCAATAGGCAGGGGGCGAAGGTGTCGGGTGAAGCTTTCTTT	CASSNRQGAKVSGEAFF	TRBV7-9	TRBJ1-1
TGTGCCACCAGCAGAGGGGGGACAGGGTTCACCTACGAGCAGTACTTC	CATSRGGTGFTYEQYF	TRBV15	TRBJ2-7
TGTGCCAGCAGTTTATCGCGGAAACGAGGGCTAAAAAACACCGGGGAGCTGTTTTTT	CASSLSRKRGLKNTGELFF	TRBV27	TRBJ2-2
TGTGCCAGCCCGGGGTCTCATCAGCCCCAGCATTTT	CASPGSHQPQHF	TRBV7-9	TRBJ1-5
TGCGCCAGCAGCTTGGAATGGGCGACCTACGAGCAGTACTTC	CASSLEWATYEQYF	TRBV5-1	TRBJ2-7
TGTGCCTGGAGTATAGGGGGGGCCACGGAGACCCAGTACTTC	CAWSIGGATETQYF	TRBV30	TRBJ2-5
TGTGCCAGCAGTTACAGAGGGAGCACTGAAGCTTTCTTT	CASSYRGSTEAFF	TRBV6-2	TRBJ1-1
TGTGCCAGCCTCAGGGACTGCTACGAGCAGTACTTC	CASLRDCYEQYF	TRBV2	TRBJ2-7
TGTGCCAGCAACGGACGGCGAGTCGGGGAGCTGTTTTTT	CASNGRRVGELFF	TRBV18	TRBJ2-2
TGTGCCAGCAGCCGGCGGGACCGTTCGCAAGAGACCCAGTACTTC	CASSRRDRSQETQYF	TRBV7-3	TRBJ2-5
TGTGCCAGCAGCCCCATTGGGGCCGACGGCTACACCTTC	CASSPIGADGYTF	TRBV3-1	TRBJ1-2
TGTGCTAGTGGTTCGGCCCGATGGGTCGAAAACTACGAGCAGTACTTC	CASGSARWVENYEQYF	TRBV12-5	TRBJ2-7
TGTGCCAGTATGAGGGGCTTTGCTTTCTTT	CASMRGFAFF	TRBV19	TRBJ1-1
TGTGCCAGTAGTCCGGCCCTCGGGACTAGCGTAGGGGGGGAGCTGTTTTTT	CASSPALGTSVGGELFF	TRBV19	TRBJ2-2
TGTGCCAGCCAGGGGGGATCATACCAGAATCAGCCCCAGCATTTT	CASQGGSYQNQPQHF	TRBV11-2	TRBJ1-5
TGCAGTGCTCCCCCCCTGATGGCGGACAATTATACCACAGATACGCAGTATTTT	CSAPPLMADNYTTDTQYF	TRBV20-1	TRBJ2-3
TGCGCCAGCAGCCCCCACTCCTACGAGCAGTACTTC	CASSPHSYEQYF	TRBV5-1	TRBJ2-7
TGTGCCATCAGTGATCTCACCGGGACAGGTGACTATGGCTACACCTTC	CAISDLTGTGDYGYTF	TRBV10-3	TRBJ1-2
TGCAGTGCTTATGGACAGGGGTCACCCCTCCACTTT	CSAYGQGSPLHF	TRBV20-1	TRBJ1-6
TGCAGTGCTGACCCGAGAAAACGAGGGGACGAGCAGTACTTC	CSADPRKRGDEQYF	TRBV20-1	TRBJ2-7
TGTGCCAGCAGCCAACCAGCGGGGCGGGAGACCCAGTACTTC	CASSQPAGRETQYF	TRBV7-9	TRBJ2-5
TGCGCCAGCAGCGAACTCGGACAGGGCCACGAGCAGTACTTC	CASSELGQGHEQYF	TRBV5-1	TRBJ2-7
TGTGCCAGCAGCCTCCGTAGCGGGGGAAACTGGGCTAGCACAGATACGCAGTATTTT	CASSLRSGGNWASTDTQYF	TRBV7-3	TRBJ2-3
TGCAGTGCTAGATCGGTACGGCAGACTGAAGCTTTCTTT	CSARSVRQTEAFF	TRBV20-1	TRBJ1-1
