TGTGCCTGGAGCCGGGACGCCCCAGGTAACACAGATACGCAGTATTTT	CAWSRDAPGNTDTQYF	TRBV30	TRBJ2-3
TGTGCCAGCGCACACCCGCAGAGTAATGGCTACACCTTC	CASAHPQSNGYTF	TRBV2	TRBJ1-2
TGCAGTGCAGTCGGCACAGGTAGCTACGAGCAGTACTTC	CSAVGTGSYEQYF	TRBV20-1	TRBJ2-7
TGTGCCAGCAGTGCGTGGGGACAAAACGGGGAGCTGTTTTTT	CASSAWGQNGELFF	TRBV6-4	TRBJ2-2
TGTGCCAGCACCCAGGGACAGCCGGCCTCCGGGGAGCTGTTTTTT	CASTQGQPASGELFF	TRBV27	TRBJ2-2
TGTGCCAGCAGCGGGAGGGACAGCAAGGGGAGGGTTGAGCAGTACTTC	CASSGRDSKGRVEQYF	TRBV7-9	TRBJ2-7
TGCAGCGTACAGATGACCTACAATGAGCAGTTCTTC	CSVQMTYNEQFF	TRBV29-1	TRBJ2-1
TGTGCCAGCTCACCATGGAGCGGGGGCTGCTCCTACGAGCAGTACTTC	CASSPWSGGCSYEQYF	TRBV18	TRBJ2-7
TGCGCCAGCAGCTTGGATCCCGAACAGGCATACACAGATACGCAGTATTTT	CASSLDPEQAYTDTQYF	TRBV5-1	TRBJ2-3
TGTGCCAGCAGTAAGGGCAATCAGCCCCAGCATTTT	CASSKGNQPQHF	TRBV27	TRBJ1-5
TGTGCCAGCGGGACAGGAGGGGGCTACACCTTC	CASGTGGGYTF	TRBV7-9	TRBJ1-2
TGTGTCTGGACAGGGGCGAACACTGAAGCTTTCTTT	CVWTGANTEAFF	TRBV27	TRBJ1-1
TGTGCCAGCAGCCCCTCAGGGGGCCCAGGCCAAGAGACCCAGTACTTC	CASSPSGGPGQETQYF	TRBV3-1	TRBJ2-5
TGTGCCAGCAGCTTATCGGGGACAGGGAGCCGGGTTATTAACGAGCAGTACTTC	CASSLSGTGSRVINEQYF	TRBV11-2	TRBJ2-7
TGCGCCAGCAGCTTGGGGAGGGGGCATGGCTACACCTTC	CASSLGRGHGYTF	TRBV5-1	TRBJ1-2
TGCGCCAGCAGCCACCAACAATGGGCTTCCTACGAGCAGTACTTC	CASSHQQWASYEQYF	TRBV4-1	TRBJ2-7
TGCAGTTTTAGGCTTGGGTGCTACGAGCAGTACTTC	CSFRLGCYEQYF	TRBV20-1	TRBJ2-7
TGTGCCAGCAGTTTACCCCTGACAGCGGGGAAGACCCAGTACTTC	CASSLPLTAGKTQYF	TRBV27	TRBJ2-5
TGTGCCAGCAGCCCTCCCATCCCGAACACTGAAGCTTTCTTT	CASSPPIPNTEAFF	TRBV5-8	TRBJ1-1
TGTGCCAGCCAGGGGGTGACGGGGTACTATGGCTACACCTTC	CASQGVTGYYGYTF	TRBV4-2	TRBJ1-2
TGCGCCAGCCAACGGGTTGGAAACACCATATATTTT	CASQRVGNTIYF	TRBV5-1	TRBJ1-3
TGTGCCAGTATGGAGGTTCCTAGCACAGATACGCAGTATTTT	CASMEVPSTDTQYF	TRBV19	TRBJ2-3
TGTGCCAGCGGGGAGGAGGGCTACACCTTC	CASGEEGYTF	TRBV6-1	TRBJ1-2
TGTGCCACCAGTGAGGGTCTCGACACTGAAGCTTTCTTT	CATSEGLDTEAFF	TRBV24-1	TRBJ1-1
TGCAGTTCCGGGACAGGGAGTAACTATGGCTACACCTTC	CSSGTGSNYGYTF	TRBV20-1	TRBJ1-2
TGCAGTGCTAGTACGCAGGTGGCCTACGAGCAGTACTTC	CSASTQVAYEQYF	TRBV20-1	TRBJ2-7
TGTGCCAGCAGTCATGGGCCGCGCTACACCTTC	CASSHGPRYTF	TRBV2	TRBJ1-2
TGTGCCAGCAGTGACAGTTCAGAGACCTTAGCACCCCCGGGTGACAGGATTTCGACCTATGGCTACACCTTC	CASSDSSETLAPPGDRISTYGYTF	TRBV6-4	TRBJ1-2
TGTGCCACCAGTGCAGGGGGGGCTGAGTTCGTGAGGAACTATGGCTACACCTTC	CATSAGGAEFVRNYGYTF	TRBV24-1	TRBJ1-2
TGTGCCAGCATTCGACATACGCAGTATTTT	CASIRHTQYF	TRBV6-4	TRBJ2-3
TGCAGTGCTAGAGATGGACGGGACACTGAAGCTTTCTTT	CSARDGRDTEAFF	TRBV20-1	TRBJ1-1
TGTGCCAGCAGAGGGACAGGGGCGGGAGCTTTCTTT	CASRGTGAGAFF	TRBV27	TRBJ1-1
TGTGCCATCTGTGTCAGGGGACGGTGTGAAGCTTTCTTT	CAICVRGRCEAFF	TRBV6-1	TRBJ1-1
TGTGCCAAGGGGCACGAGCAGTACTTC	CAKGHEQYF	TRBV10-3	TRBJ2-7
TGTGCCAGCAGCTTATCCGGGACTTGTCACACCGGGGAGCTGTTTTTT	CASSLSGTCHTGELFF	TRBV11-3	TRBJ2-2
TGTGCCAGCAGCGACAGTCCGGGACTAGAGGAAGAGACCCAGTACTTC	CASSDSPGLEEETQYF	TRBV13	TRBJ2-5
TGCAGCGCAGGGACGGGGACTGAAGCTTTCTTT	CSAGTGTEAFF	TRBV29-1	TRBJ1-1
TGTGCCAGCATTCGGGGACTAGCGGGGGACTACAATGAGCAGTTCTTC	CASIRGLAGDYNEQFF	TRBV27	TRBJ2-1
TGTGCCATCAGACTAGCGGTAACAAAACCGAACACCGGGGAGCTGTTTTTT	CAIRLAVTKPNTGELFF	TRBV10-3	TRBJ2-2
TGTGCCAGCAGTCCTTGGAGCGGGAGCGCTGGATCCAATGAAAAACTGTTTTTT	CASSPWSGSAGSNEKLFF	TRBV28	TRBJ1-4
TGTGCCAGCAGCTCCACTAGCGGGAGCGTTTGTCGGAGCACCGGGGAGCTGTTTTTT	CASSSTSGSVCRSTGELFF	TRBV7-9	TRBJ2-2
TGCAGTGCTAGGTGGACCAATGAGCAGTTCTTC	CSARWTNEQFF	TRBV20-1	TRBJ2-1
TGTGCCAGCAGCCCGTTCGGAAGGCGGGCCGGGTACTACAATGAGCAGTTCTTC	CASSPFGRRAGYYNEQFF	TRBV13	TRBJ2-1
TGTGCCATCAGTCCAGGAGGACGTAAGAACCAAGAGACCCAGTACTTC	CAISPGGRKNQETQYF	TRBV10-3	TRBJ2-5
TGTGCCAGCAGCGCCCTCAGGGGGTATAGCAATCAGCCCCAGCATTTT	CASSALRGYSNQPQHF	TRBV13	TRBJ1-5
TGCAGCGACCCTCCCAGTGACAGGGAATACAATGAGCAGTTCTTC	CSDPPSDREYNEQFF	TRBV29-1	TRBJ2-1
TGTGCCAGCAAGAGGGGACGGATCACTGAAGCTTTCTTT	CASKRGRITEAFF	TRBV6-5	TRBJ1-1
TGCAGTGCTAAGACAAGACCGGGCTCCTACAATGAGCAGTTCTTC	CSAKTRPGSYNEQFF	TRBV20-1	TRBJ2-1
TGTGCCAGCAGTAACTCCCCTCTCCCGTCCTACGAGCAGTACTTC	CASSNSPLPSYEQYF	TRBV6-5	TRBJ2-7
TGTGCCAGCAGCCAAGGTCCTACCGGGGGCGCCTTGAGGGGGGGCAATCAGCCCCAGCATTTT	CASSQGPTGGALRGGNQPQHF	TRBV14	TRBJ1-5
TGCGCCAGCCACTGGTGCCGACAGGTAAGAAACTACGAGCAGTACTTC	CASHWCRQVRNYEQYF	TRBV10-2	TRBJ2-7
TGTGCCAGCAGCTCCCCGCCGGACATCGGCACAGATACGCAGTATTTT	CASSSPPDIGTDTQYF	TRBV7-3	TRBJ2-3
TGTGCCAGTGGCTTCAGGATAGCGGGTTACGAGCAGTACTTC	CASGFRIAGYEQYF	TRBV19	TRBJ2-7
TGTGCCAGCAGTTTTGAATGCTCCCGGGGGAGGGCCTACGAGCAGTACTTC	CASSFECSRGRAYEQYF	TRBV12-4	TRBJ2-7
TGTGCCAGCAGTTTCAATCCCCGGTGGACGGGGGATCGCTCCTATAATTCACCCCTCCACTTT	CASSFNPRWTGDRSYNSPLHF	TRBV27	TRBJ1-6
TGTGCCAGCAGTGCGTCCACACGGGACAGCTATGGCTACACCTTC	CASSASTRDSYGYTF	TRBV6-4	TRBJ1-2
TGTGCCAGCAGAGTCAGGGTGTATGGCTACACCTTC	CASRVRVYGYTF	TRBV5-5	TRBJ1-2
TGTGCCAGCAGCGCTAGACCATCCTACGAGCAGTACTTC	CASSARPSYEQYF	TRBV13	TRBJ2-7
TGTGCCAGCAGCTGCGACCTCTATTACGAGCAGTACTTC	CASSCDLYYEQYF	TRBV5-4	TRBJ2-7
TGTGCCCCACTTCGGAGACCCACAGATACGCAGTATTTT	CAPLRRPTDTQYF	TRBV5-4	TRBJ2-3
TGTGCCTGGAGTGTACGGCGCGGGAGTGGGGGCTACACCTTC	CAWSVRRGSGGYTF	TRBV30	TRBJ1-2
TGTGCCAGCAGCCCGGGACTTGAAAAACTGTTTTTT	CASSPGLEKLFF	TRBV6-2	TRBJ1-4
TGTGCCAGCAGCCGGCTGGCAGATACGCAGTATTTT	CASSRLADTQYF	TRBV27	TRBJ2-3
TGTGCCAGCAGTGAATGCCCGGGACAAGCCCCCGGAGCTTTCTTT	CASSECPGQAPGAFF	TRBV25-1	TRBJ1-1
TGCGCCAGCAATCGCGGGGGAACAATCGAGCAGTACTTC	CASNRGGTIEQYF	TRBV10-1	TRBJ2-7
TGCAGTGCTGAGAACGGGACAGCCCACTATGGCTACACCTTC	CSAENGTAHYGYTF	TRBV20-1	TRBJ1-2
TGTGCCAGCAGTGAAGCGCACGACCTAGGGACAGGGGGCCAATACAATGAGCAGTTCTTC	CASSEAHDLGTGGQYNEQFF	TRBV6-1	TRBJ2-1
TGTGCCAGCAGCCATCAGTACTGCAATCAGCCCCAGCATTTT	CASSHQYCNQPQHF	TRBV7-9	TRBJ1-5
TGTGCCAGCAGAGTAGCTCTATCTAAGACCACTGAAGCTTTCTTT	CASRVALSKTTEAFF	TRBV2	TRBJ1-1
TGTGCCTGGACTACAGTGAATGAGCAGTTCTTC	CAWTTVNEQFF	TRBV30	TRBJ2-1
TGTGCCAGCAGCTTTTCACAGGGAGGCGAGACCCAGTACTTC	CASSFSQGGETQYF	TRBV11-3	TRBJ2-5
TGTGCCAGCAGTTTCTCGTGCGACAGGGAGCACTATGGCTACACCTTC	CASSFSCDREHYGYTF	TRBV27	TRBJ1-2
TGTGCTAGTGGTTTTTTTGGGCCAAGGGGACGTTACGCGAACACCGGGGAGCTGTTTTTT	CASGFFGPRGRYANTGELFF	TRBV12-5	TRBJ2-2
TGTGCCAGCAGCTCCCGGGACAGTAGGTCACCCCTCCACTTT	CASSSRDSRSPLHF	TRBV9	TRBJ1-6
TGCAGCGTTGACTCCCAGGGAGACGTACCCCTCCACTTT	CSVDSQGDVPLHF	TRBV29-1	TRBJ1-6
TGTGCCAGAGAGGGGGGTAGCGGGCCGGACGAGCAGTACTTC	CAREGGSGPDEQYF	TRBV6-5	TRBJ2-7
TGTGCCAGCAGTGCTTGGACAGGGGTAACAGATACGCAGTATTTT	CASSAWTGVTDTQYF	TRBV6-4	TRBJ2-3
TGTGCCAGCAGCAGGCCCGGGACAGTCCGTCCGCCCACGGAGACCCAGTACTTC	CASSRPGTVRPPTETQYF	TRBV7-8	TRBJ2-5
TGTGCCAGCAGCTTAACGCTGCAAAAAAGGGAAATCTTCCGTAGTGAGCAGTTCTTC	CASSLTLQKREIFRSEQFF	TRBV7-3	TRBJ2-1
TGTGCCAGTAGTATCCCAAGGGGCCAGGAGCCCCAGCATTTT	CASSIPRGQEPQHF	TRBV19	TRBJ1-5
TGTGCCAGCAGTGACGTGGTCCGGACAGACACCGGGGAGCTGTTTTTT	CASSDVVRTDTGELFF	TRBV6-4	TRBJ2-2
TGTGCCAGCAGTTTACCGTATGGAGAGGGGTGTCAGCCCCAGCATTTT	CASSLPYGEGCQPQHF	TRBV27	TRBJ1-5
TGTGCCAGCATCTCCGGTCGCTATAGGATTAACTATGGCTACACCTTC	CASISGRYRINYGYTF	TRBV27	TRBJ1-2
TGTGCCAGCACCAGGGGGCCGGGGCCCCAGCATTTT	CASTRGPGPQHF	TRBV6-6	TRBJ1-5
TGTGCCAGCAGCTTAGCGGACGTCGGGAACACTGAAGCTTTCTTT	CASSLADVGNTEAFF	TRBV7-6	TRBJ1-1
TGTGCCAGCAGCTTGGGTTGCGAGGGCTACGAGCAGTACTTC	CASSLGCEGYEQYF	TRBV5-6	TRBJ2-7
TGTGCCAGCAGCCAAGCCGATATAAGGGGAGACAGGTCAGGGGAAAAACTGTTTTTT	CASSQADIRGDRSGEKLFF	TRBV3-1	TRBJ1-4
TGTGCCAGCAGCTTGGGGGACAGCTCCTACGAGCAGTACTTC	CASSLGDSSYEQYF	TRBV5-4	TRBJ2-7
TGCAAGGACAGGGGGGTTAACGGAGGCTACACCTTC	CKDRGVNGGYTF	TRBV29-1	TRBJ1-2
TGTGCCAGCAGTTTCGGGACAGGTAATCTATTCGACGATCAGCCCCAGCATTTT	CASSFGTGNLFDDQPQHF	TRBV12-3	TRBJ1-5
TGTGCCAGCTCACCACGGGGGACAGGGTCGATGGGAAACATTCAGTACTTC	CASSPRGTGSMGNIQYF	TRBV18	TRBJ2-4
TGTGCCAGCAGTTTATCCACCAGACAGGGGACGAACACTGAAGCTTTCTTT	CASSLSTRQGTNTEAFF	TRBV27	TRBJ1-1
TGTGCCAGCAGCTTGGTTTGGGACAGGGGGCTTTGGGTTGTCCCTGAAGCTTTCTTT	CASSLVWDRGLWVVPEAFF	TRBV11-3	TRBJ1-1
TGTGCTAGAGCGGCGACAGATTATAGCAATCAGCCCCAGCATTTT	CARAATDYSNQPQHF	TRBV12-5	TRBJ1-5
TGCAGCGTTGGCGGAGCAATGAAGGGCGAGCAGTACTTC	CSVGGAMKGEQYF	TRBV29-1	TRBJ2-7
TGTGCCTTGACTAGCGGGAGGGCGAAGAATTACGAGCAGTACTTC	CALTSGRAKNYEQYF	TRBV30	TRBJ2-7
TGTGCCAGCAGCCCCAAAACGACAGGGTCTACAAATGAGCAGTTCTTC	CASSPKTTGSTNEQFF	TRBV7-3	TRBJ2-1
TGTGCCAGCAGCTTGGTTGGACAGGCTCAAGAGACCCAGTACTTC	CASSLVGQAQETQYF	TRBV5-4	TRBJ2-5
TGTGCCAGCTTTTCGATGGACTTGGGGGTCTTC	CASFSMDLGVF	TRBV19	TRBJ2-1
TGCGCCAGCAGACTAGGGGTTCTCCGTGCTTTCTTT	CASRLGVLRAFF	TRBV10-1	TRBJ1-1
