TGTGCCAGCAGTCGTGACCCTGACAATGAGCAGTTCTTC	CASSRDPDNEQFF	TRBV6-2	TRBJ2-1
TGTGCCAGCAGCTTGACAGGGGAAAAAATCTATGGCTACACCTTC	CASSLTGEKIYGYTF	TRBV5-6	TRBJ1-2
TGTGCCAGCAGCTTCGGCAGACAGGCTCACGATAATTCACCCCTCCACTTT	CASSFGRQAHDNSPLHF	TRBV7-9	TRBJ1-6
TGCGCCAGCCATGGGGCCTTCTTT	CASHGAFF	TRBV10-1	TRBJ1-1
TGTGCCAGCAGCAAATCGGGGGGTAGGGGGTGGTCCTACGAGCAGTACTTC	CASSKSGGRGWSYEQYF	TRBV7-9	TRBJ2-7
TGTGCCAGCACGGACAGGGGGGACTACGAGCAGTACTTC	CASTDRGDYEQYF	TRBV6-5	TRBJ2-7
TGTGCCAGCAGAGGAAGGGCCGGGGAGCTGTTTTTT	CASRGRAGELFF	TRBV6-5	TRBJ2-2
TGTGCCAGCAGTCCCCGCACCCAGGAAGCAACTAATGAAAAACTGTTTTTT	CASSPRTQEATNEKLFF	TRBV27	TRBJ1-4
TGTGCTAGTGGTCGGACGAAGTGCACAGATACGCAGTATTTT	CASGRTKCTDTQYF	TRBV12-5	TRBJ2-3
TGTGCCAGCAGCTCCGGCCCAGTGTGGAGAGGAGACACCGGGGAGCTGTTTTTT	CASSSGPVWRGDTGELFF	TRBV7-9	TRBJ2-2
TGTGCCAGCAGCGTTAGAGACAGGGGGTTTGGAGATCAGCCCCAGCATTTT	CASSVRDRGFGDQPQHF	TRBV13	TRBJ1-5
TGTGCCAGCAGTTACGATCCCTGCGGGGAGCTGTTTTTT	CASSYDPCGELFF	TRBV6-2	TRBJ2-2
TGTGCCAGTAGTATAGATAACCGGGACATCGGTGGGAACACTGAAGCTTTCTTT	CASSIDNRDIGGNTEAFF	TRBV19	TRBJ1-1
TGTGCCAGCAGCCTCCTAGCGGGGGGAGAGACCCAGTACTTC	CASSLLAGGETQYF	TRBV7-2	TRBJ2-5
TGTGCCACCAGTGACCGCGGTTCAAACCTAGCGGGAGTCAATCAGCCCCAGCATTTT	CATSDRGSNLAGVNQPQHF	TRBV24-1	TRBJ1-5
TGTGCCAGCAGGTCCTGGGGGGGGGCAGATACGCAGTATTTT	CASRSWGGADTQYF	TRBV9	TRBJ2-3
TGTGCCAGCAGCCAACTAACAGGGAATCAGCCCCAGCATTTT	CASSQLTGNQPQHF	TRBV13	TRBJ1-5
TGTGCCAGCAGCTTAAGGGGGGCGGGAGGGGTCACAGATACGCAGTATTTT	CASSLRGAGGVTDTQYF	TRBV7-2	TRBJ2-3
TGTGCCTGGAGTCAGTGGACAGTTAACTCCTACAATGAGCAGTTCTTC	CAWSQWTVNSYNEQFF	TRBV30	TRBJ2-1
TGTGCCAGCTCACCAGTACCCCAGCCCCAGCATTTT	CASSPVPQPQHF	TRBV18	TRBJ1-5
TGTGCCACCACGATCGGGCCCCCTGTAGCTAACTATGGCTACACCTTC	CATTIGPPVANYGYTF	TRBV24-1	TRBJ1-2
TGCAGTGCATTAGCTTGCAGCCCCACTGAAGCTTTCTTT	CSALACSPTEAFF	TRBV20-1	TRBJ1-1
TGCAGTGCTAGAGATGTCAGGGAATACAATGAGCAGTTCTTC	CSARDVREYNEQFF	TRBV20-1	TRBJ2-1
TGTGCCAGGCCGCTCTACGAGCAGTACTTC	CARPLYEQYF	TRBV10-3	TRBJ2-7
TGTGCCAGCATATTTTCGGGGATGGAAGGGAGTGTCGCCTATGAAAAACTGTTTTTT	CASIFSGMEGSVAYEKLFF	TRBV12-3	TRBJ1-4
TGTGCCAGCATGGGACGGGACCACGAGCAGTACTTC	CASMGRDHEQYF	TRBV7-3	TRBJ2-7
TGTGCTCCGGGCCAGTTTTGGACTTCCCGCTACGAGCAGTACTTC	CAPGQFWTSRYEQYF	TRBV7-3	TRBJ2-7
TGTGCTAGTGGTTTGGACTTCTGTGTCAATCCCGAGCAGTACTTC	CASGLDFCVNPEQYF	TRBV12-5	TRBJ2-7
TGTGCCAGCAGCACCCCCCAGGGAATGAGGGGGGATAGCAATCAGCCCCAGCATTTT	CASSTPQGMRGDSNQPQHF	TRBV7-9	TRBJ1-5
TGTGCCAGCAGGACAGGGTTAGCTAACTATGGCTACACCTTC	CASRTGLANYGYTF	TRBV6-5	TRBJ1-2
TGTGCCAGTAGTATATTGCAGGGCAGTCAAGAGACCCAGTACTTC	CASSILQGSQETQYF	TRBV19	TRBJ2-5
TGTGCCAGCAGTGCGGCCCGCCTGGGAGGGCGGGAAGATACGCAGTATTTT	CASSAARLGGREDTQYF	TRBV2	TRBJ2-3
TGTGCCAGCAGCCCCGGGACTAGCGGGGGCGGATCCTACAATGAGCAGTTCTTC	CASSPGTSGGGSYNEQFF	TRBV11-3	TRBJ2-1
TGTGCCAGCAGTTTCCCCGAGGTGGGTAGAGTACCCCGGGGGAGCACAGATACGCAGTATTTT	CASSFPEVGRVPRGSTDTQYF	TRBV28	TRBJ2-3
TGTGCCAGCAGTGGACAGGGGTATCGTGCCTACGAGCAGTACTTC	CASSGQGYRAYEQYF	TRBV6-5	TRBJ2-7
TGTGCCAGCAGAGTGGGGGCTAACTATGGCTACACCTTC	CASRVGANYGYTF	TRBV6-1	TRBJ1-2
TGTGCCATCCCGTGTGGGGCACCCTATGGCTACACCTTC	CAIPCGAPYGYTF	TRBV10-3	TRBJ1-2
TGTGCCAGCAGTGACTCGAGATTGGGGGGGGCAATGGTATTGTCAGATACGCAGTATTTT	CASSDSRLGGAMVLSDTQYF	TRBV6-4	TRBJ2-3
TGTGCCAGCAGCTTTTTGGCGCGGGAGCCGAACACTGAAGCTTTCTTT	CASSFLAREPNTEAFF	TRBV7-6	TRBJ1-1
TGTGCCAGCAGCAATCGACCCTACGAGCAGTACTTC	CASSNRPYEQYF	TRBV13	TRBJ2-7
TGTGCCATAGCGGGCTTCCCAGATACGCAGTATTTT	CAIAGFPDTQYF	TRBV24-1	TRBJ2-3
TGTGCTAGCAGCTTGAGTTCGGGAAACACCATATATTTT	CASSLSSGNTIYF	TRBV7-7	TRBJ1-3
TGCGCCAGCAGCGGGGCCTCTGGAGCAGAGACCCAGTACTTC	CASSGASGAETQYF	TRBV4-1	TRBJ2-5
TGCAGTGCTAGAGCCCTCGGGTTTACTAGCGGGAGGCACCCCGGTGGAAACACCATATATTTT	CSARALGFTSGRHPGGNTIYF	TRBV20-1	TRBJ1-3
TGCGCCAGTTCGGACAATGAGCAGTTCTTC	CASSDNEQFF	TRBV5-1	TRBJ2-1
TGTGCCAGCAGTGAAGCCGGGTCCGTCCGGTATCAGCCCCAGCATTTT	CASSEAGSVRYQPQHF	TRBV2	TRBJ1-5
TGTGCCAGCAGCTCTGACTATACCTACGAGCAGTACTTC	CASSSDYTYEQYF	TRBV9	TRBJ2-7
TGCGCCAGCAAAGTCCCAGGGATAGAAAAACTGTTTTTT	CASKVPGIEKLFF	TRBV10-1	TRBJ1-4
TGCGCCAGTCATACGGGACAAGGGGAGGAGCTGTTTTTT	CASHTGQGEELFF	TRBV10-1	TRBJ2-2
TGTGCCAGCAGCATTGATGCTTCGGAGAACGAGCAGTACTTC	CASSIDASENEQYF	TRBV7-8	TRBJ2-7
TGCGCCCCCCCCGGGACAGGAGGGACTGAAGCTTTCTTT	CAPPGTGGTEAFF	TRBV10-1	TRBJ1-1
TGTGCCAGCATACGGTACGGCTCCTACGAGCAGTACTTC	CASIRYGSYEQYF	TRBV6-2	TRBJ2-7
TGTGCCAGCAGCATCCACCATACAATCCGGGACACGGGGGACAATGAGCAGTTCTTC	CASSIHHTIRDTGDNEQFF	TRBV13	TRBJ2-1
TGTGCCTGGAGTGAAGACAGGTCTTGTGAAGCTTTCTTT	CAWSEDRSCEAFF	TRBV30	TRBJ1-1
TGTGCCAGCAGAGTCGTTCCTAGGATTGAGCAGTTCTTC	CASRVVPRIEQFF	TRBV27	TRBJ2-1
TGCAGGGGGGAATCCTACGAGCAGTACTTC	CRGESYEQYF	TRBV20-1	TRBJ2-7
TGTGCCAGCCCGCCGACAGGGGCGACAGATACGCAGTATTTT	CASPPTGATDTQYF	TRBV6-5	TRBJ2-3
TGTGCCAGTAGTGGTCGGGGACGGAGAGCTTTCTTT	CASSGRGRRAFF	TRBV19	TRBJ1-1
TGTGCCAGCAGCCAAGACGGAGGACAGGGGGCTGACGAGCAGTACTTC	CASSQDGGQGADEQYF	TRBV3-1	TRBJ2-7
TGTGCCAGCAGTTTAAGGGCTGGGACAGTAGTAGAGACCCAGTACTTC	CASSLRAGTVVETQYF	TRBV6-5	TRBJ2-5
TGTGCCAGCAGTTACCCGGTGGGGTCCGAGCAGTACTTC	CASSYPVGSEQYF	TRBV6-2	TRBJ2-7
TGTGCCAGCAGCCCCAAGGGGGTTAATTCACCCCTCCACTTT	CASSPKGVNSPLHF	TRBV5-4	TRBJ1-6
TGTGCCAGCAGCGGCCGGTGTGGACAGAGGAGCTACGAGCAGTACTTC	CASSGRCGQRSYEQYF	TRBV7-9	TRBJ2-7
TGTGCTAGCAGCTGCGAGGGCTTCGGCACAGATACGCAGTATTTT	CASSCEGFGTDTQYF	TRBV7-7	TRBJ2-3
TGTGCCACCAGTGATTCGCAATTACAACAGGGTAAGGGTGACACTGAAGCTTTCTTT	CATSDSQLQQGKGDTEAFF	TRBV24-1	TRBJ1-1
TGTGCCAGCAGTTGGCAAGGAAAGTGGGCCCGTTGGGGAGGGCAAGAGACCCAGTACTTC	CASSWQGKWARWGGQETQYF	TRBV27	TRBJ2-5
TGCAGTGCTAGATTCCGGATGCAGTCCTCCTACAATGAGCAGTTCTTC	CSARFRMQSSYNEQFF	TRBV20-1	TRBJ2-1
TGTGCCACTCGGGGGGGACGGATCTTC	CATRGGRIF	TRBV24-1	TRBJ2-7
TGTGCCAGCAGCTCTAGCGGGGGGAACACAGATACGCAGTATTTT	CASSSSGGNTDTQYF	TRBV5-5	TRBJ2-3
TGTCCCAAGGGGAGAGGGCTTGAAAAACTGTTTTTT	CPKGRGLEKLFF	TRBV7-2	TRBJ1-4
TGTGCCAGCAGCCAAGATCCGGGACTAGCGGGGACCCAGTACTTC	CASSQDPGLAGTQYF	TRBV3-1	TRBJ2-5
TGTGCCAGCAGCTTAGCTCCAGGGCTGGATGAAAAACTGTTTTTT	CASSLAPGLDEKLFF	TRBV7-2	TRBJ1-4
TGTGCCAGCAGCTTAAAGTTTTTTATGGACAGGTCCGGTGAAGCTTTCTTT	CASSLKFFMDRSGEAFF	TRBV7-3	TRBJ1-1
TGTGCCAGCAGCGTTTCCCCCAGTTTACAGGGGCTCCCCGGCTACACCTTC	CASSVSPSLQGLPGYTF	TRBV11-2	TRBJ1-2
TGCAGCGTTGAGGGCGGGACCACAGATACGCAGTATTTT	CSVEGGTTDTQYF	TRBV29-1	TRBJ2-3
TGTGCCACCGGGGACGACTACGAGCAGTACTTC	CATGDDYEQYF	TRBV24-1	TRBJ2-7
TGTGCCAGCATTCCTAAAAGAACATATTGTTCCTCTGGAAACACCATATATTTT	CASIPKRTYCSSGNTIYF	TRBV6-4	TRBJ1-3
TGTGCCAGCAGCTTGGAAGTTCAAACTCCACGGGAAGCCACAGATACGCAGTATTTT	CASSLEVQTPREATDTQYF	TRBV5-4	TRBJ2-3
TGCGCCAGCAGGTCCCCCAGGGTGAACACTGAAGCTTTCTTT	CASRSPRVNTEAFF	TRBV10-2	TRBJ1-1
TGCGCCAGCAGCCCGCCGATGCAGCCCCAGCATTTT	CASSPPMQPQHF	TRBV4-3	TRBJ1-5
TGTGCCAGCATAATGGGGGGGCCCTACGAGCAGTACTTC	CASIMGGPYEQYF	TRBV6-2	TRBJ2-7
TGCGCCAGCAGCCAAGATAGGGCGTCTGAAAAACTGTTTTTT	CASSQDRASEKLFF	TRBV4-1	TRBJ1-4
TGTGCCAGCAGCTTGTACCGGGAGGGAGTTGGAAACACCATATATTTT	CASSLYREGVGNTIYF	TRBV5-6	TRBJ1-3
TGTGCCAGCAGTGCCCGGGGGAGCGCAACTAATGAAAAACTGTTTTTT	CASSARGSATNEKLFF	TRBV25-1	TRBJ1-4
TGTGCCAGCTCACCACGCGGACTAGGGGTTCACACCGGGGAGCTGTTTTTT	CASSPRGLGVHTGELFF	TRBV18	TRBJ2-2
TGTGCCAGCAGGGGACAGTCTCAGCCCCAGCATTTT	CASRGQSQPQHF	TRBV6-5	TRBJ1-5
TGTGCCAGCAGTGAACCAAGAGCAACTCTAGCGCGGCGGACAGATACGCAGTATTTT	CASSEPRATLARRTDTQYF	TRBV6-1	TRBJ2-3
TGTGCCAGCAGCACAGGGGGGAGCGAGCAGTACTTC	CASSTGGSEQYF	TRBV9	TRBJ2-7
TGTGCCAGCAGCTTAGCACGACAGGTGTCTGGAAACACCATATATTTT	CASSLARQVSGNTIYF	TRBV11-3	TRBJ1-3
TGCGCCAGCAGCCAAGAACCTGGACTCTCTAGGGCAAATGGCTACACCTTC	CASSQEPGLSRANGYTF	TRBV4-1	TRBJ1-2
TGTGCCAGCAGCCAAGCGACAGTTATAAGCTCCTATAATTCACCCCTCCACTTT	CASSQATVISSYNSPLHF	TRBV3-1	TRBJ1-6
TGTGCCAGCAGCCATCCTAGGGGGGAAGCCAAAAACATTCAGTACTTC	CASSHPRGEAKNIQYF	TRBV7-9	TRBJ2-4
TGTGCCAGCAGTTTATGCAGGGGGCCTTCTGGAAACACCATATATTTT	CASSLCRGPSGNTIYF	TRBV27	TRBJ1-3
TGTGCCAGCAGCTTAGCCTCGCGGGAGTGGAAAGAGACCCAGTACTTC	CASSLASREWKETQYF	TRBV7-9	TRBJ2-5
TGCGCCATGCAGGCAGCTTTCTTT	CAMQAAFF	TRBV5-1	TRBJ1-1
TGTGCCAGCAGCGGTGAGACCCAGTACTTC	CASSGETQYF	TRBV9	TRBJ2-5
TGTGCCAGCAGCGTAATAGCCGGGACCCAGTACTTC	CASSVIAGTQYF	TRBV9	TRBJ2-5
TGTGCCAGCAGCGGTGGGGCAGGGGCAGCCAAAAACATTCAGTACTTC	CASSGGAGAAKNIQYF	TRBV7-9	TRBJ2-4
TGTGCCAGTAGTATCCGACCCACGTGGACAGGGACCTCTGGAAACACCATATATTTT	CASSIRPTWTGTSGNTIYF	TRBV19	TRBJ1-3
TGCAGTGCTGTTAGGGGGGACAGCGGGTGGTCTGGAAACACCATATATTTT	CSAVRGDSGWSGNTIYF	TRBV20-1	TRBJ1-3
