TGTGCTAGTGGGTACAGGGTTGCGCCCTACAATGAGCAGTTCTTC	CASGYRVAPYNEQFF	TRBV12-5	TRBJ2-1
TGTGCCAGCAGCGTATGTGACACCAGGGGTACTTCTGGAAACACCATATATTTT	CASSVCDTRGTSGNTIYF	TRBV9	TRBJ1-3
TGTGCCACCCCCGCGACAGGGGGCTACAATGAGCAGTTCTTC	CATPATGGYNEQFF	TRBV6-4	TRBJ2-1
TGTGCCAGCAGTGATCGGGGTGGGACAGGGGTGAGCAATCAGCCCCAGCATTTT	CASSDRGGTGVSNQPQHF	TRBV2	TRBJ1-5
TGTGCCAGCAGTGACTTGGGGACGCGGCAGACAGATACGCAGTATTTT	CASSDLGTRQTDTQYF	TRBV6-4	TRBJ2-3
TGTGCCAGCAGCCTAGGGGTGGACCCCGGGGAGCTGTTTTTT	CASSLGVDPGELFF	TRBV14	TRBJ2-2
TGTGCCAGCAAAGGGCTCAGCTCTGGAAACACCATATATTTT	CASKGLSSGNTIYF	TRBV27	TRBJ1-3
TGTGCCAGCAGCGACAGGGGGAATCAGCCCCAGCATTTT	CASSDRGNQPQHF	TRBV13	TRBJ1-5
TGTGCCAGCGAGGGGGGGGTGCCTGACAGGATGTCAAAGACCCAGTACTTC	CASEGGVPDRMSKTQYF	TRBV2	TRBJ2-5
TGCAGTGCTTTATCGGGACAGGTATTAGATTCATACCAGCCCCAGCATTTT	CSALSGQVLDSYQPQHF	TRBV20-1	TRBJ1-5
TGTGCCAGCAGTTATTATGACAGGGACCCCTACGAGCAGTACTTC	CASSYYDRDPYEQYF	TRBV28	TRBJ2-7
TGTGCCAGCAGCAGCGGGAGGAGAGAGTACTTAGATACGCAGTATTTT	CASSSGRREYLDTQYF	TRBV7-4	TRBJ2-3
TGCGCCAGCAGCCAAGAGCGCGGCCCTGGGGTTGAGACCCAGTACTTC	CASSQERGPGVETQYF	TRBV4-3	TRBJ2-5
TGTGCCAGCAGTGTCCGGGACAGTTCAAACACTGAAGCTTTCTTT	CASSVRDSSNTEAFF	TRBV2	TRBJ1-1
TGTGCCAGCAGCCCTTCTGGTAACTATGGCTACACCTTC	CASSPSGNYGYTF	TRBV4-2	TRBJ1-2
TGTGCCAGCTCACCACTGGGGGTGAGCTCCTACGAGCAGTACTTC	CASSPLGVSSYEQYF	TRBV18	TRBJ2-7
TGTGCCAGTAGTTGGTTCCCCAAAGGACGGGAGCGTGGAGAGACCCAGTACTTC	CASSWFPKGRERGETQYF	TRBV19	TRBJ2-5
TGTGCCAGCAGCTGGACTAGCGGGAGCCCCCCAGGGAACACCGGGGAGCTGTTTTTT	CASSWTSGSPPGNTGELFF	TRBV11-1	TRBJ2-2
TGTGCCATCAGTGGAGGGGAAGACTCCTACGAGCAGTACTTC	CAISGGEDSYEQYF	TRBV10-3	TRBJ2-7
TGCAGTGCTACTTGGGACAGGGTGACCTACAATGAGCAGTTCTTC	CSATWDRVTYNEQFF	TRBV20-1	TRBJ2-1
TGTGCCAGCAGCTACGGGACAGGGACAGGGGGGAACACTGAAGCTTTCTTT	CASSYGTGTGGNTEAFF	TRBV7-9	TRBJ1-1
TGTGCCAGCAGCCTACGGGGGGCTTCCTACAATGAGCAGTTCTTC	CASSLRGASYNEQFF	TRBV3-1	TRBJ2-1
TGTGCCAGCAGCTTCAAGAAAGGGAACGAGCAGTACTTC	CASSFKKGNEQYF	TRBV7-4	TRBJ2-7
TGTGCCACCAGTGAGCGGGACGACTACGAGCAGTACTTC	CATSERDDYEQYF	TRBV24-1	TRBJ2-7
TGTGCCAGCAGTCCAATCCCGTTAGGGGGCTCCAGAAGAGCGAGCTACGAGCAGTACTTC	CASSPIPLGGSRRASYEQYF	TRBV6-4	TRBJ2-7
TGTGCCAGCAGTTTACAAGTCTGCGGGAAGGTGAACACTGAAGCTTTCTTT	CASSLQVCGKVNTEAFF	TRBV12-3	TRBJ1-1
TGTGCTTACCCGATCGATCAGCCCCAGCATTTT	CAYPIDQPQHF	TRBV2	TRBJ1-5
TGCAGTGCTAGCGGAGTGCGTGGCAATCAGCCCCAGCATTTT	CSASGVRGNQPQHF	TRBV20-1	TRBJ1-5
TGTGCCAGCAGCGTCTACAGGGGGCCAGGTTTGTACGAGCAGTACTTC	CASSVYRGPGLYEQYF	TRBV14	TRBJ2-7
TGTGACTTCCTACGGCGCTACGAGCAGTACTTC	CDFLRRYEQYF	TRBV11-3	TRBJ2-7
TGTGCCAGCAGCCAAAGCCCTAGATACAATGAGCAGTTCTTC	CASSQSPRYNEQFF	TRBV3-1	TRBJ2-1
TGCGCCAGCAGTGAGTCCGGGAGGACAGCCAACACCGGGGAGCTGTTTTTT	CASSESGRTANTGELFF	TRBV10-1	TRBJ2-2
TGCGCCAGCAGCCAAGGCGGGGCTAATAAAGCTTTCTTT	CASSQGGANKAFF	TRBV4-1	TRBJ1-1
TGTGCCAGCAGGCCCTGGGACGGTCGCTCCTACAATGAGCAGTTCTTC	CASRPWDGRSYNEQFF	TRBV7-3	TRBJ2-1
TGTGCCAGCAGTGGACATACTGGGTATAGCAATCAGCCCCAGCATTTT	CASSGHTGYSNQPQHF	TRBV2	TRBJ1-5
TGTGCCACCAGTGGGAAGGGGGCCTTAGGGGGGAATAGCAATCAGCCCCAGCATTTT	CATSGKGALGGNSNQPQHF	TRBV24-1	TRBJ1-5
TGTGCCAGACAGGCGTATCAGCCCCAGCATTTT	CARQAYQPQHF	TRBV3-1	TRBJ1-5
TGTGCCAGCAGCTTAGCGCAGGGGGCCCAGGATGAGCAGTTCTTC	CASSLAQGAQDEQFF	TRBV7-2	TRBJ2-1
TGTGCCAGCCCCGGGAGGGCGAAACCCAGCGAGCAGTACTTC	CASPGRAKPSEQYF	TRBV7-6	TRBJ2-7
TGTGCCACCCCACAGGGCACTGAAGCTTTCTTT	CATPQGTEAFF	TRBV24-1	TRBJ1-1
TGTGCCAGCAGTTACGCGCAGGGCGCTAGCGGGAGCTCCTATAATTCACCCCTCCACTTT	CASSYAQGASGSSYNSPLHF	TRBV6-5	TRBJ1-6
TGTGCCAGCAGCAGGGACGTGGATGGCTACACCTTC	CASSRDVDGYTF	TRBV12-4	TRBJ1-2
TGTGGTACAGGGTATGGCTACACCTTC	CGTGYGYTF	TRBV7-9	TRBJ1-2
TGTGCCAGTAGTATAGCGATTAAGTTCTTGGACTATGGCTACACCTTC	CASSIAIKFLDYGYTF	TRBV19	TRBJ1-2
TGTGCCAGCAGCATAATAGTTTATGAGGACTTCTATAATTCACCCCTCCACTTT	CASSIIVYEDFYNSPLHF	TRBV7-4	TRBJ1-6
TGTGCCAGCAACGCTGAAGAGCAGTACTTC	CASNAEEQYF	TRBV7-4	TRBJ2-7
TGCAGTGCTAGAGGACAGGGCAATGAGCAGTTCTTC	CSARGQGNEQFF	TRBV20-1	TRBJ2-1
TGTGCCAGCAGCCGGACGAGAACAGATACGCAGTATTTT	CASSRTRTDTQYF	TRBV7-9	TRBJ2-3
TGTGCCAGCAGCCGATTCAAGGACAGGGGTGGAAACACCATATATTTT	CASSRFKDRGGNTIYF	TRBV5-6	TRBJ1-3
TGTGCCCCTTCCAGGGGAGGCGATCAGCCCCAGCATTTT	CAPSRGGDQPQHF	TRBV6-5	TRBJ1-5
TGTGCCACCAGAAGACTAGCGGCGTACTTC	CATRRLAAYF	TRBV24-1	TRBJ2-5
TGTGCCAGCAGTGACTCAGGGGCTCATACCGGGGAGCTGTTTTTT	CASSDSGAHTGELFF	TRBV6-4	TRBJ2-2
TGTGCCAGCAGTGAACAAGCCAGGGGGCTCCCCAAAAACATTCAGTACTTC	CASSEQARGLPKNIQYF	TRBV6-1	TRBJ2-4
TGTGCCAGCAGTGTCAGGGTCCACACCGGGGAGCTGTTTTTT	CASSVRVHTGELFF	TRBV6-4	TRBJ2-2
TGTGCCAGCAGCTTAGATTACAGGGACAGGGGGGGCCGCATCCATAGCAATCAGCCCCAGCATTTT	CASSLDYRDRGGRIHSNQPQHF	TRBV11-3	TRBJ1-5
TGTGCCAGCAGCGGGGACACTAGCACAGATACGCAGTATTTT	CASSGDTSTDTQYF	TRBV7-7	TRBJ2-3
TGTGCCAGCAGCCAAGCTACAGGGGAACACACCGGGGAGCTGTTTTTT	CASSQATGEHTGELFF	TRBV14	TRBJ2-2
TGCGCCAGCAACCGGAAGTACGGCGGTGAGACCCAGTACTTC	CASNRKYGGETQYF	TRBV10-1	TRBJ2-5
TGTGCCAGCCCCCCGGACTTCAATGAGCAGTTCTTC	CASPPDFNEQFF	TRBV25-1	TRBJ2-1
TGTGCCAGCAGTTTAAACCCACGGAATTCTGAGGGGACAGAGATCTACAATGAGCAGTTCTTC	CASSLNPRNSEGTEIYNEQFF	TRBV12-3	TRBJ2-1
TGTGCCAGCAGCATACGTCTGTTTTTT	CASSIRLFF	TRBV25-1	TRBJ1-4
TGTGCCAGCGACCGGGACAGGAGTGGGAAAAATTCACCCCTCCACTTT	CASDRDRSGKNSPLHF	TRBV6-5	TRBJ1-6
TGTGCCAGCAGTTTCGGGCTGGAACCTCAGTATGGCTACACCTTC	CASSFGLEPQYGYTF	TRBV27	TRBJ1-2
TGTGCCAGCAGCAGTACTAACTCCTACGAGCAGTACTTC	CASSSTNSYEQYF	TRBV7-9	TRBJ2-7
TGTGCCAGCAGCGGCCGAATAGGGACACCCTACGAGCAGTACTTC	CASSGRIGTPYEQYF	TRBV9	TRBJ2-7
TGTGCCAGCAGCCTTGGTAAAAGAAACTCTATGAACACTGAAGCTTTCTTT	CASSLGKRNSMNTEAFF	TRBV6-6	TRBJ1-1
TGTGCCAGCATAAGGGACAAGTCGAACACTGAAGCTTTCTTT	CASIRDKSNTEAFF	TRBV6-2	TRBJ1-1
TGTGCCAGCAGCGTAGTGCGGGACGCTGAAGCTTTCTTT	CASSVVRDAEAFF	TRBV9	TRBJ1-1
TGTGCCAGCAGCCAAGATGAGTGGAATCAGCCCCAGCATTTT	CASSQDEWNQPQHF	TRBV3-1	TRBJ1-5
TGTGCCAGCAGTGAAAAACTTAGACATGAGCAGTTCTTC	CASSEKLRHEQFF	TRBV25-1	TRBJ2-1
TGTGCCAGCAGTTTGTACCAGCCTTCTTCAGATACGCAGTATTTT	CASSLYQPSSDTQYF	TRBV27	TRBJ2-3
TGTGCCGTCCACAGGGGGGGTACTGAAGCTTTCTTT	CAVHRGGTEAFF	TRBV7-9	TRBJ1-1
TGCGCCAGCAGCCAGTCCCGGGACATGAACACCGGGGAGCTGTTTTTT	CASSQSRDMNTGELFF	TRBV4-3	TRBJ2-2
TGTGCCATCAAGGAGCAGCTAACGCCTGAAGCTTTCTTT	CAIKEQLTPEAFF	TRBV10-3	TRBJ1-1
TGTGCCAGCAGCCAAGCTGAGAGTCCGACCCAGTACTTC	CASSQAESPTQYF	TRBV4-2	TRBJ2-5
TGTGCCAGCAGCTTAGGGACAGGGTTTAGTAATGAAAAACTGTTTTTT	CASSLGTGFSNEKLFF	TRBV5-8	TRBJ1-4
TGTGCCAGCAGTCCGACAGGGGCTGGGGGGATTTTAGCCAAAAACATTCAGTACTTC	CASSPTGAGGILAKNIQYF	TRBV2	TRBJ2-4
TGTGCCAGCAGTGAAAAGCCACATCCCCTTCTCGGACAGGCTAACACCGGGGAGCTGTTTTTT	CASSEKPHPLLGQANTGELFF	TRBV25-1	TRBJ2-2
TGTGCCAGCAGTGACTCGAATAGAAAATATGGCTACACCTTC	CASSDSNRKYGYTF	TRBV6-4	TRBJ1-2
TGTGCCAGCAGCAAGTGGCCCGAGGGGGGTGAGACCCAGTACTTC	CASSKWPEGGETQYF	TRBV11-2	TRBJ2-5
TGTGCCAGCAGTTGGGGGAAGGCAACTAATGAAAAACTGTTTTTT	CASSWGKATNEKLFF	TRBV27	TRBJ1-4
TGTGCCAGCAGGCCGGGGAGGCGTGATACGCAGTATTTT	CASRPGRRDTQYF	TRBV6-4	TRBJ2-3
TGTGCCAGCAGTTACCGTCGGACTAGCGGGGGTCCCGCCGGGGAGCTGTTTTTT	CASSYRRTSGGPAGELFF	TRBV6-3	TRBJ2-2
TGTGCCAGCAGCTCCAGCGCCACCCGAACGAAAACTAATGAAAAACTGTTTTTT	CASSSSATRTKTNEKLFF	TRBV5-4	TRBJ1-4
TGTGCCAGCCCGCACAGGGGGCGCGTCGAAGCTTTCTTT	CASPHRGRVEAFF	TRBV19	TRBJ1-1
TGCGCCAGCAGCTTCCGGACCAGGAAAAAGACTGAAGCTTTCTTT	CASSFRTRKKTEAFF	TRBV5-1	TRBJ1-1
TGCGCCAGCAGCCACCCTGCGCACGAGCAGTACTTC	CASSHPAHEQYF	TRBV4-1	TRBJ2-7
TGTGCCAGTAACCCCGGGGGGTGGGGACCAGATACGCAGTATTTT	CASNPGGWGPDTQYF	TRBV19	TRBJ2-3
TGCGCCAGCATTCCGCCACCCCGTGGGGGCGTGGCATATGGCTACACCTTC	CASIPPPRGGVAYGYTF	TRBV10-1	TRBJ1-2
TGTGCCAGCAGTACCGGGACAGGGTCAGGACGCAATCAGCCCCAGCATTTT	CASSTGTGSGRNQPQHF	TRBV2	TRBJ1-5
TGTGCCACCAGTGAGGGCGGATCTGGATACGAGCAGTACTTC	CATSEGGSGYEQYF	TRBV24-1	TRBJ2-7
TGTGCCAGCAGCTTGGCCAAAGTGACTAGCGCAAGTGGGGATGAGCAGTTCTTC	CASSLAKVTSASGDEQFF	TRBV11-2	TRBJ2-1
TGCGCCAGCAGCACTTCGACGAACACCGGGGAGCTGTTTTTT	CASSTSTNTGELFF	TRBV5-1	TRBJ2-2
TGTGCTATCCAGCGGGGAGAAGATGAGCAGTTCTTC	CAIQRGEDEQFF	TRBV24-1	TRBJ2-1
TGCGCCAGCGAAGGAAGTAATCAGCCCCAGCATTTT	CASEGSNQPQHF	TRBV5-1	TRBJ1-5
TGTGCCAGTAGCACTAGCGGGTCCTCCGAGCAGTACTTC	CASSTSGSSEQYF	TRBV19	TRBJ2-7
TGTGCCACCAGTGTGAGCTGGAAAAGGAACACCGGGGAGCTGTTTTTT	CATSVSWKRNTGELFF	TRBV24-1	TRBJ2-2
TGTGCCAGCAGCCAGGGCAATCAGGATCCGGACCTCTACGAGCAGTACTTC	CASSQGNQDPDLYEQYF	TRBV13	TRBJ2-7
TGCGCCAGCAGCCAAGATCAGCGGACAGGGGGTGTCTGGCAGCCCCAGCATTTT	CASSQDQRTGGVWQPQHF	TRBV4-3	TRBJ1-5
TGTGCCAGCAGCCAAGACCCCGGACAGGGCTCCTACGAGCAGTACTTC	CASSQDPGQGSYEQYF	TRBV3-1	TRBJ2-7
