TGTGCCAGCAGCGGGACAGGCTTAGAGACCCAGTACTTC	CASSGTGLETQYF	TRBV6-4	TRBJ2-5
TGTGCCAGCAGCTTTTTAGGCGGCCCTGCCTACGAGCAGTACTTC	CASSFLGGPAYEQYF	TRBV7-3	TRBJ2-7
TGTGCCAGCAGGCGGCAAAGGGGGAACACCGGGGAGCTGTTTTTT	CASRRQRGNTGELFF	TRBV28	TRBJ2-2
TGTGCCAGCAGCCGCAGGACCAACTATGGCTACACCTTC	CASSRRTNYGYTF	TRBV7-4	TRBJ1-2
TGCGCCAGTGTTACGGGACAGGGATGGGACACTGAAGCTTTCTTT	CASVTGQGWDTEAFF	TRBV5-1	TRBJ1-1
TGCGCCAGCAGCGGGTGGAGACGGTCTAATGAAAAACTGTTTTTT	CASSGWRRSNEKLFF	TRBV5-1	TRBJ1-4
TGTGCTAGTGGTTTGCCCCTAGACGTCAATAGCGAAAAACTGTTTTTT	CASGLPLDVNSEKLFF	TRBV12-5	TRBJ1-4
TGCGCCAGCAGCTTGGTTGGGACAGGGTGGGGCTACACCTTC	CASSLVGTGWGYTF	TRBV5-1	TRBJ1-2
TGTGCCAGCACAAAGACAGGGGTCTCTGGAAACACCATATATTTT	CASTKTGVSGNTIYF	TRBV28	TRBJ1-3
TGTGCCAGCAGCCCGGTTAGAGGCGTTGCCACAGATACGCAGTATTTT	CASSPVRGVATDTQYF	TRBV3-1	TRBJ2-3
TGCGCCAGCAGCATGTCCGGGACAGGGCATGAGCAGTTCTTC	CASSMSGTGHEQFF	TRBV5-1	TRBJ2-1
TGTGCCAGCGCCGGCCGCCGGGACTTAACGTCCTACGAGCAGTACTTC	CASAGRRDLTSYEQYF	TRBV13	TRBJ2-7
TGTGCCAGCAGCTCTCCGCTGACTGGACAGGGTACAGATACGCAGTATTTT	CASSSPLTGQGTDTQYF	TRBV5-4	TRBJ2-3
TGTGCCAGCAGTTTCAGGGAGGGCCGCCCCTGCTTTACAGATACGCAGTATTTT	CASSFREGRPCFTDTQYF	TRBV6-1	TRBJ2-3
TGCGCCAGCGATGGGTGGGGTGGAGTCCGGAGCAATCAGCCCCAGCATTTT	CASDGWGGVRSNQPQHF	TRBV5-1	TRBJ1-5
TGTGCCAGCCCCAGATCTAATAATTCACCCCTCCACTTT	CASPRSNNSPLHF	TRBV14	TRBJ1-6
TGTGCCACCAGTGATTTCCAGCGGGAGGGAAAGGATGAGCAGTTCTTC	CATSDFQREGKDEQFF	TRBV24-1	TRBJ2-1
TGTGCCAGCAGCTGTGTCCTCCGGGAGGGGTACTATGGCTACACCTTC	CASSCVLREGYYGYTF	TRBV7-3	TRBJ1-2
TGTGCCAGTAGGGGGACAGGGCTCTGGTCCGGGGAGCTGTTTTTT	CASRGTGLWSGELFF	TRBV19	TRBJ2-2
TGTGCCAGCAGCGCCCAGGGGGGTGGCTACACCTTC	CASSAQGGGYTF	TRBV13	TRBJ1-2
TGTGCCACGCGGGAGCACACCGGGGAGCTGTTTTTT	CATREHTGELFF	TRBV24-1	TRBJ2-2
TGTGCCACCCCTAGCTACGCCCGCCATACAGGGAAGGAAAAACTGTTTTTT	CATPSYARHTGKEKLFF	TRBV24-1	TRBJ1-4
TGTGCCAGCAGTTACTCCGGGGGCACAGCTTTCTTT	CASSYSGGTAFF	TRBV6-3	TRBJ1-1
TGTGCCAGCAGTTCGGCCCCTGTGGACCTCCGGGACAGGGGGAGGACCGGGGAGCTGTTTTTT	CASSSAPVDLRDRGRTGELFF	TRBV12-4	TRBJ2-2
TGTGCCAGCAGCTGCCAGGGGCAATCGGAAGCTTTCTTT	CASSCQGQSEAFF	TRBV11-3	TRBJ1-1
TGTGCCAGTAGTATGGGGGCGCGGACGAACACCGGGGAGCTGTTTTTT	CASSMGARTNTGELFF	TRBV19	TRBJ2-2
TGTGCCAGCAGCTTGCCAAAAAGAAATGCAGGGCTTAAGGCTGCAACTAATGAAAAACTGTTTTTT	CASSLPKRNAGLKAATNEKLFF	TRBV5-4	TRBJ1-4
TGTGCCACCCATCGACACCGCTACGAGCAGTACTTC	CATHRHRYEQYF	TRBV24-1	TRBJ2-7
TGTGCCAGCGATACAGCTTCTCACCGACTAGCGGGTTTATCGAACACCGGGGAGCTGTTTTTT	CASDTASHRLAGLSNTGELFF	TRBV6-5	TRBJ2-2
TGTGGGGGGGGACCTGAGCAGTTCTTC	CGGGPEQFF	TRBV7-9	TRBJ2-1
TGTGCCAGCAAAACGGACTGTCGGGGGGGCGGGAAAGGGGACGAGCAGTACTTC	CASKTDCRGGGKGDEQYF	TRBV9	TRBJ2-7
TGTGCCAGCAGCGTGGCCTTGACAGTGCGGAACGTCACTGAAGCTTTCTTT	CASSVALTVRNVTEAFF	TRBV5-4	TRBJ1-1
TGCAGTGCTTTACGACATGGGGATCAGCCCCAGCATTTT	CSALRHGDQPQHF	TRBV20-1	TRBJ1-5
TGCGCCAGCAGCCACCCGGGAGAAGGTGGCACAGATACGCAGTATTTT	CASSHPGEGGTDTQYF	TRBV4-3	TRBJ2-3
TGTGCCAGCAGTTACTCGAACCCCTTCACTAGCGGGAGGCGACTCCGGGACACAGATACGCAGTATTTT	CASSYSNPFTSGRRLRDTDTQYF	TRBV6-2	TRBJ2-3
TGCAGTGCTAGAGATTTTGGCCGGGACAGGGGACTGAACACTGAAGCTTTCTTT	CSARDFGRDRGLNTEAFF	TRBV20-1	TRBJ1-1
TGTGCTAGTGGTTTGGTCCACACTGACTCTGGGGCCAACGTCCTGACTTTC	CASGLVHTDSGANVLTF	TRBV12-5	TRBJ2-6
TGTGCCAGCTCACCTGGGACAGCAGCCAAAGAGACCCAGTACTTC	CASSPGTAAKETQYF	TRBV18	TRBJ2-5
TGTGCCAGCAGCATCAGATCTCAAAACCCCGGGGTTTATAGCAATCAGCCCCAGCATTTT	CASSIRSQNPGVYSNQPQHF	TRBV9	TRBJ1-5
TGTGCCAGCAGTGGCCCGACAGCCTACGAGCAGTACTTC	CASSGPTAYEQYF	TRBV6-1	TRBJ2-7
TGTGCCAGCAGCTACTACGAAGGCAGAGATACGCAGTATTTT	CASSYYEGRDTQYF	TRBV5-4	TRBJ2-3
TGTGCCAGCAGGGTCGAGAGGAGGTCCTACAATGAGCAGTTCTTC	CASRVERRSYNEQFF	TRBV7-7	TRBJ2-1
TGTGCCAGCAGTTACTTAACAGGGTTGGGGACTGAAGCTTTCTTT	CASSYLTGLGTEAFF	TRBV6-5	TRBJ1-1
TGTGCCACCAGTGATTTGTGGGTAAAGCGGGATTATCAGCCCCAGCATTTT	CATSDLWVKRDYQPQHF	TRBV24-1	TRBJ1-5
TGTGCCAGCAGCAAAATGCCCGTAGCGGATGACAATGAGCAGTTCTTC	CASSKMPVADDNEQFF	TRBV7-3	TRBJ2-1
TGCAGCGTTGGGACTAGCGGGGGGGCCCGAGAAACCGGGGAGCTGTTTTTT	CSVGTSGGARETGELFF	TRBV29-1	TRBJ2-2
TGTGCCAGCATTCGGGGACAGAACACTGAAGCTTTCTTT	CASIRGQNTEAFF	TRBV9	TRBJ1-1
TGTGCCAGCAGTGTTCCATGTTGGGGGGCCGGCAGACCCACCTACGAGCAGTACTTC	CASSVPCWGAGRPTYEQYF	TRBV27	TRBJ2-7
TGCAGTGCGGGATACGGAGAAAAACTGTTTTTT	CSAGYGEKLFF	TRBV20-1	TRBJ1-4
TGCAGTGCTAGAGATCCGGGTGGGACTAGCTTTGAGCAGTTCTTC	CSARDPGGTSFEQFF	TRBV20-1	TRBJ2-1
TGCGCCAGCAGTCATAGCGGAGCAGATACGCAGTATTTT	CASSHSGADTQYF	TRBV10-1	TRBJ2-3
TGTGCCAGCAGTGACCCGGGACAGGGGGCGCGAGGAAATCACACTGAAGCTTTCTTT	CASSDPGQGARGNHTEAFF	TRBV2	TRBJ1-1
TGTGCCAGCAGCTTGGCCGGGACGCCCACAGATACGCAGTATTTT	CASSLAGTPTDTQYF	TRBV5-5	TRBJ2-3
TGTGCCAGCCCGGACAGCTCTGGGGCCAACGTCCTGACTTTC	CASPDSSGANVLTF	TRBV27	TRBJ2-6
TGTGCCAGCTCCGGGACTAGTAAAACGGTCTCCCCCAGGGCTCCCGACTCCGAGCAGTACTTC	CASSGTSKTVSPRAPDSEQYF	TRBV6-1	TRBJ2-7
TGTGCCAGCTCACCACCTCCAAGGAGGTTAAGGCCCAAAAACATTCAGTACTTC	CASSPPPRRLRPKNIQYF	TRBV18	TRBJ2-4
TGTGCCAGCAGCGTCCTTAGCGGGGTCACCGGGGAGCTGTTTTTT	CASSVLSGVTGELFF	TRBV4-2	TRBJ2-2
TGTGCCAGCAGTCGAAAATGGACAGGGCGTCCCCTCCACTTT	CASSRKWTGRPLHF	TRBV28	TRBJ1-6
TGTGCCAGCAGCGTTTACCCGTCTGGGGCGTACGAAGCTTTCTTT	CASSVYPSGAYEAFF	TRBV9	TRBJ1-1
TGCGCCAGGGGCAGGGTTCACGAGCAGTACTTC	CARGRVHEQYF	TRBV10-1	TRBJ2-7
TGCAGTGCTAGAGATAGCTTGATCATGGCTGGGAGCTCCTACGAGCAGTACTTC	CSARDSLIMAGSSYEQYF	TRBV20-1	TRBJ2-7
TGTGCCAGCAGCTTGCTCTGGGGACTAAGCAATCAGCCCCAGCATTTT	CASSLLWGLSNQPQHF	TRBV5-6	TRBJ1-5
TGCGCCAGCAGCCCGAGCCCCCTCTCGGGGGGGAAGATGCCCCAGCATTTT	CASSPSPLSGGKMPQHF	TRBV5-1	TRBJ1-5
TGTGCCAGCAGTCCGGACACCGGCTACGAGCAGTACTTC	CASSPDTGYEQYF	TRBV28	TRBJ2-7
TGTGCCTGGAATTTAGCTAACTATGGCTACACCTTC	CAWNLANYGYTF	TRBV30	TRBJ1-2
TGTGCCAGCTCCACCCCCCCGGGACAGGGAAGGTCACCCCTCCACTTT	CASSTPPGQGRSPLHF	TRBV18	TRBJ1-6
TGTGCCAGCAGCTTAATTGGGGGGCCGAACACTGAAGCTTTCTTT	CASSLIGGPNTEAFF	TRBV7-9	TRBJ1-1
TGTGCCAGCAGGCGAAGTACCCAGTATAATTCACCCCTCCACTTT	CASRRSTQYNSPLHF	TRBV3-1	TRBJ1-6
TGTGCCAGTAGTAGGAAACAGGGGGCTACCTATAATTCACCCCTCCACTTT	CASSRKQGATYNSPLHF	TRBV19	TRBJ1-6
TGTGCCAGCAGCGTCTGGGACAGGGACCAAGAGACCCAGTACTTC	CASSVWDRDQETQYF	TRBV9	TRBJ2-5
TGTGCCAGCAGCAGAGGGGGGGTCTATGGCTACACCTTC	CASSRGGVYGYTF	TRBV7-9	TRBJ1-2
TGTGCCAGCAGTTGCGGGACTAGCGGGAATGAGCAGTTCTTC	CASSCGTSGNEQFF	TRBV27	TRBJ2-1
TGTGCCAGCATCAGGGACAGGGCCTGTTCCTGGAGCAACACTGAAGCTTTCTTT	CASIRDRACSWSNTEAFF	TRBV7-9	TRBJ1-1
TGTGCCAGCAGCTTGGTGCGCTCGGGTGATAACAATGAGCAGTTCTTC	CASSLVRSGDNNEQFF	TRBV5-6	TRBJ2-1
TGTGCCAGCAGCGTAGGAAGAGGGGTAGCTAGCACAGATACGCAGTATTTT	CASSVGRGVASTDTQYF	TRBV9	TRBJ2-3
TGTGCCAGCAGCTGGAACCCCGGGACCTCTGAAGCTTTCTTT	CASSWNPGTSEAFF	TRBV7-8	TRBJ1-1
TGTGCCAGCAGTGGGGGCATGCCGCTTAGCAATCAGCCCCAGCATTTT	CASSGGMPLSNQPQHF	TRBV25-1	TRBJ1-5
TGTGCCAGCAGCCTGGAGGACAGGGATGGCTACACCTTC	CASSLEDRDGYTF	TRBV7-9	TRBJ1-2
TGTGCCAGCAGTGGTAAACAGGGGGGCACTGAAGCTTTCTTT	CASSGKQGGTEAFF	TRBV25-1	TRBJ1-1
TGTGCCAGCAGCGCTGGGAAGAACATCGAGCAGTACTTC	CASSAGKNIEQYF	TRBV9	TRBJ2-7
TGTGCCAGCAGCCAGGGGGGTTGGAGCTCCTACGAGCAGTACTTC	CASSQGGWSSYEQYF	TRBV14	TRBJ2-7
TGTGCCAGCAGTCGTCATCTAGCGGGCGGCTACCAAGAGACCCAGTACTTC	CASSRHLAGGYQETQYF	TRBV12-4	TRBJ2-5
TGTGCCAGCAGTGAAGCGCAACTTACTCAACCCGGGACCAATGAGCAGTTCTTC	CASSEAQLTQPGTNEQFF	TRBV6-1	TRBJ2-1
TGTGCCAGCAGGAACCCAGGGAACAAGTATAGCAATCAGCCCCAGCATTTT	CASRNPGNKYSNQPQHF	TRBV6-5	TRBJ1-5
TGTGCCAGCAGTTGGGAGGGGGGCTTCGAGCAGTACTTC	CASSWEGGFEQYF	TRBV2	TRBJ2-7
TGTGCCAGCAGCCAAGTCAGAGCGGGAGCAGCGGAAGTTTACGAGCAGTACTTC	CASSQVRAGAAEVYEQYF	TRBV14	TRBJ2-7
TGTGCCAGCAGCTTACCTGGGGGGGGGAGGAGGGACTTC	CASSLPGGGRRDF	TRBV7-6	TRBJ2-7
TGTGCCACCAGTGATTTAACGCTCGGGCCCTACAATGAGCAGTTCTTC	CATSDLTLGPYNEQFF	TRBV24-1	TRBJ2-1
TGTGCCAGCAGTGAACAGGACAGGGCAGACGACCAAGAGACCCAGTACTTC	CASSEQDRADDQETQYF	TRBV6-1	TRBJ2-5
TGTGCCTGGTCGGGGGGGTGGGTCCATACGCAGTATTTT	CAWSGGWVHTQYF	TRBV30	TRBJ2-3
TGTGCCAGCAGCCACCGGATCAGGGGCAAGAGCAATCAGCCCCAGCATTTT	CASSHRIRGKSNQPQHF	TRBV5-4	TRBJ1-5
TGTGCCAGCAGCTTCTTTCCTTTTAAGACTAGCGAGCAGTACTTC	CASSFFPFKTSEQYF	TRBV5-8	TRBJ2-7
TGTGCCAGCAGGAGAATACGAGGCCAGTACTTC	CASRRIRGQYF	TRBV6-4	TRBJ2-4
TGCGCCAGCAGTCCAGGGATTGTATTCCGGCAAGAGACCCAGTACTTC	CASSPGIVFRQETQYF	TRBV5-1	TRBJ2-5
TGCAGTGCTAGAGATCTCCCGCCCGTTTCCGATGGTTATTCCACAGATACGCAGTATTTT	CSARDLPPVSDGYSTDTQYF	TRBV20-1	TRBJ2-3
TGTGCCAGCAGCGGACAGGGGAGTTGGGACAATCAGCCCCAGCATTTT	CASSGQGSWDNQPQHF	TRBV7-3	TRBJ1-5
TGTGCCAGCAGCCGGGAGGGGCGGCTCCACTTT	CASSREGRLHF	TRBV7-3	TRBJ1-6
TGTGCCAGCAAGATCGGAGGGAATGAGCAGTTCTTC	CASKIGGNEQFF	TRBV27	TRBJ2-1
TGTGCGTCTCGCCCAAGACACAGGATCACAGATACGCAGTATTTT	CASRPRHRITDTQYF	TRBV27	TRBJ2-3
TGTGCCAGCAGCTTAACCCCGGGGGGGGGGGTGTACTTC	CASSLTPGGGVYF	TRBV5-6	TRBJ2-7
