TGTGCCAGCAGCTTAGCGTGTCCGGGTCCGGCAATAGATAGCAATCAGCCCCAGCATTTT	CASSLACPGPAIDSNQPQHF	TRBV7-2	TRBJ1-5
TGCGCCAGCAATGCAGGGGGCACAGATACGCAGTATTTT	CASNAGGTDTQYF	TRBV10-1	TRBJ2-3
TGTGCCACCAGTGATTTGCCCAATGGGGACGACCGGAATTCACCCCTCCACTTT	CATSDLPNGDDRNSPLHF	TRBV24-1	TRBJ1-6
TGTGCCAGCAGCTTCGCTAGCGAGACCCAGTACTTC	CASSFASETQYF	TRBV7-3	TRBJ2-5
TGTGCCAGCAGCAGGGGACTGCGAAACACCATATATTTT	CASSRGLRNTIYF	TRBV13	TRBJ1-3
TGTGCCAGTAGTATAGATTGCAGACTAGCGGGAAACAATGAGCAGTTCTTC	CASSIDCRLAGNNEQFF	TRBV19	TRBJ2-1
TGCGCCAGCAGCCAGGAGACAGCAAATAACTATGGCTACACCTTC	CASSQETANNYGYTF	TRBV4-3	TRBJ1-2
TGTGCCAGCACCCTCATGAGTCCAGACTATGGCTACACCTTC	CASTLMSPDYGYTF	TRBV25-1	TRBJ1-2
TGTGCCAGTAGTTCTTTCGACCTAGAACGTCTAGAAGAGCAGTACTTC	CASSSFDLERLEEQYF	TRBV19	TRBJ2-7
TGTGCCAGCAGGGGAGGGGACTATACCGGGGAGCTGTTTTTT	CASRGGDYTGELFF	TRBV6-5	TRBJ2-2
TGTGCCAGCAGCCAAGATACTAGGGACAGGGGGGTTGGCTACACCTTC	CASSQDTRDRGVGYTF	TRBV14	TRBJ1-2
TGTGCCAGCAGCTTAGAACGGACAGACTCTGGAAACACCATATATTTT	CASSLERTDSGNTIYF	TRBV11-2	TRBJ1-3
TGTGCCAGCAGTGAATGGGGCCCCCCGGGCTCTAGCACAGATACGCAGTATTTT	CASSEWGPPGSSTDTQYF	TRBV6-4	TRBJ2-3
TGTGCCTGGAGTGTTCGACTAGCGGGTTGGTCGCAGTTCTTC	CAWSVRLAGWSQFF	TRBV30	TRBJ2-1
TGCAGCGTTGCGGGGGGGGCCTCGTACAATGAGCAGTTCTTC	CSVAGGASYNEQFF	TRBV29-1	TRBJ2-1
TGTGCCAGCAGTTACGGGTGGACAGGGGAGCCCCAGCATTTT	CASSYGWTGEPQHF	TRBV6-6	TRBJ1-5
TGCGCCGGGACAGGGGGCGTGGAGCAGTACTTC	CAGTGGVEQYF	TRBV10-1	TRBJ2-7
TGTGCCAGCCCTCCCCAAGGGACTAGCGGGGGGGGGGAGCAGTACTTC	CASPPQGTSGGGEQYF	TRBV2	TRBJ2-7
TGTGCCAGCAAGAACAGGAATTCACCCCTCCACTTT	CASKNRNSPLHF	TRBV6-5	TRBJ1-6
TGTGCCAGCAGCAAGCGTTTGCGGGAGAGGCCCCAGTACTTC	CASSKRLRERPQYF	TRBV11-3	TRBJ2-5
TGTGCCAGCAGTGTCCCCGGACCGGACACCATATATTTT	CASSVPGPDTIYF	TRBV12-3	TRBJ1-3
TGTGCCAGCTCACCAGTGAAACAGATGAGGGGGGGCCGGGAGCAGTTCTTC	CASSPVKQMRGGREQFF	TRBV18	TRBJ2-1
TGTGCCAGCAGCCACCTCCGTCTAACATACACTGAAGCTTTCTTT	CASSHLRLTYTEAFF	TRBV7-3	TRBJ1-1
TGTGCCAGTCCTACAGGGGACGGGGAGCTGTTTTTT	CASPTGDGELFF	TRBV7-9	TRBJ2-2
TGTGCCGGGTCAGGGGACCATAGCAATCAGCCCCAGCATTTT	CAGSGDHSNQPQHF	TRBV30	TRBJ1-5
TGTGCCAGCAGGTCCCGTCGGACTAGCGGACGGGGCTACGAGCAGTACTTC	CASRSRRTSGRGYEQYF	TRBV28	TRBJ2-7
TGCGCCAGCAGTGCCAGCGAGACAGATACGCAGTATTTT	CASSASETDTQYF	TRBV10-1	TRBJ2-3
TGTGCCAGCAGCCACGGCGACTGGAGCGACTATGGCTACACCTTC	CASSHGDWSDYGYTF	TRBV5-6	TRBJ1-2
TGTGCCAGCAGCCTCTGGCGGCACTACGAGCAGTACTTC	CASSLWRHYEQYF	TRBV5-5	TRBJ2-7
TGTGCCAGCAGTAGGATGCAGAGACAGGACACTGAAGCTTTCTTT	CASSRMQRQDTEAFF	TRBV6-1	TRBJ1-1
TGTGCCAGCAGCCAAGACGACACGAAGAATGGCTACACCTTC	CASSQDDTKNGYTF	TRBV14	TRBJ1-2
TGTGCCTGGAGTGGCCGGTCTAGGACCGAGCAGTACTTC	CAWSGRSRTEQYF	TRBV30	TRBJ2-7
TGCACGGTAGGCGCATATCAGGGGAAGGTAAGTAATTCACCCCTCCACTTT	CTVGAYQGKVSNSPLHF	TRBV20-1	TRBJ1-6
TGCGCCAGCACCCTCCACAGGGGAAACTATGGCTACACCTTC	CASTLHRGNYGYTF	TRBV10-1	TRBJ1-2
TGTGCCAGAGTCGGTTTCCCCTTGTGCAGGGGGAACTATGGCTACACCTTC	CARVGFPLCRGNYGYTF	TRBV28	TRBJ1-2
TGTGCCAGTAGTGGGAGGGTTTACGGGGTGAACACTGAAGCTTTCTTT	CASSGRVYGVNTEAFF	TRBV19	TRBJ1-1
TGTGCCAGCAGACGGACAGGGCCCTACAATGAGCAGTTCTTC	CASRRTGPYNEQFF	TRBV6-5	TRBJ2-1
TGTGCCAGCAGCGGCCCCCCAGGGCCCAGGTGCTCCTACAATGAGCAGTTCTTC	CASSGPPGPRCSYNEQFF	TRBV9	TRBJ2-1
TGTGCCAGCAGCTTAGAGACTAGCGGGAGAGAGCAGTTCTTC	CASSLETSGREQFF	TRBV11-3	TRBJ2-1
TGTGCCAGCAGTTGGACCGGGGCACCCACAGATACGCAGTATTTT	CASSWTGAPTDTQYF	TRBV6-2	TRBJ2-3
TGTGCCAGTAGTATAGATCCCAGGGGGGGCCACGAGCAGTACTTC	CASSIDPRGGHEQYF	TRBV19	TRBJ2-7
TGTGCCAGCAGTGAATCCCCTGGGGGCGCTTTCTGGAGTACCTACGAGCAGTACTTC	CASSESPGGAFWSTYEQYF	TRBV6-1	TRBJ2-7
TGTGCCAGCAGCTTGGCTCTCCACCTCTTGAACACTGAAGCTTTCTTT	CASSLALHLLNTEAFF	TRBV5-4	TRBJ1-1
TGTGCCAGCAGCGTGAACAGGGGGCCCGAAAAACTGTTTTTT	CASSVNRGPEKLFF	TRBV9	TRBJ1-4
TGTGCCAGCAGCTTATCGAAACCAGGATCCTACGAGCAGTACTTC	CASSLSKPGSYEQYF	TRBV7-7	TRBJ2-7
TGTGCCAGCAGTCCGGGAGTTTGGGCCTATGGCTACACCTTC	CASSPGVWAYGYTF	TRBV5-4	TRBJ1-2
TGTGCCAGCAGCTGTCTAGCGGTCACAGATACGCAGTATTTT	CASSCLAVTDTQYF	TRBV7-4	TRBJ2-3
TGTGCCAGCAGCTCGATGGGGCATGTCTACGAGCAGTACTTC	CASSSMGHVYEQYF	TRBV13	TRBJ2-7
TGTGCCAGCAGTTTACCCCCCCAGGACAGGGACCAAACCTACGAGCAGTACTTC	CASSLPPQDRDQTYEQYF	TRBV28	TRBJ2-7
TGCGCCAGCAGGCTTCAACTTGGACAGGGATTCGCTTTCTTT	CASRLQLGQGFAFF	TRBV5-1	TRBJ1-1
TGTGCCAGCAGCTTACAGGGGAAGTACTTC	CASSLQGKYF	TRBV7-9	TRBJ2-7
TGTGCCAGCAGGGCTAGAGCCCTACAGGGGCGGGAAGGAAATGAGCAGTTCTTC	CASRARALQGREGNEQFF	TRBV7-2	TRBJ2-1
TGTGCCAGCAGTGAGGCCACAGGAATCCAGACCAATCAGCCCCAGCATTTT	CASSEATGIQTNQPQHF	TRBV2	TRBJ1-5
TGCGCCAGCAGCTCCCCCCCCCCCTGGACCCCTATATTCCGTGTTCCCTTTAAAGAGACCCAGTACTTC	CASSSPPPWTPIFRVPFKETQYF	TRBV5-1	TRBJ2-5
TGCATTATATGGACAGAGAAGAACGAGCAGTACTTC	CIIWTEKNEQYF	TRBV29-1	TRBJ2-7
TGTGCCAGCAGATCAGGGCGAGGCACTGAAGCTTTCTTT	CASRSGRGTEAFF	TRBV7-9	TRBJ1-1
TGCGCCAGCAGCCAACGATCCCACAGGGACGGTCAGCCCCAGCATTTT	CASSQRSHRDGQPQHF	TRBV4-1	TRBJ1-5
TGTGCCAGCAGCGGGGGGGAGAACTATGGCTACACCTTC	CASSGGENYGYTF	TRBV9	TRBJ1-2
TGCGCCAGCAGCAGAGGGGTTTCCGAGCCCTCCTCCTACGAGCAGTACTTC	CASSRGVSEPSSYEQYF	TRBV5-1	TRBJ2-7
TGCGCCAGCAGTGAATCCCCGGGACAGGGGGGGTACTTC	CASSESPGQGGYF	TRBV10-1	TRBJ2-7
TGTGCCAGCAGTTACCTGGACAGGGATGGAGGGGGCGCAACTGAAGCTTTCTTT	CASSYLDRDGGGATEAFF	TRBV6-2	TRBJ1-1
TGTGCCAGCAGTTCCCCCCGGTTTCACGACTATGGCTACACCTTC	CASSSPRFHDYGYTF	TRBV28	TRBJ1-2
TGTGCCACCAGTGATTCCAGCAGGGCGGTTGGGGCCAACGTCCTGACTTTC	CATSDSSRAVGANVLTF	TRBV24-1	TRBJ2-6
TGTGCCAGGGGACAGGATCAGCCCCAGCATTTT	CARGQDQPQHF	TRBV27	TRBJ1-5
TGTGCCAGATCCGCCCGGGACGAAAACGGCTACGAGCAGTACTTC	CARSARDENGYEQYF	TRBV6-1	TRBJ2-7
TGCGCCAGCAGCCAAGTTCCGGGACAGTTCAATCAGCCCCAGCATTTT	CASSQVPGQFNQPQHF	TRBV4-1	TRBJ1-5
TGTGCCAGCAGTTATGGGGGATACACTGAAGCTTTCTTT	CASSYGGYTEAFF	TRBV27	TRBJ1-1
TGTGCCTGGAGTAAGCGGCCCGGGCTAGCGGAAGAGACCCAGTACTTC	CAWSKRPGLAEETQYF	TRBV30	TRBJ2-5
TGTGCCAGCAGCCCCCAGGTAAAGGGAAGCAATCAGCCCCAGCATTTT	CASSPQVKGSNQPQHF	TRBV6-1	TRBJ1-5
TGTGCCAGTGTCCTGCAGAACGAGCAGTACTTC	CASVLQNEQYF	TRBV19	TRBJ2-7
TGTGCCAGTAGTATAGCTCCAGGCATTCCGAACGGCTACACCTTC	CASSIAPGIPNGYTF	TRBV19	TRBJ1-2
TGTGCCTGGAGTGTACCGAGGGCTTTCCACTTC	CAWSVPRAFHF	TRBV30	TRBJ2-7
TGTGCCAGCAGCGTAGATCTAGCGGGAGAGTCCAACGAGCAGTACTTC	CASSVDLAGESNEQYF	TRBV9	TRBJ2-7
TGTGCCAGCCCTAGAGAGCGCTATGGCTACACCTTC	CASPRERYGYTF	TRBV28	TRBJ1-2
TGCGCCAGCAGCAAGTGCGTCAATCAGCCCCAGCATTTT	CASSKCVNQPQHF	TRBV5-1	TRBJ1-5
TGCAGCGCCAGCCCCGCAACTAGCGGGTATTTT	CSASPATSGYF	TRBV29-1	TRBJ2-3
TGTGCCAGCAGAACGGTAAGACAGGTTATTACGAATCAGCCCCAGCATTTT	CASRTVRQVITNQPQHF	TRBV6-4	TRBJ1-5
TGTGCCAGTAGTCGGACAGGAGGGACAGGTGTTGGGTCTGGGGCCAACGTCCTGACTTTC	CASSRTGGTGVGSGANVLTF	TRBV19	TRBJ2-6
TGTGCCAGCAAAATGTGGGGGGGGCCGAAAGTGGAGACCCAGTACTTC	CASKMWGGPKVETQYF	TRBV27	TRBJ2-5
TGTGCCAGCAGCTTAGTAATCCCCGGGGGCACAGATACGCAGTATTTT	CASSLVIPGGTDTQYF	TRBV7-6	TRBJ2-3
TGTGCCATCAGAACAGGGGGCGAAAAACTGTTTTTT	CAIRTGGEKLFF	TRBV10-3	TRBJ1-4
TGTGCCAGCACGGGGGAGGGCCGAATGCCCCAGCATTTT	CASTGEGRMPQHF	TRBV27	TRBJ1-5
TGTGCCAGCAGCTTACCCAACTTCGAGCCCCAGCATTTT	CASSLPNFEPQHF	TRBV7-4	TRBJ1-5
TGTGCCAGCAGTTGGAGGGTCTGCACAGATACGCAGTATTTT	CASSWRVCTDTQYF	TRBV27	TRBJ2-3
TGTGCCAGCAGGATTCAGGGGGTGAACACTGAAGCTTTCTTT	CASRIQGVNTEAFF	TRBV6-5	TRBJ1-1
TGTGCCAGCAGCTTGATGGGCCCGGATGAAAAACTGTTTTTT	CASSLMGPDEKLFF	TRBV5-6	TRBJ1-4
TGCAGCGTTGATTCAGGGGGGGGAAGGGCCGGGGAGCTGTTTTTT	CSVDSGGGRAGELFF	TRBV29-1	TRBJ2-2
TGTGCCAGCAGCAGCTACCCGGACAGCTACAATGAGCAGTTCTTC	CASSSYPDSYNEQFF	TRBV13	TRBJ2-1
TGTGCCAGCCGGACAGGGGGAGAGGATGGCTACACCTTC	CASRTGGEDGYTF	TRBV28	TRBJ1-2
TGCGCCAGCAGTAGGGGACTCCGAGGAGTGCGGAGGGCTAGCAATCAGCCCCAGCATTTT	CASSRGLRGVRRASNQPQHF	TRBV10-1	TRBJ1-5
TGTGCCAGCAAGGAGGAGGGTTATAATTCACCCCTCCACTTT	CASKEEGYNSPLHF	TRBV28	TRBJ1-6
TGTGCCAGCAGCGAGGCGGGGGCGAGACGAAAACTGTTTTTT	CASSEAGARRKLFF	TRBV5-4	TRBJ1-4
TGCAGTGCTAGCGGGGCCTCCTACGAGCAGTACTTC	CSASGASYEQYF	TRBV20-1	TRBJ2-7
TGCAGTGCTAGAGTATGCCACGGACAGGGAAGGATAACCAAAAACATTCAGTACTTC	CSARVCHGQGRITKNIQYF	TRBV20-1	TRBJ2-4
TGTGCCAGCAGTGAATGGATGGGGGCAAACTATGGCTACACCTTC	CASSEWMGANYGYTF	TRBV25-1	TRBJ1-2
TGTGCCAGCAGTTTCTACCGGGGGACTGAAGCTTTCTTT	CASSFYRGTEAFF	TRBV12-3	TRBJ1-1
TGTGCCAGCAGCAATGATGGTGAAGCTTTCTTT	CASSNDGEAFF	TRBV3-1	TRBJ1-1
TGTGCCAGCAGCCCCCCTTTGGATGTTACCTACGAGCAGTACTTC	CASSPPLDVTYEQYF	TRBV5-6	TRBJ2-7
TGCGCCAGCAGCCAAGGTAATTTCACAGGGTTGGGGAACCACTATGGCTACACCTTC	CASSQGNFTGLGNHYGYTF	TRBV4-1	TRBJ1-2
TGTGCCGGACAGGGAGAGACCCAGTACTTC	CAGQGETQYF	TRBV27	TRBJ2-5
