TGTGCCAGCAGCCCATTAACCCGGGCTAGCTCCTACAATGAGCAGTTCTTC	CASSPLTRASSYNEQFF	TRBV13	TRBJ2-1
TGTGCCAGCAGCTTAGATCGGCTAGGCCACCAAGAGACCCAGTACTTC	CASSLDRLGHQETQYF	TRBV11-3	TRBJ2-5
TGTGCCAGCAGCTCTAACAGGGTGAAGGCCGGGGAGCTGTTTTTT	CASSSNRVKAGELFF	TRBV5-6	TRBJ2-2
TGTGCCAGCAGCTTATTTGGGGGCCGGAACTATGGCTACACCTTC	CASSLFGGRNYGYTF	TRBV7-4	TRBJ1-2
TGTGCTAGTGGAACGGGGAGCTACGAGCAGTACTTC	CASGTGSYEQYF	TRBV12-5	TRBJ2-7
TGTGCCAGCAGCAGAGGAAGGGGGGCGGGGGGAAATGAGCAGTTCTTC	CASSRGRGAGGNEQFF	TRBV7-2	TRBJ2-1
TGTGCCAGCAGTGGGGGGACAGGGGGGTACACTGAAGCTTTCTTT	CASSGGTGGYTEAFF	TRBV6-1	TRBJ1-1
TGTGCCAGCAGCGGGACAGGAGCGGACGAGCAGTACTTC	CASSGTGADEQYF	TRBV13	TRBJ2-7
TGTGCCACCAGCAGAGATGTCTCGGATGGACAGGGAAAGTTCAATCAGCCCCAGCATTTT	CATSRDVSDGQGKFNQPQHF	TRBV15	TRBJ1-5
TGTGCCAGCAGCTCCATACGCCTAGCGGGGAAAGATACGCAGTATTTT	CASSSIRLAGKDTQYF	TRBV13	TRBJ2-3
TGTGCCAGCAGCTTGACCCCTGGGACAGCGTTCTTC	CASSLTPGTAFF	TRBV7-4	TRBJ2-1
TGTGCCACCACACCCCTCCCTAGCGGGCCTAAGTACAATGAGCAGTTCTTC	CATTPLPSGPKYNEQFF	TRBV24-1	TRBJ2-1
TGCAGCGTCCTGGGACCTAGGGGGAGGACTGAAGCTTTCTTT	CSVLGPRGRTEAFF	TRBV29-1	TRBJ1-1
TGTGCCAGCAGTTACCCCAGCCCCACTAACTATGGCTACACCTTC	CASSYPSPTNYGYTF	TRBV6-3	TRBJ1-2
TGCGCCAGCAGTGAGAAAGCGGCCAGCGACCAAGAGACCCAGTACTTC	CASSEKAASDQETQYF	TRBV10-1	TRBJ2-5
TGTGCCAGCAGCGTCCTAGGGGGATTACCCTACGAGCAGTACTTC	CASSVLGGLPYEQYF	TRBV9	TRBJ2-7
TGTGCCAGCAGTTTAAGGGAGGGACGAAATGGCTACACCTTC	CASSLREGRNGYTF	TRBV27	TRBJ1-2
TGCAGCGTTGAGAGTACTTTATGGAGGACTACCGGATCCAAGCCCTATGGCTACACCTTC	CSVESTLWRTTGSKPYGYTF	TRBV29-1	TRBJ1-2
TGCGCCAGCAGCCAAGCCAGGCCGGACAAAGGCAGACAGCCCCAGCATTTT	CASSQARPDKGRQPQHF	TRBV4-1	TRBJ1-5
TGTGCCAGCAGTTTACCTTTCAGGGTGGGCAATCAGCCCCAGCATTTT	CASSLPFRVGNQPQHF	TRBV28	TRBJ1-5
TGTGCCGTTACAGGGCGTTTGGAGGTATGTAATGAAAAACTGTTTTTT	CAVTGRLEVCNEKLFF	TRBV9	TRBJ1-4
TGTGCCAGCAGCTTAGCCTTAGAACTGTACAATGAGCAGTTCTTC	CASSLALELYNEQFF	TRBV11-3	TRBJ2-1
TGTGCCAGCAGTTACTTAGACAGGGCGGGTAGAGGCTACACCTTC	CASSYLDRAGRGYTF	TRBV6-5	TRBJ1-2
TGTGCCAGCTCACCATGGGACATAGCGGGAGCTCGGGCCGGGGAGCTGTTTTTT	CASSPWDIAGARAGELFF	TRBV18	TRBJ2-2
TGTGCCAGTAGCGAGGGGACAGGGGAAAGTTTATACAGTGGCTACACCTTC	CASSEGTGESLYSGYTF	TRBV19	TRBJ1-2
TGTGCCAGCAGTGAAGGGCATCCTTTGGGACAGTCTAGCAATCAGCCCCAGCATTTT	CASSEGHPLGQSSNQPQHF	TRBV6-1	TRBJ1-5
TGCGAATTAAGGTTGGAAAATGGCTACACCTTC	CELRLENGYTF	TRBV5-1	TRBJ1-2
TGTGCCAGCAGGCCCAGCTCCTACGAGCAGTACTTC	CASRPSSYEQYF	TRBV28	TRBJ2-7
TGTGCCAGCAGGGTCCGGGGCGGGCAAGTGAACACTGAAGCTTTCTTT	CASRVRGGQVNTEAFF	TRBV9	TRBJ1-1
TGTGCCAGCAGTTTCCTCGAGTACTACGAGCAGTACTTC	CASSFLEYYEQYF	TRBV28	TRBJ2-7
TGCAGTGCTAGAGATCCGACAGGGAATACTGCTTTCTTT	CSARDPTGNTAFF	TRBV20-1	TRBJ1-1
TGTGCCAGCAGTTTCGATCGCCAGGGAGTTCAAACCGCAACTAATGAAAAACTGTTTTTT	CASSFDRQGVQTATNEKLFF	TRBV27	TRBJ1-4
TGTGCCTGGAGTGTACGCCGGGTAGCCAAAAACATTCAGTACTTC	CAWSVRRVAKNIQYF	TRBV30	TRBJ2-4
TGTGCCTGGGCGCTTCCTCAAATGGGGGGGTTGGGCGAGCAGTACTTC	CAWALPQMGGLGEQYF	TRBV30	TRBJ2-7
TGTGCTAGTGGTTTAAGGCGGCTAGCGGGCACAGATACGCAGTATTTT	CASGLRRLAGTDTQYF	TRBV12-5	TRBJ2-3
TGCGCCAGCAGCCCCTACGTCACAGATACGCAGTATTTT	CASSPYVTDTQYF	TRBV5-1	TRBJ2-3
TGTGCCAGCAGCTTAGCCTTGGCACCGGGATTTCTATCCTATAATTCACCCCTCCACTTT	CASSLALAPGFLSYNSPLHF	TRBV11-3	TRBJ1-6
TGCAGTGCACTGGCGAGGGGAGATACGCAGTATTTT	CSALARGDTQYF	TRBV20-1	TRBJ2-3
TGTGCCACCAGTTCACCTGCGGGACATAACTGGGGCGAGCAGTACTTC	CATSSPAGHNWGEQYF	TRBV24-1	TRBJ2-7
TGTGCCAGTAGTACCCGGGACCACCTTTTGAACACTGAAGCTTTCTTT	CASSTRDHLLNTEAFF	TRBV19	TRBJ1-1
TGTGCCAGCAGGATGATACCCGACTCCTACGAGCAGTACTTC	CASRMIPDSYEQYF	TRBV27	TRBJ2-7
TGTGCCAGCAGCCACTTTAGACCGGCGAAAGAGACCCAGTACTTC	CASSHFRPAKETQYF	TRBV14	TRBJ2-5
TGTGCCAGCAGTTCCCGTCGGGGGTTCGGACGGGATCCAACTGAAGCTTTCTTT	CASSSRRGFGRDPTEAFF	TRBV12-3	TRBJ1-1
TGTGCCAGCAGGGGATTCGTACAGGGGGATCAGCCCCAGCATTTT	CASRGFVQGDQPQHF	TRBV27	TRBJ1-5
TGTGCCAGCAGCACTATCAGGGAGTACTCCTACGAGCAGTACTTC	CASSTIREYSYEQYF	TRBV9	TRBJ2-7
TGTGCCAAACATAAGGGGGCTTGTCACGAGCAGTACTTC	CAKHKGACHEQYF	TRBV6-3	TRBJ2-7
TGCGCCAGCAGCTTGCCCGACCTAACCTACGAGCAGTACTTC	CASSLPDLTYEQYF	TRBV5-1	TRBJ2-7
TGTGCCAGCAGCGAGAGCAGAATGAGGCAAGAGACCCAGTACTTC	CASSESRMRQETQYF	TRBV5-5	TRBJ2-5
TGCAGTCCGGGGGGGAGCTCCTACGAGCAGTACTTC	CSPGGSSYEQYF	TRBV20-1	TRBJ2-7
TGTGCCATCAAGTTCGGGCCACGTAGGGGAAGCACTGAAGCTTTCTTT	CAIKFGPRRGSTEAFF	TRBV10-3	TRBJ1-1
TGTGCCAGCGACAATCGGGACAGGGGAAGTGCGAACACCGGGGAGCTGTTTTTT	CASDNRDRGSANTGELFF	TRBV6-4	TRBJ2-2
TGTGCCAGCACTAACCTGTCACGCTACGAGCAGTACTTC	CASTNLSRYEQYF	TRBV6-5	TRBJ2-7
TGCAGTGCTAGAAACTTACTAGCGGCCGGGGCCTACGAGCAGTACTTC	CSARNLLAAGAYEQYF	TRBV20-1	TRBJ2-7
TGTGCCAGCAGCAGGAAGAAGTCCTACGAGCAGTACTTC	CASSRKKSYEQYF	TRBV9	TRBJ2-7
TGCGCCAGCAGCCAAGGAGCGGGGAACGAGCAGTACTTC	CASSQGAGNEQYF	TRBV4-1	TRBJ2-7
TGTGCCAGCTATGGGGGTCCCTACGAGCAGTACTTC	CASYGGPYEQYF	TRBV25-1	TRBJ2-7
TGTGTTTACGAAGAGACCCAGTACTTC	CVYEETQYF	TRBV24-1	TRBJ2-5
TGTGCCAGCAGCTTGCGGGACGTAACCAATCAGCCCCAGCATTTT	CASSLRDVTNQPQHF	TRBV5-6	TRBJ1-5
TGCGCCAGCAGCTTGTTTGACCGGGGGCCGAACACCGGGGAGCTGTTTTTT	CASSLFDRGPNTGELFF	TRBV5-1	TRBJ2-2
TGTGCCAGCAGAGTAATCCCTTCGACAGGGGGCTTCGCGGGCGCCTACGAGCAGTACTTC	CASRVIPSTGGFAGAYEQYF	TRBV6-4	TRBJ2-7
TGTGCCAGCAGCGGTGGACAGGGTGGCAATCAGCCCCAGCATTTT	CASSGGQGGNQPQHF	TRBV9	TRBJ1-5
TGTGCCAGCAGCGGGACAGGGGAGGTCTATGGCTACACCTTC	CASSGTGEVYGYTF	TRBV13	TRBJ1-2
TGTGCCAGCAGTACCAGGGGCACAGATACGCAGTATTTT	CASSTRGTDTQYF	TRBV6-3	TRBJ2-3
TGTGCCACCAGTGCGGGGGCCCCTAGATACAATGAGCAGTTCTTC	CATSAGAPRYNEQFF	TRBV24-1	TRBJ2-1
TGTGCCAGCAGTTTAAGAACGGGGGGCTCCTACAATGAGCAGTTCTTC	CASSLRTGGSYNEQFF	TRBV27	TRBJ2-1
TGTGCCAGCAGTTTATGGGGACAGGGGAAGTTCTGTAACTATGGCTACACCTTC	CASSLWGQGKFCNYGYTF	TRBV28	TRBJ1-2
TGTGCCATCTGGAAGTCAAGGGGGCCTTCAGCGACCACAGATACGCAGTATTTT	CAIWKSRGPSATTDTQYF	TRBV10-3	TRBJ2-3
TGTGCCAGCTCAATCAAAGGGGGGGCCTATGGCTACACCTTC	CASSIKGGAYGYTF	TRBV18	TRBJ1-2
TGCGCCAGATTTCCGGGACTAGCGGGATTCTCCTACGAGCAGTACTTC	CARFPGLAGFSYEQYF	TRBV10-2	TRBJ2-7
TGTGCCAGCAGCTTCTCCTCAGACCGGCAGGGGGCCTATGGCTACACCTTC	CASSFSSDRQGAYGYTF	TRBV11-3	TRBJ1-2
TGTGCCAGCAAAGATAGCGGGCCGCAGTATTTT	CASKDSGPQYF	TRBV28	TRBJ2-3
TGTGCCAGCAGTTTAAGACCTAGCACAGATACGCAGTATTTT	CASSLRPSTDTQYF	TRBV27	TRBJ2-3
TGCGCCACAGGACAGGGGCGAAGTAATCAGCCCCAGCATTTT	CATGQGRSNQPQHF	TRBV5-1	TRBJ1-5
TGCAGTGCTACCCGGGGACTGTGCTACGAGCAGTACTTC	CSATRGLCYEQYF	TRBV20-1	TRBJ2-7
TGTGCCAGCAGCCACCCCCTCCCCGCCAGGGATGACTTGACCTACGAGCAGTACTTC	CASSHPLPARDDLTYEQYF	TRBV4-2	TRBJ2-7
TGCAGTGCTAGAGTGGGGGCCTACGAGCAGTACTTC	CSARVGAYEQYF	TRBV20-1	TRBJ2-7
TGCAGTGCGGGGGAGGGGGGAAACACCATATATTTT	CSAGEGGNTIYF	TRBV20-1	TRBJ1-3
TGTGCCAGCTCACCGTTCTGGATACGTTCACTAGCGGGGGGGGGCACCGGGGAGCTGTTTTTT	CASSPFWIRSLAGGGTGELFF	TRBV18	TRBJ2-2
TGTGCCAGCAGCCCGGGACACAGCTCCTACAATGAGCAGTTCTTC	CASSPGHSSYNEQFF	TRBV7-9	TRBJ2-1
TGTGCCAGCAGTTATTCCCTGGGGCGCGAGCAGTACTTC	CASSYSLGREQYF	TRBV6-9	TRBJ2-7
TGTGCCAGCAGCTTAGTTATATCTGACAGGCTGTTTTTT	CASSLVISDRLFF	TRBV7-4	TRBJ2-2
TGTGCCAGCGTTTGGGACTGCCATACGCAGTATTTT	CASVWDCHTQYF	TRBV19	TRBJ2-3
TGTGCCAGCATGCCTTATGGGGGGCCCAGGGCGGTTGTCCTCCACGGGAGGCACTACGAGCAGTACTTC	CASMPYGGPRAVVLHGRHYEQYF	TRBV6-2	TRBJ2-7
TGTGCCAGCAGCCAAACATGGGGGGGCGCTGAGCAGTTCTTC	CASSQTWGGAEQFF	TRBV14	TRBJ2-1
TGTGCCAGCAGCTGTCGGGGTCCTGGTAACTATGGCTACACCTTC	CASSCRGPGNYGYTF	TRBV11-3	TRBJ1-2
TGTGCCAGCAGTTACCGTTCGGGACAGTTTTTCAATGAGCAGTTCTTC	CASSYRSGQFFNEQFF	TRBV6-6	TRBJ2-1
TGCAGTGCGCAAGGGAGATCCAGCTATGGCTACACCTTC	CSAQGRSSYGYTF	TRBV20-1	TRBJ1-2
TGCAGTGCTAGAGATAGCGACCCTCGGACGGGTCGTGCGAACACTGAAGCTTTCTTT	CSARDSDPRTGRANTEAFF	TRBV20-1	TRBJ1-1
TGTGCCAGCAGCGTGAAAGGTCAGCCCCAGCATTTT	CASSVKGQPQHF	TRBV11-2	TRBJ1-5
TGTGCCAGTGACCACTATGGCTACACCTTC	CASDHYGYTF	TRBV7-3	TRBJ1-2
TGTGCCAGCAGTTACTCGACCGGGCGGGGGGGTAGCTCCTACAATGAGCAGTTCTTC	CASSYSTGRGGSSYNEQFF	TRBV6-6	TRBJ2-1
TGTGCCTCCGGCCTGGGGGACAGGAGGTGTTACTCCTATAATTCACCCCTCCACTTT	CASGLGDRRCYSYNSPLHF	TRBV10-3	TRBJ1-6
TGTGCCAGCAGTGAGACAGGGGCTAATGAAAAACTGTTTTTT	CASSETGANEKLFF	TRBV6-4	TRBJ1-4
TGTGCCAGCAGCCAGTCAGGGGAGCGATGTTACGTGAACACTGAAGCTTTCTTT	CASSQSGERCYVNTEAFF	TRBV7-9	TRBJ1-1
TGTGCCACCAGTGAAAGCTGTGGAGGGGGCAAAGCTTTCTTT	CATSESCGGGKAFF	TRBV24-1	TRBJ1-1
TGTGCCAGCAGTACTACACACTGGACAGGGGGCCCCTCGGGGGATCAGGGTAGTGAAAAACTGTTTTTT	CASSTTHWTGGPSGDQGSEKLFF	TRBV7-9	TRBJ1-4
TGTGCCAGCAGTTTCTCCGAAGGGACAGCCTATGGCTACACCTTC	CASSFSEGTAYGYTF	TRBV28	TRBJ1-2
TGTGCCAGCAGTGACGATAGCGGGTACGGCACAGATACGCAGTATTTT	CASSDDSGYGTDTQYF	TRBV6-1	TRBJ2-3
TGTGCCAGCACGTCTTTAGCAGATACGCAGTATTTT	CASTSLADTQYF	TRBV9	TRBJ2-3
TGTGCCAGCAGTGGAAAACACCCTGAGCAGTTCTTC	CASSGKHPEQFF	TRBV27	TRBJ2-1
