TGTGCCAGCAGACCTTTGACCGGCGGTTTGGGGAAAAACATTCAGTACTTC	CASRPLTGGLGKNIQYF	TRBV9	TRBJ2-4
TGTGCCAGCAGCGTAGACGATCCTCTGACAGGGCGTAACTCTGGAAACACCATATATTTT	CASSVDDPLTGRNSGNTIYF	TRBV13	TRBJ1-3
TGCGCCAGCAGTGAAAAGCAGGCGGGGGAAAACACCGGGGAGCTGTTTTTT	CASSEKQAGENTGELFF	TRBV10-1	TRBJ2-2
TGTGCCAGCAGCCCACCCGGGGGGGCCCACTCTGGAAACACCATATATTTT	CASSPPGGAHSGNTIYF	TRBV7-2	TRBJ1-3
TGCAGTGCTAGAGGCCGAACCCAGGGGGCCGGCCCGTGTCGGAATGAAAAACTGTTTTTT	CSARGRTQGAGPCRNEKLFF	TRBV20-1	TRBJ1-4
TGTGCCAGCAGTGGTCTAGGCACCAGGGGGCTCCCAACACGAAACACCATATATTTT	CASSGLGTRGLPTRNTIYF	TRBV6-1	TRBJ1-3
TGTGCCAGCAGGCTTTATCAGCCCCAGCATTTT	CASRLYQPQHF	TRBV7-2	TRBJ1-5
TGTGCCAGCAGCCGAGGAACTAGCGGGGGGGCCGGAGACAATGAGCAGTTCTTC	CASSRGTSGGAGDNEQFF	TRBV9	TRBJ2-1
TGTGCCTGGACTTCCCGGGACAGAGATAGCAATCAGCCCCAGCATTTT	CAWTSRDRDSNQPQHF	TRBV30	TRBJ1-5
TGTGCCAGCAGTTTATCTCACCCGACAGATAGGGACACCGGGGAGCTGTTTTTT	CASSLSHPTDRDTGELFF	TRBV28	TRBJ2-2
TGTGCCAGCAGCGACACATGTTTGTATTTT	CASSDTCLYF	TRBV13	TRBJ2-3
TGTGCCAGCAGCTTAGTCTCGGGGCCCCGACCCTACAATGAGCAGTTCTTC	CASSLVSGPRPYNEQFF	TRBV7-9	TRBJ2-1
TGCGCCAGCAGTGACCCAACGCACAGGCGGATTGGCTACACCTTC	CASSDPTHRRIGYTF	TRBV10-1	TRBJ1-2
TGTGCCTGGAGTGAGGACTCTGAGCAGTTCTTC	CAWSEDSEQFF	TRBV30	TRBJ2-1
TGCGCCAGCAGCCTGCCCGACTGGCTAGCGGGCACAGATACGCAGTATTTT	CASSLPDWLAGTDTQYF	TRBV4-1	TRBJ2-3
TGTGCCAGCAGCTTTGGGACTAGCTACACAGATACGCAGTATTTT	CASSFGTSYTDTQYF	TRBV7-2	TRBJ2-3
TGTGCCAGCAGCGTCAGGGAATATCAGCCCCAGCATTTT	CASSVREYQPQHF	TRBV13	TRBJ1-5
TGTGCCAGCAGCCAAGATAGAAGGGACACCGGGGAGCTGTTTTTT	CASSQDRRDTGELFF	TRBV4-2	TRBJ2-2
TGTGCCACCCATCCACAAGGCCCGGCACATGGAAACACCATATATTTT	CATHPQGPAHGNTIYF	TRBV24-1	TRBJ1-3
TGCGCCAGCAGCTTGTCTACCGACTTCCGTCCCCAAGAGACCCAGTACTTC	CASSLSTDFRPQETQYF	TRBV5-1	TRBJ2-5
TGTGCCAGCAGTAACCTCGGTCCGGAATGGTGGACTAGCGGGACGTCAGATACGCAGTATTTT	CASSNLGPEWWTSGTSDTQYF	TRBV5-6	TRBJ2-3
TGTGCCAGCAGTTTACCAGCGGTGCGTGGGACGGGGACTGAAGCTTTCTTT	CASSLPAVRGTGTEAFF	TRBV28	TRBJ1-1
TGCGCCAGCGGAAGTAAAGTAGCGGGGGGACATGGGCAGAAGACCCAGTACTTC	CASGSKVAGGHGQKTQYF	TRBV10-2	TRBJ2-5
TGTGCCAGCAGTGACGGGGGGACAGGGGGGGGCGAGCAGTACTTC	CASSDGGTGGGEQYF	TRBV6-4	TRBJ2-7
TGTGCCAGCAGCCCGGCCTTTACTACATGGGGACGGGGGCAGCCCCAGCATTTT	CASSPAFTTWGRGQPQHF	TRBV11-2	TRBJ1-5
TGCGCCAGCAGGATGTACTCCTACGAGCAGTACTTC	CASRMYSYEQYF	TRBV4-1	TRBJ2-7
TGCGCCAGCAGTGAGTCGGGGGGGCCGGATACGCAGTATTTT	CASSESGGPDTQYF	TRBV10-1	TRBJ2-3
TGTGAGCCGGGACAGGGGCTTGCCGGCTACACCTTC	CEPGQGLAGYTF	TRBV6-4	TRBJ1-2
TGTGCCAGCAGCCGTTCCCTGGGACAGGGATTCCGGTACCAAGAGACCCAGTACTTC	CASSRSLGQGFRYQETQYF	TRBV7-3	TRBJ2-5
TGCGCCAGCAGCTTCAGGAAGGACAGGGTTGGCACCGGGGAGCTGTTTTTT	CASSFRKDRVGTGELFF	TRBV5-1	TRBJ2-2
TGTGCCAGCAGCGACAGGGGCACAACTAATGAAAAACTGTTTTTT	CASSDRGTTNEKLFF	TRBV9	TRBJ1-4
TGCGCCCGGGACAGGGGGACATCCGGGGAGCTGTTTTTT	CARDRGTSGELFF	TRBV10-1	TRBJ2-2
TGCGCCAGCAGTGAGGTTCCGGACAGGATACGGAGGAACACTGAAGCTTTCTTT	CASSEVPDRIRRNTEAFF	TRBV10-1	TRBJ1-1
TGCAGTGCTGTGCGACAGTGTATTCCGGCCTACGAGCAGTACTTC	CSAVRQCIPAYEQYF	TRBV20-1	TRBJ2-7
TGTGCCACCCTGAGAAAGACGGGGTTCTTT	CATLRKTGFF	TRBV18	TRBJ1-1
TGTGCCAGCAGCGCAGAAAGGGGTTACGCCTACGAGCAGTACTTC	CASSAERGYAYEQYF	TRBV11-3	TRBJ2-7
TGCAGTGCTAGGGTTCCGGGGGAGCATTTT	CSARVPGEHF	TRBV20-1	TRBJ1-5
TGTGCCAGAAAGGGGCGCCTAAAAGGCTACACCTTC	CARKGRLKGYTF	TRBV6-4	TRBJ1-2
TGCAGTGCTAGAGATCCCCGACAGGTAGCCCACTCCTACGAGCAGTACTTC	CSARDPRQVAHSYEQYF	TRBV20-1	TRBJ2-7
TGTGCCAGCAGGGTATCCTACGAGCAGTACTTC	CASRVSYEQYF	TRBV7-3	TRBJ2-7
TGTGCCAGCAGTGGGGCACGCCCCGGGGTGAGGAGTTGCCCGCAGTACTTC	CASSGARPGVRSCPQYF	TRBV12-3	TRBJ2-7
TGTGCCAGCAGTTATACGGGCGGACAGGGGGCCAGGAACACTGAAGCTTTCTTT	CASSYTGGQGARNTEAFF	TRBV6-5	TRBJ1-1
TGTGCCACCAGTGGCGGGGGGCATTCACCCCTCCACTTT	CATSGGGHSPLHF	TRBV24-1	TRBJ1-6
TGTGCCAGCAGCTTTCGGGACAGGGCCTACGAGCAGTACTTC	CASSFRDRAYEQYF	TRBV6-4	TRBJ2-7
TGTGCCAGCAGCTTACGATCAGGGGGCTACCGCTACGAGCAGTACTTC	CASSLRSGGYRYEQYF	TRBV7-3	TRBJ2-7
TGTGCCTCCCCTGGCCGGGACAGCAGCAATCAGCCCCAGCATTTT	CASPGRDSSNQPQHF	TRBV24-1	TRBJ1-5
TGTGCCAGCAGTGTAGAAGAGCAGTACTTC	CASSVEEQYF	TRBV6-4	TRBJ2-7
TGTGCCAGCAGCCTTCCCACCGCGCTGAACACTGAAGCTTTCTTT	CASSLPTALNTEAFF	TRBV13	TRBJ1-1
TGCAGCGTGGACCAGGGCTGTAGGGGGATCTCCTACGAGCAGTACTTC	CSVDQGCRGISYEQYF	TRBV29-1	TRBJ2-7
TGTGCCAGCAGTTCAGCGAGGGCCTACGAGCAGTACTTC	CASSSARAYEQYF	TRBV27	TRBJ2-7
TGTGCCAGCAGACCGGGTGGCAATCAGCCCCAGCATTTT	CASRPGGNQPQHF	TRBV6-1	TRBJ1-5
TGTGCCAGCAGTTACCAGAATTCTGTGAACACTGAAGCTTTCTTT	CASSYQNSVNTEAFF	TRBV6-5	TRBJ1-1
TGTGCCAGCAGCGTAGGCCCACCATTACAACAGCATGAAAAACTGTTTTTT	CASSVGPPLQQHEKLFF	TRBV9	TRBJ1-4
TGCGCCAGCAGTGAGTCACGCGGGGCTTATAGCAATCAGCCCCAGCATTTT	CASSESRGAYSNQPQHF	TRBV10-1	TRBJ1-5
TGTGCCATCAGTGGGCCGACAGGGAGGCTCGATCAGCCCCAGCATTTT	CAISGPTGRLDQPQHF	TRBV10-3	TRBJ1-5
TGTGCCAGCAGCTTAGGGACGCAGTTCTTC	CASSLGTQFF	TRBV7-9	TRBJ2-1
TGTGCCAGCAGTTTATTCTATGCAGGCAACGCTTTCTTT	CASSLFYAGNAFF	TRBV27	TRBJ1-1
TGTGCCAGTAGTATCCCCTGGACAGAGAACTATGGCTACACCTTC	CASSIPWTENYGYTF	TRBV19	TRBJ1-2
TGTGCCAGCAGAAGGGGACAGCCAGTTAACTATGGCTACACCTTC	CASRRGQPVNYGYTF	TRBV6-2	TRBJ1-2
TGTGCCAGCAGTTTCGCCACAGGGGTAAACACTGAAGCTTTCTTT	CASSFATGVNTEAFF	TRBV28	TRBJ1-1
TGTGCCAGCAGCTTAAATCGGACAGCATCGGGGCCGAAGCCCTTAGAGACCCAGTACTTC	CASSLNRTASGPKPLETQYF	TRBV7-3	TRBJ2-5
TGCAGTGCTCCCGGGCTAAAGCCCAGACTAGCGGGCTCCTACGAGCAGTACTTC	CSAPGLKPRLAGSYEQYF	TRBV20-1	TRBJ2-7
TGCAGTGCTAGGCAAGGCACAGATACGCAGTATTTT	CSARQGTDTQYF	TRBV20-1	TRBJ2-3
TGTGCCAGCAGACCCGGGGACAGCCGGGAAAACACCGGGGAGCTGTTTTTT	CASRPGDSRENTGELFF	TRBV27	TRBJ2-2
TGCGCCAGCAGCTTGGAGGGGCCCCTGCGAATGGGTTCGAGCTCCTACGAGCAGTACTTC	CASSLEGPLRMGSSSYEQYF	TRBV5-1	TRBJ2-7
TGCAGTGCTAGAACGTATCGAGCCTACAATGAGCAGTTCTTC	CSARTYRAYNEQFF	TRBV20-1	TRBJ2-1
TGCAGTGCTTTACCCCACCGGGTGAACTATGGCTACACCTTC	CSALPHRVNYGYTF	TRBV20-1	TRBJ1-2
TGTGCCAGCGGAGTTCACAGGGTTTACGAGCAGTACTTC	CASGVHRVYEQYF	TRBV28	TRBJ2-7
TGCAGTCAGGGGGCCGTATATGTGGTCACTGAAGCTTTCTTT	CSQGAVYVVTEAFF	TRBV20-1	TRBJ1-1
TGTGCCAGCAGCTCACGACAGTTCTCTGGGGCCAACGTCCTGACTTTC	CASSSRQFSGANVLTF	TRBV7-9	TRBJ2-6
TGTGCCAGCAGCACCGGACAGGGGCCCTCCGGGGAGCTGTTTTTT	CASSTGQGPSGELFF	TRBV13	TRBJ2-2
TGTGCCAGCAGTGAGACAGGTAACAATCAGCCCCAGCATTTT	CASSETGNNQPQHF	TRBV6-1	TRBJ1-5
TGCAGTGCGGGGGGGAAGGTGGGACAGACTGAAGCTTTCTTT	CSAGGKVGQTEAFF	TRBV20-1	TRBJ1-1
TGTGCCAGCAGCCAACCACCGGGACTAGCGGCTCAGGTTGACAGCATTCAGTACTTC	CASSQPPGLAAQVDSIQYF	TRBV4-2	TRBJ2-4
TGTGCCAGCAGCCAAACCCCGGGACGAGGAGAGTCTGAAGCTTTCTTT	CASSQTPGRGESEAFF	TRBV9	TRBJ1-1
TGTGCCAGCATCAGTGCTTGGGAGGGCCCGAATGAAAAACTGTTTTTT	CASISAWEGPNEKLFF	TRBV5-5	TRBJ1-4
TGTGCCTGGCCCCCCTCCGGGACAGTTCGCGAGCAGTACTTC	CAWPPSGTVREQYF	TRBV30	TRBJ2-7
TGTGCCAGCAGCTTAGAATTGGACGGGGGACGGGACGGGGAGCTGTTTTTT	CASSLELDGGRDGELFF	TRBV7-2	TRBJ2-2
TGTGCCAGCACCGAGACAGGGGGAGACGAGCAGTACTTC	CASTETGGDEQYF	TRBV6-2	TRBJ2-7
TGTGCCAGCAGCGTCATGTCCAGGACAGGGACCTCCTACGAGCAGTACTTC	CASSVMSRTGTSYEQYF	TRBV13	TRBJ2-7
TGTGCCAGCAGCGCCCACCTGGTCGATGGATGGAAAGAGACCCAGTACTTC	CASSAHLVDGWKETQYF	TRBV5-8	TRBJ2-5
TGCAGTGCTACCGGGGGCATCTCGACCTACGAGCAGTACTTC	CSATGGISTYEQYF	TRBV20-1	TRBJ2-7
TGCAGTGCGACATATCGGAATGAGCAGTTCTTC	CSATYRNEQFF	TRBV20-1	TRBJ2-1
TGTGCCAGCAGCTTAGGCCAGGCGTCACTAGCGGGAGTTCAGCCCCAGCATTTT	CASSLGQASLAGVQPQHF	TRBV7-9	TRBJ1-5
TGTGCCAGCAGCGGGCGGACTAGAATTAGCTCCTACAATGAGCAGTTCTTC	CASSGRTRISSYNEQFF	TRBV11-2	TRBJ2-1
TGTGCCAGCAGCCCTCCGCACCTGGACAGGGTAGAAGCATGTGAGACCCAGTACTTC	CASSPPHLDRVEACETQYF	TRBV13	TRBJ2-5
TGTGCCAGCAGCCATCACGGGGGGCCGAGGAATGAAAAACTGTTTTTT	CASSHHGGPRNEKLFF	TRBV13	TRBJ1-4
TGTGCCAGCAGTCTCCAGCGGGAGACTAAGAACACTGAAGCTTTCTTT	CASSLQRETKNTEAFF	TRBV6-1	TRBJ1-1
TGTGCCAGCATCCTAACGACAGGCTCCACTGAAGCTTTCTTT	CASILTTGSTEAFF	TRBV27	TRBJ1-1
TGTGCCAGCAGCCCACAGCAAGAGACCCAGTACTTC	CASSPQQETQYF	TRBV6-4	TRBJ2-5
TGCACAAAAAAACTCCTAGCGGGTGGGGCCTACGAGCAGTACTTC	CTKKLLAGGAYEQYF	TRBV20-1	TRBJ2-7
TGTGCCTGGAGAATTTGTCCCCCGGACCACATTCAGTACTTC	CAWRICPPDHIQYF	TRBV30	TRBJ2-4
TGTGCCAGCAGTTACTCTCTCCCAGGGACAGGGCAGCCCCTCTACACCTTC	CASSYSLPGTGQPLYTF	TRBV6-6	TRBJ1-2
TGTGCCAGCAGCGTTCAATTAAGTCCCTCCTACGAGCAGTACTTC	CASSVQLSPSYEQYF	TRBV9	TRBJ2-7
TGCGCCAGCAGTGAGTCGGCAGACCGGGTATCAGGGGCTGTTCGCTACAATGAGCAGTTCTTC	CASSESADRVSGAVRYNEQFF	TRBV10-1	TRBJ2-1
TGTGCCAGCAGTTATATCTGGGCCGGGACAGGGGAGGAAGCTTTCTTT	CASSYIWAGTGEEAFF	TRBV6-9	TRBJ1-1
TGTGCCAGCGGAAGCCCGGACAGGGATCTCAGCAACGTCCTGACTTTC	CASGSPDRDLSNVLTF	TRBV6-4	TRBJ2-6
TGTGCCAGCAGCTTGCTGAGTTTCAGGGGGGACTATAATTCACCCCTCCACTTT	CASSLLSFRGDYNSPLHF	TRBV5-5	TRBJ1-6
TGTGCCAGCAGCTTAGGCCCACCCTTAGGGCCGGGGAAGTACAATGAGCAGTTCTTC	CASSLGPPLGPGKYNEQFF	TRBV13	TRBJ2-1
TGCAGTGCTAGAGAAAAGGGCAGCGGGACGCGGTTGGGGTATAATTCACCCCTCCACTTT	CSAREKGSGTRLGYNSPLHF	TRBV20-1	TRBJ1-6
