TGTGCCAGCAGCCAAGATGGACAGGAGTGCAATCAGCCCCAGCATTTT	CASSQDGQECNQPQHF	TRBV3-1	TRBJ1-5
TGCAGTGCTAGAGGGGGAGAGTACTATGGCTACACCTTC	CSARGGEYYGYTF	TRBV20-1	TRBJ1-2
TGTGCCAGCAGTGAAGTAACGAGGGAGCAGTACTTC	CASSEVTREQYF	TRBV6-1	TRBJ2-7
TGTGCCAGCACCCGACTAGCGGGGGGGCCAGCACACAATGAGCAGTTCTTC	CASTRLAGGPAHNEQFF	TRBV6-5	TRBJ2-1
TGTGCCAGCAAGAAGGGGGGGCCTTTACAAGAGACCCAGTACTTC	CASKKGGPLQETQYF	TRBV7-3	TRBJ2-5
TGTGCCAGCAGCTTAGGGGGGAGGGGGGTACACGAGCAGTACTTC	CASSLGGRGVHEQYF	TRBV11-2	TRBJ2-7
TGTGCCAGCATATGGATGGACGAGGGGGTTGACAATGAGCAGTTCTTC	CASIWMDEGVDNEQFF	TRBV12-3	TRBJ2-1
TGCCCCTTAAGACTAGCGGGCGGGGAGGAGATCGGGGAGCTGTTTTTT	CPLRLAGGEEIGELFF	TRBV5-1	TRBJ2-2
TGTGCCAGCACCTTTCTCGGGAGAACGGAGACCCAGTACTTC	CASTFLGRTETQYF	TRBV7-9	TRBJ2-5
TGTGCCAGCTTCCTGGGGGCCCCGGGAGAGACCCAGTACTTC	CASFLGAPGETQYF	TRBV6-1	TRBJ2-5
TGTGCCAGCAGTAAGAAGGGGTGGAACACTGAAGCTTTCTTT	CASSKKGWNTEAFF	TRBV9	TRBJ1-1
TGTGCCAGCAGCACTAGACCTTACACAGATACGCAGTATTTT	CASSTRPYTDTQYF	TRBV5-5	TRBJ2-3
TGTGCCAGCAGGGTTCCGGGACTAGCGGGCGTCAGGACCGCGAACACCGGGGAGCTGTTTTTT	CASRVPGLAGVRTANTGELFF	TRBV2	TRBJ2-2
TGTGCCAGCTCACGCGGGGGGGGCTCGAACACCGGGGAGCTGTTTTTT	CASSRGGGSNTGELFF	TRBV18	TRBJ2-2
TGTGCCAGCAGCGTAAGGACAGGGAACTATGGCTACACCTTC	CASSVRTGNYGYTF	TRBV9	TRBJ1-2
TGTGCCAGCAGCTGCAGGTACGAGACCCAGTACTTC	CASSCRYETQYF	TRBV7-2	TRBJ2-5
TGTGCCAGCAGCTGGGGTCATATTATGGACGGTGGGCTCTACAATGAGCAGTTCTTC	CASSWGHIMDGGLYNEQFF	TRBV7-2	TRBJ2-1
TGTGCCAGCAGCTCTTCAGCCCACACCGGGGAGCTGTTTTTT	CASSSSAHTGELFF	TRBV9	TRBJ2-2
TGTGCCAGCCAGGGTTACGAGCAGTACTTC	CASQGYEQYF	TRBV6-4	TRBJ2-7
TGTGCCAGTAGATACGAATCACTTGGTGGCTACACCTTC	CASRYESLGGYTF	TRBV19	TRBJ1-2
TGTGCCTGGAGACGAGGGGAACCGGACACTGAAGCTTTCTTT	CAWRRGEPDTEAFF	TRBV30	TRBJ1-1
TGTGCCAGCAGCCTTACTAGACAGGGGCCCGCCGTGAACACTGAAGCTTTCTTT	CASSLTRQGPAVNTEAFF	TRBV6-6	TRBJ1-1
TGTGCCAGCAGCTTGGACTCCCGGGGGGGGCTGGGCCCTAGCACAGATACGCAGTATTTT	CASSLDSRGGLGPSTDTQYF	TRBV5-8	TRBJ2-3
TGTGCCAGCAGTTACAAAAAGCTCGAGACCCAGTACTTC	CASSYKKLETQYF	TRBV6-5	TRBJ2-5
TGTGCCAGCAGCCATATACGAAGGCAAGAGACCCAGTACTTC	CASSHIRRQETQYF	TRBV14	TRBJ2-5
TGTGCCAGCAGGCCGACAGGTCGGGGGTCCAACACCATATATTTT	CASRPTGRGSNTIYF	TRBV6-4	TRBJ1-3
TGTGCCAGCAGCTCCCTTCCCGGGGGCAGGAACACTGAAGCTTTCTTT	CASSSLPGGRNTEAFF	TRBV7-3	TRBJ1-1
TGTGCCAGCCGCGACAGGCCTCACATCTCCTACGAGCAGTACTTC	CASRDRPHISYEQYF	TRBV27	TRBJ2-7
TGTGCCAGCAGCTCCAACGGGGGACTCGAGCAGTACTTC	CASSSNGGLEQYF	TRBV7-9	TRBJ2-7
TGTGCCAGCAGCTTATCGGACAGGGGAGGCGCGGAGTATTTT	CASSLSDRGGAEYF	TRBV7-9	TRBJ2-3
TGCAGTGCTGTGACAGGGATGAACACTGAAGCTTTCTTT	CSAVTGMNTEAFF	TRBV20-1	TRBJ1-1
TGCAGTGCGCACCGGAGTAAAAACATTCAGTACTTC	CSAHRSKNIQYF	TRBV20-1	TRBJ2-4
TGTGCCAGCCCGGGACAGAATACACGACCAGATACGCAGTATTTT	CASPGQNTRPDTQYF	TRBV6-4	TRBJ2-3
TGCAGCGTTGAAGGCCACCACAGGGGAGACGAGCAGTACTTC	CSVEGHHRGDEQYF	TRBV29-1	TRBJ2-7
TGCGCCAGCAGCGATGGTACGGGGGTCTCGAATAGCTCCTACAATGAGCAGTTCTTC	CASSDGTGVSNSSYNEQFF	TRBV5-1	TRBJ2-1
TGTGCCAGTAGTCTTTCCACGGAAGGTTGTTCCTTCGAGCAGTACTTC	CASSLSTEGCSFEQYF	TRBV19	TRBJ2-7
TGTGCCAGCAGCTTACCACCGCAGGGGGTTCACACTGAAGCTTTCTTT	CASSLPPQGVHTEAFF	TRBV7-2	TRBJ1-1
TGTGCCAGCAGCTTACACCCCCAAGATGGTACAGATACGCAGTATTTT	CASSLHPQDGTDTQYF	TRBV7-9	TRBJ2-3
TGTGCCAGCCGCAGGGGGAGGGCTTTCTTT	CASRRGRAFF	TRBV3-1	TRBJ1-1
TGTGCCAGCAGCTTGGCCACCATTTACCCCCTGGAACAGAGGGGGCCCCAGCATTTT	CASSLATIYPLEQRGPQHF	TRBV5-6	TRBJ1-5
TGTGCCAGCAGCCAAGATGGGGACAGGGATGAGCAGTTCTTC	CASSQDGDRDEQFF	TRBV14	TRBJ2-1
TGTGCCAGCAGCCAAGTATCCCGCCAGGGGCCTGTGAACTATGGCTACACCTTC	CASSQVSRQGPVNYGYTF	TRBV3-1	TRBJ1-2
TGTGCCAGCAGGGCGGAGGGCTACTCTGGGGCCAACGTCCTGACTTTC	CASRAEGYSGANVLTF	TRBV27	TRBJ2-6
TGTCGAATCTCTGGAAACACCATATATTTT	CRISGNTIYF	TRBV6-1	TRBJ1-3
TGTGCCACCAGTGATTCAGGGGGGGGCTCGCAGCCCCAGCATTTT	CATSDSGGGSQPQHF	TRBV24-1	TRBJ1-5
TGTGCCAGCAGGGCTAGCGGGGGGGGGAGCTACGAGCAGTACTTC	CASRASGGGSYEQYF	TRBV27	TRBJ2-7
TGCAGTGCTTTACCATGGGACAGCTTGACAGAGACCCAGTACTTC	CSALPWDSLTETQYF	TRBV20-1	TRBJ2-5
TGTGCCAGTAGTAGGTCCCCTTCGAAGGGGGAGCAGTTCTTC	CASSRSPSKGEQFF	TRBV19	TRBJ2-1
TGTGCCAGCAGTTTTCAAAAGACTAGGGTTATTGCAGATACGCAGTATTTT	CASSFQKTRVIADTQYF	TRBV28	TRBJ2-3
TGTGCCAGCAGCTTAACGATGAGGGGAAACACCATATATTTT	CASSLTMRGNTIYF	TRBV7-3	TRBJ1-3
TGTGCCAGTACTCTCGGGACAGGATTCTACGAGCAGTACTTC	CASTLGTGFYEQYF	TRBV19	TRBJ2-7
TGTGCCTGGAGTGGGGGCAACGAGACCCAGTACTTC	CAWSGGNETQYF	TRBV30	TRBJ2-5
TGTGCCAGTAGTACCGGGGGCCGGACTGACGAGCAGTACTTC	CASSTGGRTDEQYF	TRBV19	TRBJ2-7
TGTGCCAGCAGTCAACGGGGATCCGCTAACTATGGCTACACCTTC	CASSQRGSANYGYTF	TRBV12-4	TRBJ1-2
TGTGCCAGCAGTTGTACCAATGAAAAACTGTTTTTT	CASSCTNEKLFF	TRBV27	TRBJ1-4
TGTGCCACCAGTGAGGCCCTAGGCGGGAGCCCCGGGGAGCTGTTTTTT	CATSEALGGSPGELFF	TRBV24-1	TRBJ2-2
TGTGCATTTTTAGCGAAAGGAGGTGTCTACGAGCAGTACTTC	CAFLAKGGVYEQYF	TRBV9	TRBJ2-7
TGTGCCAGCGGTAAACCGACAGCAGAGCAGTACTTC	CASGKPTAEQYF	TRBV6-3	TRBJ2-7
TGTGCCAGCAGCCCAAGGTTCCAAAATAACGGGATAGCATGGGAGACCCAGTACTTC	CASSPRFQNNGIAWETQYF	TRBV7-4	TRBJ2-5
TGTGCCAGCAGCCCTAAGCGGGAGGGTTACTACGAGCAGTACTTC	CASSPKREGYYEQYF	TRBV13	TRBJ2-7
TGTGCCAGCAGCCCCCTGCGCACAGATACGCAGTATTTT	CASSPLRTDTQYF	TRBV9	TRBJ2-3
TGCGCCAGCAGCCTTCGGACAGGCTACGGGATGAACACTGAAGCTTTCTTT	CASSLRTGYGMNTEAFF	TRBV5-1	TRBJ1-1
TGTGCCAGCAGCACAGAGAAGAACACTGAAGCTTTCTTT	CASSTEKNTEAFF	TRBV14	TRBJ1-1
TGTGCCAGCAGTGACTCAAAACCCGGGACACGAGCGAACACCGGGGAGCTGTTTTTT	CASSDSKPGTRANTGELFF	TRBV6-4	TRBJ2-2
TGTGCCATCAGTCAAGGACAGCGAGTGGGTGCAACTAATGAAAAACTGTTTTTT	CAISQGQRVGATNEKLFF	TRBV10-3	TRBJ1-4
TGCGCCAGCAGTCTAGAAGGGGGTTGCTCCTACGAGCAGTACTTC	CASSLEGGCSYEQYF	TRBV10-1	TRBJ2-7
TGTGCCTGGTCCGAGGGCCAATACTTC	CAWSEGQYF	TRBV30	TRBJ2-7
TGTGCCAGCAGTGAACTCGGACAGGGGGGGAATGAGCAGTTCTTC	CASSELGQGGNEQFF	TRBV2	TRBJ2-1
TGCAGTGCTAGTTTAATAACAGGTCCAGGCATGAACACTGAAGCTTTCTTT	CSASLITGPGMNTEAFF	TRBV20-1	TRBJ1-1
TGTGCCAGCAGCTATGGGCCCCCCACTGAAGCTTTCTTT	CASSYGPPTEAFF	TRBV5-6	TRBJ1-1
TGTGCCAGCAGCACAGGGAAATACACCGGGGAGCTGTTTTTT	CASSTGKYTGELFF	TRBV11-3	TRBJ2-2
TGTGCCAGCAGTTTATCGAAGTACTGGAGGGGACATGAGCAGTTCTTC	CASSLSKYWRGHEQFF	TRBV27	TRBJ2-1
TGTGCCAGTAGTATGAGGACTTCAAGCTCCTACAATGAGCAGTTCTTC	CASSMRTSSSYNEQFF	TRBV19	TRBJ2-1
TGTGCCAGCAGCTTAGGAGCAGGACTCACAAGGGAGGACTCCTATAATTCACCCCTCCACTTT	CASSLGAGLTREDSYNSPLHF	TRBV7-9	TRBJ1-6
TGCGCCAGCAGCGGGGCCCCCCCGGGACTAGCGGGTACTAGCACAGATACGCAGTATTTT	CASSGAPPGLAGTSTDTQYF	TRBV5-1	TRBJ2-3
TGTGCCAGCACCGAGGAGACCCAGTACTTC	CASTEETQYF	TRBV11-3	TRBJ2-5
TGTGCCAGCATGAATAGGGGTGGGAGCTACAATGAGCAGTTCTTC	CASMNRGGSYNEQFF	TRBV5-5	TRBJ2-1
TGTGCCAGCAGCTTCGGGACTAGCGGGGCTGGGGTTAGGATGCAAGAGACCCAGTACTTC	CASSFGTSGAGVRMQETQYF	TRBV13	TRBJ2-5
TGCGCCAGCAGCTACCGACAGGGAAGGGGGGGGGAGCTGTTTTTT	CASSYRQGRGGELFF	TRBV5-1	TRBJ2-2
TGTGCCAGCAGGACTAGCGGGTTATACGAGCAGTACTTC	CASRTSGLYEQYF	TRBV12-3	TRBJ2-7
TGTGCCAGCAGCCACGATTCAGGGGCAACGTCACAACCCTACGAGCAGTACTTC	CASSHDSGATSQPYEQYF	TRBV4-2	TRBJ2-7
TGTGCCAGCAGTTTCCAGAGGACAGGTTTCTTC	CASSFQRTGFF	TRBV12-4	TRBJ2-1
TGTGCCAGCAGTGGGAATAGGGGGCGTCTCCGAGGATCTCAGCCCCAGCATTTT	CASSGNRGRLRGSQPQHF	TRBV6-1	TRBJ1-5
TGTGCCAGCTTCGGAGGTGGAAACACCATATATTTT	CASFGGGNTIYF	TRBV6-4	TRBJ1-3
TGTGCCACCAGTGCCCCTACAGATGGCGAGCAGTACTTC	CATSAPTDGEQYF	TRBV24-1	TRBJ2-7
TGTGCCAGCAGCTTAGATCCGGGGAGAGGCTACGAGCAGTACTTC	CASSLDPGRGYEQYF	TRBV7-7	TRBJ2-7
TGTGCCAGCAGCTGTAAAATCCGCCCACGAGAGACCCAGTACTTC	CASSCKIRPRETQYF	TRBV7-4	TRBJ2-5
TGTGCCAGCAGCGGAGGCAAAAACCCACGGAGACAGGGAGTGCTGGAGCGAAACACCATATATTTT	CASSGGKNPRRQGVLERNTIYF	TRBV12-3	TRBJ1-3
TGTGCCAGCAGCTCGGGACTAGCGAACCTTAGCTCCTACAATGAGCAGTTCTTC	CASSSGLANLSSYNEQFF	TRBV6-2	TRBJ2-1
TGCAGTGCTTGGGGACAGCTGGCGTTCGGAAACACCATATATTTT	CSAWGQLAFGNTIYF	TRBV20-1	TRBJ1-3
TGTGCCATACAGGAAGCGAGGGTCCCTGATCAGCCCCAGCATTTT	CAIQEARVPDQPQHF	TRBV7-2	TRBJ1-5
TGTGCCAGCAGTTACTTCCTTCCAAAACCAGGGGAGACCCAGTACTTC	CASSYFLPKPGETQYF	TRBV6-2	TRBJ2-5
TGTGCCAGCAAGACAGGCCACTGGCAGTACTTC	CASKTGHWQYF	TRBV6-6	TRBJ2-7
TGTGCTAGCCGCCAGGGAGTTCAGCCCCAGCATTTT	CASRQGVQPQHF	TRBV7-7	TRBJ1-5
TGCGCCAGCAGGGGAGGGCTGCGAAGCTATGGCTACACCTTC	CASRGGLRSYGYTF	TRBV5-1	TRBJ1-2
TGTGCCATCACGTGCCAGCGGGCCTCCTACGAGCAGTACTTC	CAITCQRASYEQYF	TRBV10-3	TRBJ2-7
TGTGCCAGCAGTTACTCGGGTGGCGAGAATAGACATCAGCCCCAGCATTTT	CASSYSGGENRHQPQHF	TRBV6-5	TRBJ1-5
TGTGCCAGCAGTGACTACGGGGGGCCCTACGAGCAGTACTTC	CASSDYGGPYEQYF	TRBV6-4	TRBJ2-7
TGTGCCTGGAGTAATGACAGGAGGGGCAAAAACATTCAGTACTTC	CAWSNDRRGKNIQYF	TRBV30	TRBJ2-4
TGTGCCAGCAGTTACTTTCGACGGGGGACTAAAGATACGCAGTATTTT	CASSYFRRGTKDTQYF	TRBV6-5	TRBJ2-3
