TGCGCCAGCAGCCAAGATCGGCGCTACGAGCAGTACTTC	CASSQDRRYEQYF	TRBV4-1	TRBJ2-7
TGCGCCAGCAGCATTCACCGCCGGGACAGGGGGCCAGCGAACACTGAAGCTTTCTTT	CASSIHRRDRGPANTEAFF	TRBV5-1	TRBJ1-1
TGTGCCAAAAGGGACAGGGCAGGAAACATTCAGTACTTC	CAKRDRAGNIQYF	TRBV12-4	TRBJ2-4
TGTGCCATCAGTGTAATACCAACAGATACGCAGTATTTT	CAISVIPTDTQYF	TRBV10-3	TRBJ2-3
TGTGCCAGCAGTTTCTCCTTTCTGGGGGGAAATGAGCAGTTCTTC	CASSFSFLGGNEQFF	TRBV6-9	TRBJ2-1
TGTGCCAGGGCGCGTCTAGCGGGATTATGCTACGAGCAGTACTTC	CARARLAGLCYEQYF	TRBV6-5	TRBJ2-7
TGTGCCTGGACAGGGGAAGAGAACACTGAAGCTTTCTTT	CAWTGEENTEAFF	TRBV30	TRBJ1-1
TGCGCCAGCAGCTTGTTCAGGAGGGGGATGCGGGGGGACGAGCAGTACTTC	CASSLFRRGMRGDEQYF	TRBV5-1	TRBJ2-7
TGCGCCAGCATAGAGGGTAGCCCGCAGTATTTT	CASIEGSPQYF	TRBV10-2	TRBJ2-3
TGTGCCAGCAGCGGCCTAGCTCCTCGAGAGACCCAGTACTTC	CASSGLAPRETQYF	TRBV7-3	TRBJ2-5
TGTGCCAGCCCTCCTGCCCATCCCTACGAGCAGTACTTC	CASPPAHPYEQYF	TRBV9	TRBJ2-7
TGCGCCAGCAGCCAAGATCAGGGCGAGCTGGGCTACGAGCAGTACTTC	CASSQDQGELGYEQYF	TRBV4-1	TRBJ2-7
TGTGCCAGCAGCAAGGACAGCTACGAGCAGTACTTC	CASSKDSYEQYF	TRBV11-3	TRBJ2-7
TGTGCCAGCAGTCCTCACAGGGTCGGACTGAATTCACCCCTCCACTTT	CASSPHRVGLNSPLHF	TRBV28	TRBJ1-6
TGTGCCAGCAGAGACGGGGACGAGCAGCAGGAGGGACAGGGGCAGCCCCAGCATTTT	CASRDGDEQQEGQGQPQHF	TRBV28	TRBJ1-5
TGTGCCAGCAGCAAGGGATACGAGCAGTACTTC	CASSKGYEQYF	TRBV13	TRBJ2-7
TGTGCCAGTAGAATATCCCCCGGGACAGGGGGGGGTAGCAATCAGCCCCAGCATTTT	CASRISPGTGGGSNQPQHF	TRBV19	TRBJ1-5
TGCAGTGCTAGAGGGGGATGCGACAGGGAGTCCCCTGGGGCCAACGTCCTGACTTTC	CSARGGCDRESPGANVLTF	TRBV20-1	TRBJ2-6
TGTGCCACTACCCTACGGACAGGTTCTTATCAGCCCCAGCATTTT	CATTLRTGSYQPQHF	TRBV24-1	TRBJ1-5
TGCGCCAGCAGCTTGCCCCCAAGAGGGTCTAGCACAGATACGCAGTATTTT	CASSLPPRGSSTDTQYF	TRBV5-1	TRBJ2-3
TGCAGTGCTAGAGATTATCTTTTGGTTCCAGACAGGGGGAATGGCTACACCTTC	CSARDYLLVPDRGNGYTF	TRBV20-1	TRBJ1-2
TGTGCCAGTAGAGGAATTCGGGACGAGCAGTACTTC	CASRGIRDEQYF	TRBV19	TRBJ2-7
TGTGCCAGCAGCGGGTACGGGGGGGATGTAGAGACCCAGTACTTC	CASSGYGGDVETQYF	TRBV7-3	TRBJ2-5
TGTGCCAGCAGTAGCCACCGGGAGGGCCTGCCCGGGGAGCTGTTTTTT	CASSSHREGLPGELFF	TRBV6-5	TRBJ2-2
TGTGCCAGCAGGGACGGCGGGTCTGGGGCCAACGTCCTGACTTTC	CASRDGGSGANVLTF	TRBV12-3	TRBJ2-6
TGTGCCACCATTTGGGGCCCGAACACCGGGGAGCTGTTTTTT	CATIWGPNTGELFF	TRBV24-1	TRBJ2-2
TGTGCCAGCAGTTTACTTTCAACTAGCGGTACGGAGCAGTACTTC	CASSLLSTSGTEQYF	TRBV28	TRBJ2-7
TGTGCCAGCATAGGCCCAGACATGAACACTGAAGCTTTCTTT	CASIGPDMNTEAFF	TRBV6-1	TRBJ1-1
TGTGCCAGCAGGGGGGGCCCCGGAGGGAAAGAGACCCAGTACTTC	CASRGGPGGKETQYF	TRBV6-4	TRBJ2-5
TGCGCCAGCAGCATGGCGGAATTCGAGACCCAGTACTTC	CASSMAEFETQYF	TRBV5-1	TRBJ2-5
TGTGCCAGCGTTTCCGGGGGGGCCCTCTCCTACGAGCAGTACTTC	CASVSGGALSYEQYF	TRBV27	TRBJ2-7
TGCGCCAGCAGCTTGTCGGGGGGGAGCTCCTACGAGCAGTACTTC	CASSLSGGSSYEQYF	TRBV5-1	TRBJ2-7
TGTGCCAGCAGCTTAGGAAAACAGGGCAGCTCCTATAATTCACCCCTCCACTTT	CASSLGKQGSSYNSPLHF	TRBV7-4	TRBJ1-6
TGTGCCAGCAGTGAAAAGGCGGGAGATCAGCCCCAGCATTTT	CASSEKAGDQPQHF	TRBV25-1	TRBJ1-5
TGTGCCAGCAGCATCGGACAGGACAAAAACATTCAGTACTTC	CASSIGQDKNIQYF	TRBV11-2	TRBJ2-4
TGTGCCAGCAGCTTAAAGCAAGACAGAAATGGCTACACCTTC	CASSLKQDRNGYTF	TRBV7-8	TRBJ1-2
TGTGCCAGCAGCTTAGAGGGGGGGGACAATGAGCAGTTCTTC	CASSLEGGDNEQFF	TRBV7-8	TRBJ2-1
TGTGCCAGCAGTTACCTTTCGGGGGCTGGCTACACCTTC	CASSYLSGAGYTF	TRBV6-6	TRBJ1-2
TGTGCCAGTAGGGAGGACAGGACTAACTATGGCTACACCTTC	CASREDRTNYGYTF	TRBV19	TRBJ1-2
TGTGCCAGTAGTACCCGAGGAAAGGGCTCCTACGAGCAGTACTTC	CASSTRGKGSYEQYF	TRBV19	TRBJ2-7
TGCAATACGGGGCACAAGGGGGGCACCTCCTACAATGAGCAGTTCTTC	CNTGHKGGTSYNEQFF	TRBV20-1	TRBJ2-1
TGCGCCAGCAGCCAACTCAGCCGACTTTGCGAGCAGTACTTC	CASSQLSRLCEQYF	TRBV4-3	TRBJ2-7
TGTGCCAGCAGCCCGGGTGCCTACGAGCAGTACTTC	CASSPGAYEQYF	TRBV5-4	TRBJ2-7
TGTGCCAGTAGTATAAGTCCCGGACAGGAAAACACCATATATTTT	CASSISPGQENTIYF	TRBV19	TRBJ1-3
TGCAGTGCTGAGCGGCAGGGGGCCTACAATGAGCAGTTCTTC	CSAERQGAYNEQFF	TRBV20-1	TRBJ2-1
TGTGCCAGCAGCGTGGGGCAGACGGGTTCTTCCGAGCAGTACTTC	CASSVGQTGSSEQYF	TRBV9	TRBJ2-7
TGTGCCAGCAGCTTAGCGTTCCTCGGACAGGACACCATGAACACTGAAGCTTTCTTT	CASSLAFLGQDTMNTEAFF	TRBV7-2	TRBJ1-1
TGTGCCAGTAGCGGGGTGAGGGACCCCGAATACGAGCAGTACTTC	CASSGVRDPEYEQYF	TRBV19	TRBJ2-7
TGTGCCACCCCCAGCTACGAGCAGTACTTC	CATPSYEQYF	TRBV24-1	TRBJ2-7
TGCACTAGCGAAGGGTACTCTGGAAACACCATATATTTT	CTSEGYSGNTIYF	TRBV29-1	TRBJ1-3
TGTGCCAGCAGCGTAGAGGGGGGACGGAACCAAACTGAAGCTTTCTTT	CASSVEGGRNQTEAFF	TRBV9	TRBJ1-1
TGCAGTGCCGGGGGCTATACCGGGACAGGCGCTGCCTACGAGCAGTACTTC	CSAGGYTGTGAAYEQYF	TRBV20-1	TRBJ2-7
TGTGCCAGCAGTTTATGCACCTGGGGTCCAGTTCCCTCTGGAAACACCATATATTTT	CASSLCTWGPVPSGNTIYF	TRBV28	TRBJ1-3
TGCGCCAGCAGCCGGACGGCAACACCCCCCTACGAGCAGTACTTC	CASSRTATPPYEQYF	TRBV4-1	TRBJ2-7
TGTGCCAGCAGCGGCTCCAGGGGAGATCAGCCCCAGCATTTT	CASSGSRGDQPQHF	TRBV9	TRBJ1-5
TGTGCCAGCAGCGCCGGAGGGACAGGGACATGCTATGGCTACACCTTC	CASSAGGTGTCYGYTF	TRBV13	TRBJ1-2
TGTGCCAGCAGCCACGGGGGCAGGAACACTGAAGCTTTCTTT	CASSHGGRNTEAFF	TRBV13	TRBJ1-1
TGCGCCAGGTCTGGAGGTCGGGACATGGGGGGAACCTCTGAAGCTTTCTTT	CARSGGRDMGGTSEAFF	TRBV10-1	TRBJ1-1
TGCAGTGCCCGGGACGACCTCGATACGCAGTATTTT	CSARDDLDTQYF	TRBV20-1	TRBJ2-3
TGCAGTGCTAGAGAAACGAGATATAGCGGGGTCAACACCGGGGAGCTGTTTTTT	CSARETRYSGVNTGELFF	TRBV20-1	TRBJ2-2
TGTGCCAGCAGTGGGCCGGGGGTACAGCCCCAGCATTTT	CASSGPGVQPQHF	TRBV2	TRBJ1-5
TGTGCCAGCAGCTTATTCCACCTGACAGGGGGGGATGAAAAACTGTTTTTT	CASSLFHLTGGDEKLFF	TRBV7-3	TRBJ1-4
TGTGCCAGCAGTGACTCACCCTTAGGGACAGGGGGCGATACTACCTACGTCGGCAATCAGCCCCAGCATTTT	CASSDSPLGTGGDTTYVGNQPQHF	TRBV6-4	TRBJ1-5
TGTGCCAGCAGCCCAGCGGACAGGCGGGGATTGAACTATGGCTACACCTTC	CASSPADRRGLNYGYTF	TRBV25-1	TRBJ1-2
TGCAGTGCTGGCCCACCCCCCCCAGGGAGGGGGTATGGCTACACCTTC	CSAGPPPPGRGYGYTF	TRBV20-1	TRBJ1-2
TGCAGCGTTCAGTTGCGGTTAACCTCTGGAAACACCATATATTTT	CSVQLRLTSGNTIYF	TRBV29-1	TRBJ1-3
TGTGCCAGCAGCTTGGTTCGGGCCACTGAAGCTTTCTTT	CASSLVRATEAFF	TRBV7-9	TRBJ1-1
TGTGCCAGCAGCCCGGTAGGGGGCGTCGCGGCGGGTGAGCAGTTCTTC	CASSPVGGVAAGEQFF	TRBV7-2	TRBJ2-1
TGTGCCAGCACTAGTATAGGAAGCCTTGAGCAGTTCTTC	CASTSIGSLEQFF	TRBV6-5	TRBJ2-1
TGTGCCAGCAGCTTGAGACTAGTTTCGCAGTATTTT	CASSLRLVSQYF	TRBV5-5	TRBJ2-3
TGCGCCAGCAGCCAAGATACACTGGGCGTGTTGACCTTTGGGGGGGTTCATGGGAGCTCCTACAATGAGCAGTTCTTC	CASSQDTLGVLTFGGVHGSSYNEQFF	TRBV4-1	TRBJ2-1
TGTGCCAGCTCCCCCCTCGTTTCGCCTGGACAGGGAGGCTACGAGCAGTACTTC	CASSPLVSPGQGGYEQYF	TRBV18	TRBJ2-7
TGCAGTGCTAGAGATAAACTAGCCTACGAGCAGTACTTC	CSARDKLAYEQYF	TRBV20-1	TRBJ2-7
TGTGCCAGCAGCCCGGAGGGGTTATACTACGAGCAGTACTTC	CASSPEGLYYEQYF	TRBV5-4	TRBJ2-7
TGTGCCACCCCCCCGACTAGGTACAATGAGCAGTTCTTC	CATPPTRYNEQFF	TRBV24-1	TRBJ2-1
TGCGCCAGCAGTGCACCGTCCTGGACTAGCGGACTTCACTACAATGAGCAGTTCTTC	CASSAPSWTSGLHYNEQFF	TRBV10-1	TRBJ2-1
TGTGCCAGCAGCCGGGACAGGGATGAAAAACTGTTTTTT	CASSRDRDEKLFF	TRBV7-2	TRBJ1-4
TGTGCCAGCCCTAGCGGGACCCGCTCCTACGAGCAGTACTTC	CASPSGTRSYEQYF	TRBV7-9	TRBJ2-7
TGTGCCAGCACCCTGACAGGCTACGAGCAGTACTTC	CASTLTGYEQYF	TRBV12-3	TRBJ2-7
TGTGCCAGAATGGGGGGGCCTGTATACGAGCAGTACTTC	CARMGGPVYEQYF	TRBV6-5	TRBJ2-7
TGTGCCAGCAGTTCAGACTATTCACCCCTCCACTTT	CASSSDYSPLHF	TRBV12-4	TRBJ1-6
TGCAGTGCCCTTAGCAGCTTCAATCAGCCCCAGCATTTT	CSALSSFNQPQHF	TRBV20-1	TRBJ1-5
TGTGCCACCCACGGTCCGGGACTAGCGGGAATGTACAATGAGCAGTTCTTC	CATHGPGLAGMYNEQFF	TRBV15	TRBJ2-1
TGTGCCAGCAGCTTCGGGGACAGGAACTATGGCTACACCTTC	CASSFGDRNYGYTF	TRBV7-9	TRBJ1-2
TGTGCCACCCGGACTAGCGGAGAGCCCTACGAGCAGTACTTC	CATRTSGEPYEQYF	TRBV7-9	TRBJ2-7
TGTGCCAGCAGTGACTCGACCCATCAGGGGCAGACTCAGCCCCAGCATTTT	CASSDSTHQGQTQPQHF	TRBV6-4	TRBJ1-5
TGTGCCACCAGTGATTGGATAGCGGGGTCCTCCTACGAGCAGTACTTC	CATSDWIAGSSYEQYF	TRBV24-1	TRBJ2-7
TGTGCCAGCAGTTACGGGACAGGGAGCGAGCAGTACTTC	CASSYGTGSEQYF	TRBV2	TRBJ2-7
TGCGCCAGCAGGAATTGTGTTCCTGGGGGGACCGCGAAAGAGACCCAGTACTTC	CASRNCVPGGTAKETQYF	TRBV10-1	TRBJ2-5
TGTGCCAGCAGAAAAGAGGCTGAAGCTTTCTTT	CASRKEAEAFF	TRBV6-4	TRBJ1-1
TGTGCCAGCAGCTCCCACAGGGCCCCCGCAACTAATGAAAAACTGTTTTTT	CASSSHRAPATNEKLFF	TRBV7-9	TRBJ1-4
TGCGCCAGCACCACCACAGGGTACAATGAGCAGTTCTTC	CASTTTGYNEQFF	TRBV5-1	TRBJ2-1
TGTGCCACCACTGCCTTACAGGGCCCCGAGCAGTACTTC	CATTALQGPEQYF	TRBV24-1	TRBJ2-7
TGTGCCAGCAGCAGCCCTTGGGATCTCTTTGCCAAAAACATTCAGTACTTC	CASSSPWDLFAKNIQYF	TRBV5-4	TRBJ2-4
TGTGCCACCAGCAGAGATGTCGGGACGCGTCAGCCCCAGCATTTT	CATSRDVGTRQPQHF	TRBV15	TRBJ1-5
TGCGCCAGCAGTGAGCCGGGGGGTGAGCAGTTCTTC	CASSEPGGEQFF	TRBV10-1	TRBJ2-1
TGCAGTGCTAGCCCAAGCGGGAGGCAAGCGGGGGGGCCTTACGAGCAGTACTTC	CSASPSGRQAGGPYEQYF	TRBV20-1	TRBJ2-7
TGTGCCAGCAGCTCCAAGGGGGTCGCGGGACGTCAGCCCCAGCATTTT	CASSSKGVAGRQPQHF	TRBV7-9	TRBJ1-5
TGCAGTGCTAGAGTGTCGGGGGACAGCCTCACTGAAGCTTTCTTT	CSARVSGDSLTEAFF	TRBV20-1	TRBJ1-1
TGCGCCAGCAGCTTGGAAAACAGGGATGGCTACACCTTC	CASSLENRDGYTF	TRBV5-1	TRBJ1-2
