TGTGCCAGCAGCATGATCCAGGGACAGGGGGCCGTCGGGTATAATTCACCCCTCCACTTT	CASSMIQGQGAVGYNSPLHF	TRBV13	TRBJ1-6
TGCGCCAGCAGCCAATCACCAGGGGAGACCCAGTACTTC	CASSQSPGETQYF	TRBV4-3	TRBJ2-5
TGTGCCAGCAGCTTGGCCGGAGGGCGGGGTTCTGGAAACACCATATATTTT	CASSLAGGRGSGNTIYF	TRBV5-4	TRBJ1-3
TGTGCCAGCAGCTTGGAAAGGGACCGAGATGATGAAGCTTTCTTT	CASSLERDRDDEAFF	TRBV5-6	TRBJ1-1
TGTGCCAGCAGCAGGAGTCAGCCCCAGCATTTT	CASSRSQPQHF	TRBV9	TRBJ1-5
TGTGCCAGCGCCGCAGCGGGAGGGCTCATTCAGTACTTC	CASAAAGGLIQYF	TRBV6-1	TRBJ2-4
TGTGCCAGCAGCTTCGTCTTAGAAACGCGGGACATGGAGGGCTACACCTTC	CASSFVLETRDMEGYTF	TRBV7-2	TRBJ1-2
TGTGCCAGCAGTCCCGGGGGGGGAACCCCCCAAAACTGCGAGCAGTACTTC	CASSPGGGTPQNCEQYF	TRBV12-4	TRBJ2-7
TGTGCCAGCAGCCAAGATTCAAAGTCAATAGGGGTCGGGGGAAACTTC	CASSQDSKSIGVGGNF	TRBV14	TRBJ1-2
TGTGCCACCCGAGCACAGAATCAGCCCCAGCATTTT	CATRAQNQPQHF	TRBV24-1	TRBJ1-5
TGCGCCAGCAGCCATAGGGCGTTGTACCAAGAGACCCAGTACTTC	CASSHRALYQETQYF	TRBV4-3	TRBJ2-5
TGTGCCACGGTCCCGGAAGGCTACACCTTC	CATVPEGYTF	TRBV24-1	TRBJ1-2
TGTGCCAGCAGTGACTCGGGGGGGCGAAAAGGGGTCTACGAGCAGTACTTC	CASSDSGGRKGVYEQYF	TRBV6-4	TRBJ2-7
TGTGCCAGCGGTCAGAAGACAGGGGGCAGCTCCTACGAGCAGTACTTC	CASGQKTGGSSYEQYF	TRBV6-4	TRBJ2-7
TGTGCCAGCACTAAGGGGGGTCGATCCTACGAGCAGTACTTC	CASTKGGRSYEQYF	TRBV7-2	TRBJ2-7
TGTGCCAGCAGCGAAGTCGGGGACAGCTACGCTGCAACTAATGAAAAACTGTTTTTT	CASSEVGDSYAATNEKLFF	TRBV11-3	TRBJ1-4
TGCGCCAGCACCGGGGGGGCACAATACGAGCAGTACTTC	CASTGGAQYEQYF	TRBV10-1	TRBJ2-7
TGCGCCAGCAGAGGGGCTGACAATGAGCAGTTCTTC	CASRGADNEQFF	TRBV10-1	TRBJ2-1
TGTGCCACCAGTGATATCGCGGGAGACAATGAGCAGTTCTTC	CATSDIAGDNEQFF	TRBV24-1	TRBJ2-1
TGCGCCAGCAGCCAAGGGAGGGGGGGCCGTACCGGGGAGCTGTTTTTT	CASSQGRGGRTGELFF	TRBV4-1	TRBJ2-2
TGTGCCACCAAGGACAGGGAACGTCAGCCCCAGCATTTT	CATKDRERQPQHF	TRBV15	TRBJ1-5
TGTGCCAGCAGTTACCCCGTGGGGGGGAACACAGATACGCAGTATTTT	CASSYPVGGNTDTQYF	TRBV6-2	TRBJ2-3
TGTGCCAGCAGTTTCAAACGGTCGGCCTCCGCAACTAATGAAAAACTGTTTTTT	CASSFKRSASATNEKLFF	TRBV28	TRBJ1-4
TGTGTTCCCAGCGACAGGGTATTCGGGGGATATTTT	CVPSDRVFGGYF	TRBV12-3	TRBJ1-3
TGTGCCAGCAGTGACATAGTATACGACAGGGGATTCTCTGGAAACACCATATATTTT	CASSDIVYDRGFSGNTIYF	TRBV6-4	TRBJ1-3
TGCGCCAGCAGCTTGTATTGGGCGGGACAGATTACTCAGCCCCAGCATTTT	CASSLYWAGQITQPQHF	TRBV5-1	TRBJ1-5
TGTGCCACCAGTGACTTACCGGGACAGGGGGGGAACACTGAAGCTTTCTTT	CATSDLPGQGGNTEAFF	TRBV24-1	TRBJ1-1
TGTGCCAGCACCCGACAGGGGGTTTTGGATTCACCCCTCCACTTT	CASTRQGVLDSPLHF	TRBV6-6	TRBJ1-6
TGTGCCAGCAGTTTCGTTCCACCCCCTAAAGGACATCCCGACAGCTCTGGAAACACCATATATTTT	CASSFVPPPKGHPDSSGNTIYF	TRBV12-3	TRBJ1-3
TGTGCCGGTGGGACTAGCGGTTGGGGGCAAGAGACCCAGTACTTC	CAGGTSGWGQETQYF	TRBV19	TRBJ2-5
TGTGCCGGGGACAGGGGGAATGCTGGAAACACCATATATTTT	CAGDRGNAGNTIYF	TRBV3-1	TRBJ1-3
TGCGCCAGCAGCTTGGGACGTGGACAGATCTACGAGCAGTACTTC	CASSLGRGQIYEQYF	TRBV5-1	TRBJ2-7
TGTGCCAGCAGCTTCAGGAGCAGGGAAGAAGGAGGTGTGAACGAGCAGTACTTC	CASSFRSREEGGVNEQYF	TRBV7-9	TRBJ2-7
TGTGCCAGCAGCGTTCTCAAAGGGACAGGGTCGGTGAACACTGAAGCTTTCTTT	CASSVLKGTGSVNTEAFF	TRBV28	TRBJ1-1
TGTGCCAGCAGTTTATCGCGCACACGAGGGACTAGCGGGGTACATACGCAGTATTTT	CASSLSRTRGTSGVHTQYF	TRBV27	TRBJ2-3
TGTGCCAGCAGCCGTGCCCGAACCTGGACAGGGGGTTCGTTACTAACTGAAGCTTTCTTT	CASSRARTWTGGSLLTEAFF	TRBV7-3	TRBJ1-1
TGTGCCAGCTTCGAGGACGAGCAGTACTTC	CASFEDEQYF	TRBV7-3	TRBJ2-7
TGCAGTCAGGGCTGCAATCAGCCCCAGCATTTT	CSQGCNQPQHF	TRBV20-1	TRBJ1-5
TGTGCCATCAGTGAGTCGTCCCGGGACAGCTGGGGCTACACCTTC	CAISESSRDSWGYTF	TRBV10-3	TRBJ1-2
TGTGCCAGCAGCAACACCGAACGGCTGGTATCGAACACTGAAGCTTTCTTT	CASSNTERLVSNTEAFF	TRBV7-9	TRBJ1-1
TGTGCCAGCAGTGAAGGGGGACCAGTAATGAACACTGAAGCTTTCTTT	CASSEGGPVMNTEAFF	TRBV6-1	TRBJ1-1
TGTGCCAGCAGTTTGCAGGGAGGGACAGATACGCAGTATTTT	CASSLQGGTDTQYF	TRBV12-4	TRBJ2-3
TGTGCCACCAACCCGAGTTGTTCACCCCTCCACTTT	CATNPSCSPLHF	TRBV24-1	TRBJ1-6
TGTGCCAGCAGTGGCCACCCCGGGACAGGGGCATACAATGAGCAGTTCTTC	CASSGHPGTGAYNEQFF	TRBV6-4	TRBJ2-1
TGTGCCACCAGTGATTGTACACGTAGGGGGGGAGTTAGCACAGATACGCAGTATTTT	CATSDCTRRGGVSTDTQYF	TRBV24-1	TRBJ2-3
TGTGCCCCCAGGGGGCGGGATCAGCCCCAGCATTTT	CAPRGRDQPQHF	TRBV28	TRBJ1-5
TGCAGTGCTAGATTGGACCTCCGCACAGATACGCAGTATTTT	CSARLDLRTDTQYF	TRBV20-1	TRBJ2-3
TGTGCCAGCAGCATATCAGGGCCTTTCGATGGCTACACCTTC	CASSISGPFDGYTF	TRBV13	TRBJ1-2
TGTGCCAGCAGTTTATCAGACTTTGGGCACTCACAAACACAACTTGGCGGGAATGAAAAACTGTTTTTT	CASSLSDFGHSQTQLGGNEKLFF	TRBV28	TRBJ1-4
TGTGCCAGCAGCTTCCCTCCCGGGACTAGCGGGAGTAAGGGCTACACCTTC	CASSFPPGTSGSKGYTF	TRBV7-4	TRBJ1-2
TGTGCCAGCAGCGTAGCTACCAATACCCGGGCTCAAGAGACCCAGTACTTC	CASSVATNTRAQETQYF	TRBV9	TRBJ2-5
TGTGCCAGCAGCCAAGTAGGGGCGGGCTACGAGCAGTACTTC	CASSQVGAGYEQYF	TRBV3-1	TRBJ2-7
TGTGCCAGCGAAAATCTACTAATAGCGGGGAACGAGCAGTACTTC	CASENLLIAGNEQYF	TRBV6-4	TRBJ2-7
TGTGCCAGCAGTTTACCTAGCCAGGAGGAGACCCAGTACTTC	CASSLPSQEETQYF	TRBV12-4	TRBJ2-5
TGTGCCACCCAAAAGACAGGGGAAAAACTGTTTTTT	CATQKTGEKLFF	TRBV24-1	TRBJ1-4
TGTGCCAGCAGCTTTACACGACGGGGGCCCCGGGATAGAGCCCAGTACTTC	CASSFTRRGPRDRAQYF	TRBV7-8	TRBJ2-5
TGCGCCAGCAGCGCGAGGAGGTGCTACTATGGCTACACCTTC	CASSARRCYYGYTF	TRBV5-1	TRBJ1-2
TGTGCCACCCAGCGGGACAGGGGGCCCGACACTGAAGCTTTCTTT	CATQRDRGPDTEAFF	TRBV24-1	TRBJ1-1
TGTGCCAGCAGTCGCGAGACTAGCGGGCAAGAGACCCAGTACTTC	CASSRETSGQETQYF	TRBV28	TRBJ2-5
TGTGCCACTCGGTCTTACGGATGGACAGGGGGCAGGGGGTATAATTCACCCCTCCACTTT	CATRSYGWTGGRGYNSPLHF	TRBV28	TRBJ1-6
TGTGCCAGCAGTGCAGCAGGCTGTTACACAGATACGCAGTATTTT	CASSAAGCYTDTQYF	TRBV6-1	TRBJ2-3
TGTGCCAGCAGTGAATGGAGGGGGGATTGGGACGAGCAGTACTTC	CASSEWRGDWDEQYF	TRBV25-1	TRBJ2-7
TGTGCCAGCAGCTTGGAAGACAGGGAGGCCGGGGAGCTGTTTTTT	CASSLEDREAGELFF	TRBV5-5	TRBJ2-2
TGTGCCACCAGTGACCGCTCAGGCCTCGGGTCTGGGGCCAACGTCCTGACTTTC	CATSDRSGLGSGANVLTF	TRBV24-1	TRBJ2-6
TGTGCCAGCTTTCATCAGCCCCAGCATTTT	CASFHQPQHF	TRBV7-9	TRBJ1-5
TGTGCCAGCAGCTTACCCTGGGGGAAACTCTACAATGAGCAGTTCTTC	CASSLPWGKLYNEQFF	TRBV11-2	TRBJ2-1
TGCGCCAGCAGCTTGGATCTGGCGATGGCTTATTCACCCCTCCACTTT	CASSLDLAMAYSPLHF	TRBV5-1	TRBJ1-6
TGTGCTAGCAGCAGCTCGACTAGCTCTCTTGACTACAATGAGCAGTTCTTC	CASSSSTSSLDYNEQFF	TRBV7-7	TRBJ2-1
TGTGCCAGCAGTTTGGATGGGAGGACCCTCAGTAATGAAAAACTGTTTTTT	CASSLDGRTLSNEKLFF	TRBV28	TRBJ1-4
TGTGCCTGGAGTGCTGGACATACTCAGCCCCAGCATTTT	CAWSAGHTQPQHF	TRBV30	TRBJ1-5
TGTGCCAGCAGCGGATGGGGACAGCGCAGCTACAATGAGCAGTTCTTC	CASSGWGQRSYNEQFF	TRBV13	TRBJ2-1
TGCAGTGCTACCAATCGAACAGCGTGGATGAACACTGAAGCTTTCTTT	CSATNRTAWMNTEAFF	TRBV20-1	TRBJ1-1
TGCAGTGCTGGGGGGCATGACCCTGAGACCCAGTACTTC	CSAGGHDPETQYF	TRBV20-1	TRBJ2-5
TGTGCCAGCAGTTACTCGAGACAGGGGCTTTACACTGAAGCTTTCTTT	CASSYSRQGLYTEAFF	TRBV6-6	TRBJ1-1
TGTGCCAGCAGTGACTCCGGAAAGGACCCCTCCTTCTACGAGCAGTACTTC	CASSDSGKDPSFYEQYF	TRBV6-4	TRBJ2-7
TGTGCCAGCACAACCGGGACAGGGGCGGGGCCCTACGAGCAGTACTTC	CASTTGTGAGPYEQYF	TRBV7-7	TRBJ2-7
TGTGCCAGCAGGGGACTGTTTAGGGATGAGCAGTTCTTC	CASRGLFRDEQFF	TRBV27	TRBJ2-1
TGTGCCAGCAGGGAGACTAGCGGGAGATTAGAGACCCAGTACTTC	CASRETSGRLETQYF	TRBV6-5	TRBJ2-5
TGTGCCAGCAGCTTGGCCCGGAAGGGGTTTGGCAATCAGCCCCAGCATTTT	CASSLARKGFGNQPQHF	TRBV5-6	TRBJ1-5
TGTGCCAGCAGAAACCGACAGGGGCCGAACACTGAAGCTTTCTTT	CASRNRQGPNTEAFF	TRBV6-5	TRBJ1-1
TGCGCCAGACAGGACAGGCCGGGTTCCCCAGGGGCGGGGAATGAAAAACTGTTTTTT	CARQDRPGSPGAGNEKLFF	TRBV5-1	TRBJ1-4
TGTGCCAGCAGCGACTCCAGGTTTCAATCTGGAAACACCATATATTTT	CASSDSRFQSGNTIYF	TRBV13	TRBJ1-3
TGCGCCAGCAGCGGCCCCCCGAGGACAGGGCTGTATAATTCACCCCTCCACTTT	CASSGPPRTGLYNSPLHF	TRBV5-1	TRBJ1-6
TGCGCCAGCAGCTCAGAGCCCCAGCATTTT	CASSSEPQHF	TRBV5-1	TRBJ1-5
TGCAGTGCTAGGCTAACGGAGACCCAGTACTTC	CSARLTETQYF	TRBV20-1	TRBJ2-5
TGCAGTGCTAGACTAAGGGGGGCTTTCTTT	CSARLRGAFF	TRBV20-1	TRBJ1-1
TGTGCCAGCAGTTTGTGCAGGGGAAATTCACCCCTCCACTTT	CASSLCRGNSPLHF	TRBV6-5	TRBJ1-6
TGTGCCAGCAGCCAAAAAAAGGGACGAGAGACCCAGTACTTC	CASSQKKGRETQYF	TRBV7-3	TRBJ2-5
TGTGCCAGCAGTGACCCGGCCTACGAGCAGTACTTC	CASSDPAYEQYF	TRBV6-4	TRBJ2-7
TGCAGTGCTAGATCCGGGGCTAGAGGGCTAATGTGTAGCAATCAGCCCCAGCATTTT	CSARSGARGLMCSNQPQHF	TRBV20-1	TRBJ1-5
TGTGCCAGCAGTTTCTCAGGGGGGGCCGGCTATCTACCCTACGAGCAGTACTTC	CASSFSGGAGYLPYEQYF	TRBV27	TRBJ2-7
TGTGCCAATAATGGAGAACCGGGACACACGAATCCTGACCGTCAGCCCCAGCATTTT	CANNGEPGHTNPDRQPQHF	TRBV10-3	TRBJ1-5
TGTGCCAGCAGTTTAGGAGAGGCCCTAGCAGATACGCAGTATTTT	CASSLGEALADTQYF	TRBV12-3	TRBJ2-3
TGTGCCAGCACATTAGGTCTTAAACCCGAGCAGTACTTC	CASTLGLKPEQYF	TRBV13	TRBJ2-7
TGTGCCAGCAGCTATAGCAGGCTAGGGTGGAACACTGAAGCTTTCTTT	CASSYSRLGWNTEAFF	TRBV7-9	TRBJ1-1
TGTGCCATACTAGCGGGAAGAATGGACTACGAGCAGTACTTC	CAILAGRMDYEQYF	TRBV6-1	TRBJ2-7
TGTGCCAGCAGTCTAGCGTTACTGGCTGAGCAGTTCTTC	CASSLALLAEQFF	TRBV6-1	TRBJ2-1
TGTGCCAGCAGCATAGCCCGACCTAGCGGGAAAAGCTCCGGGGAGCTGTTTTTT	CASSIARPSGKSSGELFF	TRBV13	TRBJ2-2
TGCAGTGCTAGAAGGAACGGTCGCTACGAGCAGTACTTC	CSARRNGRYEQYF	TRBV20-1	TRBJ2-7
TGTGCCAGCAGCCCATCCCGGCGGACGCATAGTAATAGCTCTGGAAACACCATATATTTT	CASSPSRRTHSNSSGNTIYF	TRBV9	TRBJ1-3
