TGCGCCAGCAGGCGGACTGAGACCCAGTACTTC	CASRRTETQYF	TRBV5-1	TRBJ2-5
TGCAGTGCTAGAGTGCGGGGAGAGCAGTTCTTC	CSARVRGEQFF	TRBV20-1	TRBJ2-1
TGTGCCAGCAGTTTCTTTCCAGGGGCTTTCTTT	CASSFFPGAFF	TRBV27	TRBJ1-1
TGTGCCAGCAGCTTGGAAGTTACAGGTTGGGGCTACACCTTC	CASSLEVTGWGYTF	TRBV5-6	TRBJ1-2
TGTGCCAGCAGCTTTTGCATCGGACAGGGGAGGTGGGTCTCTGGGGCCAACGTCCTGACTTTC	CASSFCIGQGRWVSGANVLTF	TRBV11-3	TRBJ2-6
TGCGCCAGCAGCTTCCACAGGCATAGCAATCAGCCCCAGCATTTT	CASSFHRHSNQPQHF	TRBV5-1	TRBJ1-5
TGCGCCAGCAGCTTGAAAAAGACCGGGGGGAGGCCCTCCGGATTCGGGGCCAACGTCCTGACTTTC	CASSLKKTGGRPSGFGANVLTF	TRBV5-1	TRBJ2-6
TGTGCCAGCAGTTACCTCCGGGGGCGTTGTTACGAGCAGTACTTC	CASSYLRGRCYEQYF	TRBV6-5	TRBJ2-7
TGTGCCAGCAGCTTACCTGCAGCGGGGGGGCGTGGCTTTCTCTCCTACGAGCAGTACTTC	CASSLPAAGGRGFLSYEQYF	TRBV7-2	TRBJ2-7
TGTGCCAGCAGTTCGGGACAGGGTAGTGTCCCCCAGCATTTT	CASSSGQGSVPQHF	TRBV27	TRBJ1-5
TGCAGTGCTAGAGATCTTCAGACAGGTCTAGGTAACTATGGCTACACCTTC	CSARDLQTGLGNYGYTF	TRBV20-1	TRBJ1-2
TGTGCCAGCACTTGGGACAGGGGTGGTGGCTACACCTTC	CASTWDRGGGYTF	TRBV6-5	TRBJ1-2
TGTGCCAGTAGTAGCCAAAGGGACAGATTCAATGAAAAACTGTTTTTT	CASSSQRDRFNEKLFF	TRBV19	TRBJ1-4
TGTGCCAGCAGTTACAGCTGGGGACAGGGGAGAAACACCGGGGAGCTGTTTTTT	CASSYSWGQGRNTGELFF	TRBV6-6	TRBJ2-2
TGTGCCAGTAGTATAGATCTTCAGGTGTTTATTCCAGCTAACTATGGCTACACCTTC	CASSIDLQVFIPANYGYTF	TRBV19	TRBJ1-2
TGTGCTAGCCGGATCTACGATACGGAGGACGGCTACACCTTC	CASRIYDTEDGYTF	TRBV12-5	TRBJ1-2
TGTGCCAGCAGTTACACCCATATAGGCTACACCTTC	CASSYTHIGYTF	TRBV6-5	TRBJ1-2
TGTGCCAGCAGCGGCGGCAGTTACGAGCAGTACTTC	CASSGGSYEQYF	TRBV9	TRBJ2-7
TGTGCCAGCAGCCAAGGTGACAGGGCTGTAAGGGGTCAGCCCCAGCATTTT	CASSQGDRAVRGQPQHF	TRBV3-1	TRBJ1-5
TGCAGCGCTTCAAGACGAGACGGCGACGGAAACACCATATATTTT	CSASRRDGDGNTIYF	TRBV29-1	TRBJ1-3
TGTGCCAGCAGCTTGGGGAGGAATCGGACAGGGATGGGCTACACCTTC	CASSLGRNRTGMGYTF	TRBV5-4	TRBJ1-2
TGCAGCGTTGAAGACCTAGAAAAACTGTTTTTT	CSVEDLEKLFF	TRBV29-1	TRBJ1-4
TGCGCCAGCAGTGAGTCGAGCAGAACAACATACACTGAAGCTTTCTTT	CASSESSRTTYTEAFF	TRBV10-1	TRBJ1-1
TGTGCCAGCAGAGACAGGGGTTCCAATCAGCCCCAGCATTTT	CASRDRGSNQPQHF	TRBV6-5	TRBJ1-5
TGTGCCAGCAGCGTGACGCCAGAGGGAAACACCATATATTTT	CASSVTPEGNTIYF	TRBV9	TRBJ1-3
TGTGCCAGCAGCCAAGATCGGACAGGAGGGAACACTGAAGCTTTCTTT	CASSQDRTGGNTEAFF	TRBV3-1	TRBJ1-1
TGTGCCAGCAGAAAGCGGGAGGCCACTCATGAGCAGTTCTTC	CASRKREATHEQFF	TRBV6-4	TRBJ2-1
TGTGCCAGCAGTTACCGGCCCCCAGGGCCCTTAGTTTTATCCTACAATGAGCAGTTCTTC	CASSYRPPGPLVLSYNEQFF	TRBV6-5	TRBJ2-1
TGTGCCAGCAGCCGGGGGCGCAAAGAGACCCAGTACTTC	CASSRGRKETQYF	TRBV13	TRBJ2-5
TGTGCCACCAGTGATTGGGGGAGCACGTTATCCTACGAGCAGTACTTC	CATSDWGSTLSYEQYF	TRBV24-1	TRBJ2-7
TGTGCCATCAACCCCGGGGAGGGTGGGACGGGGGCCACCGGGGAGCTGTTTTTT	CAINPGEGGTGATGELFF	TRBV10-3	TRBJ2-2
TGCAGTGCTAGAGGGGGCGAGGGACGTAACACTGAAGCTTTCTTT	CSARGGEGRNTEAFF	TRBV20-1	TRBJ1-1
TGCAGCGTTGGTAGTAGGACAGGGGGCGGGAATAACTATGGCTACACCTTC	CSVGSRTGGGNNYGYTF	TRBV29-1	TRBJ1-2
TGTGCCAGCAGCCGAAGTGACCCTCGGGGGCGCCGCTACACTGAAGCTTTCTTT	CASSRSDPRGRRYTEAFF	TRBV3-1	TRBJ1-1
TGTGCCAGCAGTCCGGACAGGGCGAGGGGATCAGCTTTCTTT	CASSPDRARGSAFF	TRBV12-4	TRBJ1-1
TGTGCCAGCAACGGGGGAAAAATAAACGAGCAGTACTTC	CASNGGKINEQYF	TRBV27	TRBJ2-7
TGTGCCATCCGGGGGGCGCGAATGGGGACGCACACTGAAGCTTTCTTT	CAIRGARMGTHTEAFF	TRBV6-2	TRBJ1-1
TGTGCCAGCAGTGAGCCTCCCGCGTGCAATCAGCCCCAGCATTTT	CASSEPPACNQPQHF	TRBV6-4	TRBJ1-5
TGCGCCAGGCATTCTTTCCGGGACAGGCAGAAGTCAACTAATGAAAAACTGTTTTTT	CARHSFRDRQKSTNEKLFF	TRBV10-1	TRBJ1-4
TGTGCCATCAGGTTGGCTAGTTACAATGAGCAGTTCTTC	CAIRLASYNEQFF	TRBV10-3	TRBJ2-1
TGTGCCAGCAGTTTTGCCCCATATGAAAAACTGTTTTTT	CASSFAPYEKLFF	TRBV28	TRBJ1-4
TGTGCCAGCAGCCAGCGCAAGGGGGCGCGATCAGATACGCAGTATTTT	CASSQRKGARSDTQYF	TRBV7-3	TRBJ2-3
TGTGCCAGCAGCTTAGGTCTTAGCGGGGGCACCGGGGAGCTGTTTTTT	CASSLGLSGGTGELFF	TRBV7-9	TRBJ2-2
TGCGCCAGCAGCCCACAGGGGGAGACCCAGTACTTC	CASSPQGETQYF	TRBV5-1	TRBJ2-5
TGTGCCAGCAGTTACCCCCCCAGGGGCAATCAGCCCCAGCATTTT	CASSYPPRGNQPQHF	TRBV6-6	TRBJ1-5
TGTGCCAGCAGTGGCCACAGGGGGCAGCAACCGGACTCCTACGAGCAGTACTTC	CASSGHRGQQPDSYEQYF	TRBV6-2	TRBJ2-7
TGTGCCAGCTCAAGGTTGGGACAGGGGTCGCGTGGCAATGAGCAGTTCTTC	CASSRLGQGSRGNEQFF	TRBV18	TRBJ2-1
TGCAGCGTTGAAGAGGTGGGGCAGAAGAGCACAGATACGCAGTATTTT	CSVEEVGQKSTDTQYF	TRBV29-1	TRBJ2-3
TGCAGCGGATGGGGCCGGAAGATTAGGAGGGAAAAACTGTTTTTT	CSGWGRKIRREKLFF	TRBV29-1	TRBJ1-4
TGTGCCAGCAGCTTAGCTACTAGCGGGCCGATGGACGAGCAGTACTTC	CASSLATSGPMDEQYF	TRBV11-2	TRBJ2-7
TGTGCCCCAGGGACAGGGACTAATGAAAAACTGTTTTTT	CAPGTGTNEKLFF	TRBV19	TRBJ1-4
TGCAAAAGGTTGACTAGATCCACAGATACGCAGTATTTT	CKRLTRSTDTQYF	TRBV20-1	TRBJ2-3
TGTGCCAGCAGCGCCGTCGGCCCTCCCTCGAACACTGAAGCTTTCTTT	CASSAVGPPSNTEAFF	TRBV5-8	TRBJ1-1
TGTGCCAGCAGTTTATCCTCCCCGGGACAGCCGAATCAGCCCCAGCATTTT	CASSLSSPGQPNQPQHF	TRBV27	TRBJ1-5
TGTGCCAGTTTAGCTGGAGAGTGGGGAAGGTCGAACACCGGGGAGCTGTTTTTT	CASLAGEWGRSNTGELFF	TRBV19	TRBJ2-2
TGCAGTGCCACTCTGGACTCTGGGGCCAACGTCCTGACTTTC	CSATLDSGANVLTF	TRBV20-1	TRBJ2-6
TGCAGCGTGGGGATTGTCTTACCTGAAGCTTTCTTT	CSVGIVLPEAFF	TRBV29-1	TRBJ1-1
TGTGCCAGCAGCTTAACAAACAGGGAGCCCAATCAGCCCCAGCATTTT	CASSLTNREPNQPQHF	TRBV7-3	TRBJ1-5
TGTGCCAGCAGGAAGCTAGCGGGGGGGCCGGTAGATGACAATGAGCAGTTCTTC	CASRKLAGGPVDDNEQFF	TRBV6-4	TRBJ2-1
TGTGCCAGCAGCTTACCCGAGCCGCCCTGCACAGATACGCAGTATTTT	CASSLPEPPCTDTQYF	TRBV11-2	TRBJ2-3
TGCGCCAGCAGCAGGAATAATTCACCCCTCCACTTT	CASSRNNSPLHF	TRBV5-1	TRBJ1-6
TGTGCCAGCAGCCTGGGGACGAGCTACGAGCAGTACTTC	CASSLGTSYEQYF	TRBV9	TRBJ2-7
TGTGCCAGTAGTACTTGGCCTAAGACAGATACGCAGTATTTT	CASSTWPKTDTQYF	TRBV19	TRBJ2-3
TGTGCCAGCCTACGACGGGGGGGCCGACCCTACGAGCAGTACTTC	CASLRRGGRPYEQYF	TRBV28	TRBJ2-7
TGTGCCAGCTCACCACGTACCCGGCGGGCAACGCTGCCCGTCCCCGGGGAGCTGTTTTTT	CASSPRTRRATLPVPGELFF	TRBV18	TRBJ2-2
TGTGCCAGCAGCTTAAAGCGGTTAATCTATAGCAATCAGCCCCAGCATTTT	CASSLKRLIYSNQPQHF	TRBV7-9	TRBJ1-5
TGCGCCAGCAGTGAGTCGTCCGGTCCGGGACCTCGAGACACTGAAGCTTTCTTT	CASSESSGPGPRDTEAFF	TRBV10-2	TRBJ1-1
TGTGCCAGCGGAACCCGAAGCACCCTAGGACGGACTCTATCTGGGGCCAACGTCCTGACTTTC	CASGTRSTLGRTLSGANVLTF	TRBV6-5	TRBJ2-6
TGTGCCAGCAACACCGCCCATGAGCAGTTCTTC	CASNTAHEQFF	TRBV7-6	TRBJ2-1
TGCGCCAGCGTAGCAGTGCAAGAGACCCAGTACTTC	CASVAVQETQYF	TRBV5-1	TRBJ2-5
TGTGCCAGCAATTCCTCCCGTAGGACAGTTGGGGCCAACGTCCTGACTTTC	CASNSSRRTVGANVLTF	TRBV5-4	TRBJ2-6
TGTGCCAGCAGCGACCGTCGTGGGGTGAGTAACTATGGCTACACCTTC	CASSDRRGVSNYGYTF	TRBV3-1	TRBJ1-2
TGCGCCAGCAGGGGGGGACAAACGTATAGCAATCAGCCCCAGCATTTT	CASRGGQTYSNQPQHF	TRBV10-1	TRBJ1-5
TGTGCCACCAGAACGCGCTCTGGGGCCAACGTCCTGACTTTC	CATRTRSGANVLTF	TRBV24-1	TRBJ2-6
TGTGCCAGCAGCCAAGATATTACAGGGAGGTCTTACGAGCAGTACTTC	CASSQDITGRSYEQYF	TRBV3-1	TRBJ2-7
TGTGCCAGCAGCGGAGGGGGGGGGTCCCCCCGTGCAACCTACAATGAGCAGTTCTTC	CASSGGGGSPRATYNEQFF	TRBV7-9	TRBJ2-1
TGCAGTGCTAGAGACCGGCACAGGGGCCACGAGCAGTACTTC	CSARDRHRGHEQYF	TRBV20-1	TRBJ2-7
TGTGCCAGCAGTGATACCGGGACAGAGACGCGCAATCAGCCCCAGCATTTT	CASSDTGTETRNQPQHF	TRBV6-4	TRBJ1-5
TGTGCCAGCAGTTACTCGGCCGTCGTACGACTAGCGGGGAGCGCAGATACGCAGTATTTT	CASSYSAVVRLAGSADTQYF	TRBV6-2	TRBJ2-3
TGTGCCAGCAGCCAAGCTTGCAAAAAGGGGCGCGCAGATAAGCATGGCTACACCTTC	CASSQACKKGRADKHGYTF	TRBV14	TRBJ1-2
TGTGCCAGCAAACAGGGTGATAACACTGAAGCTTTCTTT	CASKQGDNTEAFF	TRBV6-4	TRBJ1-1
TGTGCCACGCGAGGGACTAGCGTTTACGAGCAGTACTTC	CATRGTSVYEQYF	TRBV5-8	TRBJ2-7
TGTGCCAGCAGCGTGAGAGCAGGATACGAGCAGTACTTC	CASSVRAGYEQYF	TRBV9	TRBJ2-7
TGTGCCAGCAGTGGCTCCCCGGATACGCAGTATTTT	CASSGSPDTQYF	TRBV28	TRBJ2-3
TGCGCCAGCAGCCAAGGTAGGGCGGGTCGCCCGGCTGGTCAGACGGCCAATTCACCCCTCCACTTT	CASSQGRAGRPAGQTANSPLHF	TRBV4-1	TRBJ1-6
TGTGCCAGCAGTTACAAAGAGAGGTACGAGCAGTACTTC	CASSYKERYEQYF	TRBV6-2	TRBJ2-7
TGTGCCAGCAGCCCTCGGGACAGGGGTCCCTACGAGCAGTACTTC	CASSPRDRGPYEQYF	TRBV13	TRBJ2-7
TGTGCCACCAGGGCCAAAGGGACCTTCTATGGCTACACCTTC	CATRAKGTFYGYTF	TRBV24-1	TRBJ1-2
TGTGCCAGCAGTTCGACTAGCGGGGATGGCAAAGAGACCCAGTACTTC	CASSSTSGDGKETQYF	TRBV27	TRBJ2-5
TGCAGTGCTAGAGGTCCTACCCGGACAGGAATTCGGGGCAATCAGCCCCAGCATTTT	CSARGPTRTGIRGNQPQHF	TRBV20-1	TRBJ1-5
TGTGCCAGCAGCTTGGCCTGTTCCAGGACTGAGCAGTTCTTC	CASSLACSRTEQFF	TRBV5-6	TRBJ2-1
TGTGCCAGCAGTTTCAGCCACAGGGATCAGCCCCAGCATTTT	CASSFSHRDQPQHF	TRBV6-2	TRBJ1-5
TGTGCCAGCAGTGACCGGGGGTTGAGGCCCAGGTCTGGGGCCAACGTCCTGACTTTC	CASSDRGLRPRSGANVLTF	TRBV28	TRBJ2-6
TGCAGCGTCTGGGACAGGGTCCCGCTACTCCCGGAAGGGTCTGAAAGGGGGGAGCTGTTTTTT	CSVWDRVPLLPEGSERGELFF	TRBV29-1	TRBJ2-2
TGTGCCACCAGTGTGCCACCTACCCACAGGGTAGAGCAGTACTTC	CATSVPPTHRVEQYF	TRBV24-1	TRBJ2-7
TGTGCCAATGTTAAGGGACTTAACGAGCAGTACTTC	CANVKGLNEQYF	TRBV10-3	TRBJ2-7
TGTGCCAGCAGCTGGGACAGGGAATGGGTCTACTCTGGGGCCAACGTCCTGACTTTC	CASSWDREWVYSGANVLTF	TRBV7-9	TRBJ2-6
TGCAGTGCCCAGGATTCCTTCCGTGACAGGGACGTCATTCAGTACTTC	CSAQDSFRDRDVIQYF	TRBV20-1	TRBJ2-4
TGCGCCAGCAGTGCACCAACCGCCAAAAACATTCAGTACTTC	CASSAPTAKNIQYF	TRBV10-1	TRBJ2-4
TGCGCCAGCAGTGAGGGAGTTTTTATTCACACTGAAGCTTTCTTT	CASSEGVFIHTEAFF	TRBV10-1	TRBJ1-1
