TGTGCCACCAGTGAGGTCCCACAGTCCAGCTCCTACGAGCAGTACTTC	CATSEVPQSSSYEQYF	TRBV24-1	TRBJ2-7
TGTGCCAGCAGCTTAGGCCTGTATGAGCAGTTCTTC	CASSLGLYEQFF	TRBV7-6	TRBJ2-1
TGTGCCAGCAGCCAGAGGGGAAAAACAGGGAAGGAAAATGAAAAACTGTTTTTT	CASSQRGKTGKENEKLFF	TRBV7-3	TRBJ1-4
TGTGCCAGCAGGAAGAATCGCGAGCAGTACTTC	CASRKNREQYF	TRBV6-2	TRBJ2-7
TGTGCCAGCAGCTTAGACAGAAAGCAGTACTTC	CASSLDRKQYF	TRBV7-3	TRBJ2-7
TGCGCCCCTCCCGGGCAGAATTGGGACAGAGGGTACGAGCAGTACTTC	CAPPGQNWDRGYEQYF	TRBV5-1	TRBJ2-7
TGTGCCAGCAGCTTGGCTAACGGGCGGTTCTTC	CASSLANGRFF	TRBV5-6	TRBJ2-1
TGTGCCAGCAGTGAAAAACTGACAGGGCGGTTTTATCAGCCCCAGCATTTT	CASSEKLTGRFYQPQHF	TRBV6-1	TRBJ1-5
TGCGCCAGCAGCTTGGAGCCTAGCGGCTACCCCCACCTAGGAGAGCAGTTCTTC	CASSLEPSGYPHLGEQFF	TRBV5-1	TRBJ2-1
TGTGCCAGCAAGGGGACAGCTATATCCTACAATGAGCAGTTCTTC	CASKGTAISYNEQFF	TRBV6-4	TRBJ2-1
TGTGCCACCAGTGAGGCGGGACTAGTGGAATACGAGCAGTACTTC	CATSEAGLVEYEQYF	TRBV24-1	TRBJ2-7
TGTGCCAGCAGCTTATTCAGGGGGGGGTCCTATAATTCACCCCTCCACTTT	CASSLFRGGSYNSPLHF	TRBV7-9	TRBJ1-6
TGCAGTGGGGTTTCACGGACGGGGGGGGGCCTTGTGACCTACGAGCAGTACTTC	CSGVSRTGGGLVTYEQYF	TRBV20-1	TRBJ2-7
TGTGCCAGCAGCTTCAGGGCCCAGGTGCAGCCCCAGCATTTT	CASSFRAQVQPQHF	TRBV5-5	TRBJ1-5
TGTGCCAGCAGTTACTCCGGCACAGGGGGCTGCCTGCCCCAGCATTTT	CASSYSGTGGCLPQHF	TRBV6-5	TRBJ1-5
TGTGCCAGCAGAGGAGGCACAGATACGCAGTATTTT	CASRGGTDTQYF	TRBV12-4	TRBJ2-3
TGTGCCAGCAGCTTGGAAAACAGGGGGCTGGGCGTCTATGGCTACACCTTC	CASSLENRGLGVYGYTF	TRBV5-8	TRBJ1-2
TGTGCCAGCAGCTTAGTCTCCATTTGGGCCTACGAGCAGTACTTC	CASSLVSIWAYEQYF	TRBV7-9	TRBJ2-7
TGCAGTGCTAGAGTCCGGACTAGGCAGTTCTTC	CSARVRTRQFF	TRBV20-1	TRBJ2-1
TGTGCCAGCAGCTTAGTACTCCGGAGGGCCTCTGGGGCCAACGTCCTGACTTTC	CASSLVLRRASGANVLTF	TRBV7-2	TRBJ2-6
TGCAGCGCGGTTCACGGTCGGTACGAGCAGTACTTC	CSAVHGRYEQYF	TRBV29-1	TRBJ2-7
TGCAGTGCTAAGGGGTGGGCCAGGGGGTACAATGAGCAGTTCTTC	CSAKGWARGYNEQFF	TRBV20-1	TRBJ2-1
TGTGCCAGCAGCCAGACTGAAGCTTTCTTT	CASSQTEAFF	TRBV7-9	TRBJ1-1
TGTGCCAGCAGGCCCAATCGGGAGGGTTTGCTAGCCAAAAACATTCAGTACTTC	CASRPNREGLLAKNIQYF	TRBV6-5	TRBJ2-4
TGCGCCAGCAGTAATCAGGGTAACACCGGGGAGCTGTTTTTT	CASSNQGNTGELFF	TRBV10-1	TRBJ2-2
TGTGCCAGCAGCTACGCACTCGAGACCCAGTACTTC	CASSYALETQYF	TRBV13	TRBJ2-5
TGCGCCAGCAGCCAAGCCGGGACTAGCCATTGGCAGGCCTACGAGCAGTACTTC	CASSQAGTSHWQAYEQYF	TRBV4-3	TRBJ2-7
TGCGCCAGCAGTGAGGGGCGACAGGGTTTTGCAGCCGATCAGCCCCAGCATTTT	CASSEGRQGFAADQPQHF	TRBV10-1	TRBJ1-5
TGTGCCAGCAGATATGAGCGGGAGGGGGGACCCTACGAGCAGTACTTC	CASRYEREGGPYEQYF	TRBV9	TRBJ2-7
TGCGCCAGCAGCTGTATACAGGTCCACTATGGCTACACCTTC	CASSCIQVHYGYTF	TRBV5-1	TRBJ1-2
TGCGCCAGCAGCTTGTCGGGACAGGGGGCAACTTACGAGCAGTACTTC	CASSLSGQGATYEQYF	TRBV5-1	TRBJ2-7
TGTGCCACCAGTGATCATATTGAAGCTTTCTTT	CATSDHIEAFF	TRBV24-1	TRBJ1-1
TGTGCCAGCCAGGGTGGGTCCGGATTTAGCAATCAGCCCCAGCATTTT	CASQGGSGFSNQPQHF	TRBV6-5	TRBJ1-5
TGTGCCAGCAGTTTCCTAGGAGAACCAATGAACACTGAAGCTTTCTTT	CASSFLGEPMNTEAFF	TRBV6-5	TRBJ1-1
TGTGCCAGATCCAAAGGACCTGAAAAACTGTTTTTT	CARSKGPEKLFF	TRBV6-1	TRBJ1-4
TGTGCCAGCAGCGACAGGGGGCGGAGCTCCTATAATTCACCCCTCCACTTT	CASSDRGRSSYNSPLHF	TRBV7-3	TRBJ1-6
TGCGCCAGCAGCCAAGACCCACTAGCGGTTTTGGAGGGAGCCCACAATGAGCAGTTCTTC	CASSQDPLAVLEGAHNEQFF	TRBV4-1	TRBJ2-1
TGTGCCAGCAGCCACTTCCAGTCAGTTGGGAATTCACCCCTCCACTTT	CASSHFQSVGNSPLHF	TRBV14	TRBJ1-6
TGCGGCAGGGGGCGTGGAGAAGCTTTCTTT	CGRGRGEAFF	TRBV20-1	TRBJ1-1
TGCGCCAGCAGCTCGAGCAGGGACTGCCCCCCCGAGACCCAGTACTTC	CASSSSRDCPPETQYF	TRBV5-1	TRBJ2-5
TGTGCCAGCAGCTTAGCAGGGGGTTCATCTAACTATGGCTACACCTTC	CASSLAGGSSNYGYTF	TRBV7-2	TRBJ1-2
TGCAGCGTTGAACTAGCGGGAGGGCGGAAGAACGAGCAGTACTTC	CSVELAGGRKNEQYF	TRBV29-1	TRBJ2-7
TGTGCCAGCAGTTTATCCCGGTCCCGGGGGGACTATGGCTACACCTTC	CASSLSRSRGDYGYTF	TRBV27	TRBJ1-2
TGCAGTGCTTCAGGGGGGCAGCCCCAGCATTTT	CSASGGQPQHF	TRBV20-1	TRBJ1-5
TGTGCCAGCAGTTTGCCGGGGGGGGGCCGGAGCAATGAGCAGTTCTTC	CASSLPGGGRSNEQFF	TRBV27	TRBJ2-1
TGCGCCAGCAGCTGGGACCGCGAGCAGTACTTC	CASSWDREQYF	TRBV5-1	TRBJ2-7
TGTGCCAGCAGCCAAGATAACCGACAGGGGAACACTGAAGCTTTCTTT	CASSQDNRQGNTEAFF	TRBV14	TRBJ1-1
TGCGCCAGGGCGGGGCCGCTGGCCTACGAGCAGTACTTC	CARAGPLAYEQYF	TRBV5-1	TRBJ2-7
TGCGCCAGCAGAGGGACGGCGAACACCGGGGAGCTGTTTTTT	CASRGTANTGELFF	TRBV5-1	TRBJ2-2
TGTGCCAGCAGTTTACTAGCGGGGGGGCCCGAAGAGACCCAGTACTTC	CASSLLAGGPEETQYF	TRBV12-3	TRBJ2-5
TGCGCCAGCAGCTGGGCGGGGGTCACTATGCTGGGCTACGAGCAGTACTTC	CASSWAGVTMLGYEQYF	TRBV5-1	TRBJ2-7
TGTGCCAGCAGCCGTACTAGCGGGAGTAGTCTCTTGGAGACCCAGTACTTC	CASSRTSGSSLLETQYF	TRBV5-8	TRBJ2-5
TGTGCCAGCAGTGCCTCAGGGAAGGGGAGGAAAGAGACCCAGTACTTC	CASSASGKGRKETQYF	TRBV6-1	TRBJ2-5
TGTGCCACCGGTAAGACAGGAAAAACCTACGAGCAGTACTTC	CATGKTGKTYEQYF	TRBV24-1	TRBJ2-7
TGTGCCAGCAGTGACCTTCCGCCGGGACAGGCAGAAAAACTGTTTTTT	CASSDLPPGQAEKLFF	TRBV25-1	TRBJ1-4
TGTGCCAGCAGCCAACACAGGTCGGGCTACACCTTC	CASSQHRSGYTF	TRBV3-1	TRBJ1-2
TGTGCCAGCACCTCCACGGTTTCCACAGATACGCAGTATTTT	CASTSTVSTDTQYF	TRBV6-2	TRBJ2-3
TGCAGCGTTGAAGATCACTGGGGGTCCTATGGCTACACCTTC	CSVEDHWGSYGYTF	TRBV29-1	TRBJ1-2
TGTGCCAGCAGCGTAGCCCGCGGGAGGGACACTGAAGCTTTCTTT	CASSVARGRDTEAFF	TRBV9	TRBJ1-1
TGTGCCAGCTCAAATCCGAGACCTGTGGATGAGCAGTTCTTC	CASSNPRPVDEQFF	TRBV18	TRBJ2-1
TGTGCCAGTAGTTTCGAGACAGCGCCCTACGAGCAGTACTTC	CASSFETAPYEQYF	TRBV19	TRBJ2-7
TGCGCCAGCAGCCGATGGACAGGACATGGTGAAGCTTTCTTT	CASSRWTGHGEAFF	TRBV4-1	TRBJ1-1
TGCGCCAGCAGCGGACGGCCCGGGGCCAACGTCCTGACTTTC	CASSGRPGANVLTF	TRBV5-1	TRBJ2-6
TGTGCCAGCATGATGGAAGTGGGGAATTACGAGCAGTACTTC	CASMMEVGNYEQYF	TRBV28	TRBJ2-7
TGTGCGCCTCTTCGAGAGAAGCAGCCCCAGCATTTT	CAPLREKQPQHF	TRBV7-9	TRBJ1-5
TGTGCCTGGAGAATACAGGGAACTGAAGCTTTCTTT	CAWRIQGTEAFF	TRBV30	TRBJ1-1
TGTGACCCCACCAGGGACCAGCCCCAGCATTTT	CDPTRDQPQHF	TRBV12-3	TRBJ1-5
TGTGCCAGCCCGGGGTTTGAAAAACTGTTTTTT	CASPGFEKLFF	TRBV11-3	TRBJ1-4
TGTGCCAGCAGGTACCGGACAGGGGGCTATGGCTACACCTTC	CASRYRTGGYGYTF	TRBV2	TRBJ1-2
TGTGCCAGCAGTTCCGGGGAGGGCGGGTACGAGCAGTACTTC	CASSSGEGGYEQYF	TRBV25-1	TRBJ2-7
TGTGCCAGCAGCCACCTTCCAACAGGCGAACAGGGAGAAGGCTACACCTTC	CASSHLPTGEQGEGYTF	TRBV14	TRBJ1-2
TGTGCCAGCAGCAAGGGAGACTACGAGCAGTACTTC	CASSKGDYEQYF	TRBV13	TRBJ2-7
TGTGCCAGCAGCTCCGAAGAGGGACTAGGGTTGAAGGGTGCCGGGGAGCTGTTTTTT	CASSSEEGLGLKGAGELFF	TRBV5-6	TRBJ2-2
TGTGCCAGTACGGCCGGGACTTATCTGAACACTGAAGCTTTCTTT	CASTAGTYLNTEAFF	TRBV19	TRBJ1-1
TGTGCCAGACGGGGCCGAAGAGCTAACTATGGCTACACCTTC	CARRGRRANYGYTF	TRBV7-3	TRBJ1-2
TGCAGCGTATTGGGACCGGCAGATACGCAGTATTTT	CSVLGPADTQYF	TRBV29-1	TRBJ2-3
TGTGCCAGCAGCACTCAAAGCTACGAGCAGTACTTC	CASSTQSYEQYF	TRBV7-3	TRBJ2-7
TGTGCCAGCAGTTTTAAAGGGACAGCGGAATTTTATGGCTACACCTTC	CASSFKGTAEFYGYTF	TRBV28	TRBJ1-2
TGTGCCAGCAGCCAACCCTTCCCGTACAATGAGCAGTTCTTC	CASSQPFPYNEQFF	TRBV3-1	TRBJ2-1
TGTGCCAGCAGTCAGGGCTCTAACTATGGCTACACCTTC	CASSQGSNYGYTF	TRBV6-5	TRBJ1-2
TGCAGTGCTAGAGATCCATCTGACTGGGGACAGGGGGTTAACATTCAGTACTTC	CSARDPSDWGQGVNIQYF	TRBV20-1	TRBJ2-4
TGTGCCAGCAGCGTAGCTGGGCCTAACAGGGAACCTCCCGAGGGATGCCCCGGGGAGCTGTTTTTT	CASSVAGPNREPPEGCPGELFF	TRBV9	TRBJ2-2
TGTGCCAGCAGCGTAGGGGCCGCCAGGACCAGTCTGGATTACAATGAGCAGTTCTTC	CASSVGAARTSLDYNEQFF	TRBV9	TRBJ2-1
TGTGCCAGCAGCCAAGCTCAACCGGGACAGGGGGTTGATAGCAATCAGCCCCAGCATTTT	CASSQAQPGQGVDSNQPQHF	TRBV3-1	TRBJ1-5
TGTGCCAGCAGCTTAGCGCACACGACAGGGGAGGGGCGGGAGCAGTACTTC	CASSLAHTTGEGREQYF	TRBV7-7	TRBJ2-7
TGCAGTGCTAGGACTCCGGGAGGGGTAGCTTTCTTT	CSARTPGGVAFF	TRBV20-1	TRBJ1-1
TGTGCTAGTGGTTTGGTGGGTACCGGGGAGCTGTTTTTT	CASGLVGTGELFF	TRBV12-5	TRBJ2-2
TGTGCCAGCAGTGAATACTACTCCCGGTATAGCAATCAGCCCCAGCATTTT	CASSEYYSRYSNQPQHF	TRBV25-1	TRBJ1-5
TGTGCCAGCAGTCGGGGGGGCCCGCAGTACTTC	CASSRGGPQYF	TRBV6-8	TRBJ2-5
TGTGCCAGCTCACCCCAGACTAGCGGGTCTAATGAGCAGTTCTTC	CASSPQTSGSNEQFF	TRBV18	TRBJ2-1
TGTGCCAGCAGCAGGAACAATCCGTACAGGGAGTATGGCTACACCTTC	CASSRNNPYREYGYTF	TRBV7-8	TRBJ1-2
TGTGCCAGCAGTGGCGCGCATCCAAGCCGGACCGAGACCGAGCAGTACTTC	CASSGAHPSRTETEQYF	TRBV27	TRBJ2-7
TGTGCCAGCAGTTTCCTCCAGCAGTGGGAAAAACTGTTTTTT	CASSFLQQWEKLFF	TRBV28	TRBJ1-4
TGTGCCACCATGACAGTTAAACCTGGGGCCAACGTCCTGACTTTC	CATMTVKPGANVLTF	TRBV24-1	TRBJ2-6
TGTGCCAGCAGCCTGGGGCGAACCCTCCACTTT	CASSLGRTLHF	TRBV13	TRBJ1-6
TGTGCCAGCATCCGACTCAGGGCCGAGAACACTGAAGCTTTCTTT	CASIRLRAENTEAFF	TRBV19	TRBJ1-1
TGTGCCAGCAGCGGAGGGGCACGCCCCAATCAGCCCCAGCATTTT	CASSGGARPNQPQHF	TRBV9	TRBJ1-5
TGTGCCACCGGGGCCTCTAGCAATCAGCCCCAGCATTTT	CATGASSNQPQHF	TRBV28	TRBJ1-5
TGCAGTGCTGAGGGAGGGGGGTCTAGGCCCAATGAGCAGTTCTTC	CSAEGGGSRPNEQFF	TRBV20-1	TRBJ2-1
TGCAGCGTTGTAAGAGGAACTCAGCCCCAGCATTTT	CSVVRGTQPQHF	TRBV29-1	TRBJ1-5
