TGTGCCAGCAGTTCTCCAGGGGTTAATAATGAAAAACTGTTTTTT	CASSSPGVNNEKLFF	TRBV6-4	TRBJ1-4
TGTGCCAGTAGTATCATGAAACTAGCGGACGAGCAGTACTTC	CASSIMKLADEQYF	TRBV19	TRBJ2-7
TGCGCCAGCAGCCGCCCAGAGACCCAGTACTTC	CASSRPETQYF	TRBV5-1	TRBJ2-5
TGTGCCAGCAGCCCATACCCCATCTCAGAGACCCAGTACTTC	CASSPYPISETQYF	TRBV3-1	TRBJ2-5
TGTGCCAGCAGACCCCGACTAGCGGGACCCTACAATGAGCAGTTCTTC	CASRPRLAGPYNEQFF	TRBV28	TRBJ2-1
TGTGCCAGCAGCAGGAGGGGGCAGTCCTACGAGCAGTACTTC	CASSRRGQSYEQYF	TRBV7-6	TRBJ2-7
TGCGCCAGCAGCCGGGGGGCCAATGAAAAACTGTTTTTT	CASSRGANEKLFF	TRBV5-1	TRBJ1-4
TGTGCCAGCAGTTACCAGGGACCGGTAGAGCAGTACTTC	CASSYQGPVEQYF	TRBV6-5	TRBJ2-7
TGTGCCAGCAGCAAGGGGACAGGACGAAACACCATATATTTT	CASSKGTGRNTIYF	TRBV7-9	TRBJ1-3
TGTGCCAGCAGTACGAGGGACTATGGCTACACCTTC	CASSTRDYGYTF	TRBV6-5	TRBJ1-2
TGTGCCAGCGATAAATCCTACGAGCAGTACTTC	CASDKSYEQYF	TRBV6-5	TRBJ2-7
TGCAGTGCCGGGACTAGCGGTCGGGGGGAGCTGTTTTTT	CSAGTSGRGELFF	TRBV20-1	TRBJ2-2
TGCAGCGTTGAAGACATTAGAGAATTTTACACCGGGGAGCTGTTTTTT	CSVEDIREFYTGELFF	TRBV29-1	TRBJ2-2
TGTGCCAGTACCCGTGGGGGTCGACACACTGAAGCTTTCTTT	CASTRGGRHTEAFF	TRBV19	TRBJ1-1
TGTGCCAGCAGTTTCCGGGACAGGGACCGGAGCTCCTACAATGAGCAGTTCTTC	CASSFRDRDRSSYNEQFF	TRBV27	TRBJ2-1
TGTGCCAGCAGCAAACCCAGGGGAAACACCATATATTTT	CASSKPRGNTIYF	TRBV7-6	TRBJ1-3
TGTGCCAGCAGCTCAACCCCAGAGGAAGAAAAACTGTTTTTT	CASSSTPEEEKLFF	TRBV28	TRBJ1-4
TGTGCCAGCAGTCCCCAAGACAGGACTGAAGCTTTCTTT	CASSPQDRTEAFF	TRBV11-2	TRBJ1-1
TGTGCCAGCAGTTACAGCGGTTATAAGGAGACCCAGTACTTC	CASSYSGYKETQYF	TRBV6-5	TRBJ2-5
TGCGCCAGCAATGGAGACAAACGATCCTACAATGAGCAGTTCTTC	CASNGDKRSYNEQFF	TRBV10-1	TRBJ2-1
TGTGCCACCAGTGATACTGAGGAGCGGTTCCGCTCCTACAATGAGCAGTTCTTC	CATSDTEERFRSYNEQFF	TRBV24-1	TRBJ2-1
TGTGCCAGCAGCCAAAAGCTGACGGGAGATACGCAGTATTTT	CASSQKLTGDTQYF	TRBV11-2	TRBJ2-3
TGTGCCAGCAGCGTATGCCAGGGGACCACTGAAGCTTTCTTT	CASSVCQGTTEAFF	TRBV9	TRBJ1-1
TGTGCCAGCAGCGTCCGGGACAGGGGGAATCAGCCCCAGCATTTT	CASSVRDRGNQPQHF	TRBV12-3	TRBJ1-5
TGCAGCGTGGCATATGGTCAAGAGACCCAGTACTTC	CSVAYGQETQYF	TRBV29-1	TRBJ2-5
TGTAGAGACAGGGGAGGCCCCGAGCAGTACTTC	CRDRGGPEQYF	TRBV6-5	TRBJ2-7
TGTGCCAGCAGTGAAGGGGACAGACTCAATCAGCCCCAGCATTTT	CASSEGDRLNQPQHF	TRBV25-1	TRBJ1-5
TGTGCCAGCAGTTTCGGCTCCTCACCCCTCCACTTT	CASSFGSSPLHF	TRBV12-3	TRBJ1-6
TGTGCCAGCAGGGTACGTTTCTATGGCTACACCTTC	CASRVRFYGYTF	TRBV6-5	TRBJ1-2
TGCGCCAGCAGCCAATTTTTCGGCCTCCCAGGGTGCTTTGCAACTAATGAAAAACTGTTTTTT	CASSQFFGLPGCFATNEKLFF	TRBV5-1	TRBJ1-4
TGTGCCGGGTACCGATTAGAAATTGGTCCCGACGAGCAGTACTTC	CAGYRLEIGPDEQYF	TRBV12-3	TRBJ2-7
TGTGCCAGCAAAAGTATGCTTCAGCAGCCCCAGCATTTT	CASKSMLQQPQHF	TRBV6-4	TRBJ1-5
TGTGCAGCGCTCCGTCAGTACAATGAGCAGTTCTTC	CAALRQYNEQFF	TRBV2	TRBJ2-1
TGTGCCAGCAGCCCCTGGACCCAAGAGACCCAGTACTTC	CASSPWTQETQYF	TRBV14	TRBJ2-5
TGTGCCAGCAGTTTGAAAACCCCGTCGAGACCGTCAATCCGGAACACTGAAGCTTTCTTT	CASSLKTPSRPSIRNTEAFF	TRBV28	TRBJ1-1
TGCAGCGTTGAACGATCCAACCAGGATCCGAACACCGGGGAGCTGTTTTTT	CSVERSNQDPNTGELFF	TRBV29-1	TRBJ2-2
TGTGCTAGTGGTTTAACGAAAAGGGACAGGGAGACCCAGTACTTC	CASGLTKRDRETQYF	TRBV12-5	TRBJ2-5
TGCGCCAGCAGCTCATGGACGGGTAGGGTAACTAATGAAAAACTGTTTTTT	CASSSWTGRVTNEKLFF	TRBV5-1	TRBJ1-4
TGTGCCAGCAGGACACAGGGGACGTCCTATGGCTACACCTTC	CASRTQGTSYGYTF	TRBV6-2	TRBJ1-2
TGTGCCAGCAGTAGACCCCTGAGCATGGGATTTCGGGAAAAACTGTTTTTT	CASSRPLSMGFREKLFF	TRBV25-1	TRBJ1-4
TGTGCCAGCAGTGAACCAATCTGGGCGTGGAACACTGAAGCTTTCTTT	CASSEPIWAWNTEAFF	TRBV2	TRBJ1-1
TGTGCCAGCTCACCTAAATGCTCAGGGCCAGGGCGACCCGAGCAGTACTTC	CASSPKCSGPGRPEQYF	TRBV18	TRBJ2-7
TGTGCCAGCAGTGACTCCGTTTGCAGGACAGGGCCCATGCGGAACACTGAAGCTTTCTTT	CASSDSVCRTGPMRNTEAFF	TRBV6-4	TRBJ1-1
TGTGCCAGCTCACCCACCCACGGGCAGCAGTACTTC	CASSPTHGQQYF	TRBV18	TRBJ2-7
TGCGCCAGCAGCCAAGACAGGGGGCCCTTGTACGAGCAGTACTTC	CASSQDRGPLYEQYF	TRBV4-1	TRBJ2-7
TGTGCCAGCTCACCGGGGGGGAGCTCCTACGAGCAGTACTTC	CASSPGGSSYEQYF	TRBV18	TRBJ2-7
TGCAGTGCCAGAGAGGGTTACGAGCAGTACTTC	CSAREGYEQYF	TRBV20-1	TRBJ2-7
TGTGCCAGCAGCGACAGGGGGCCCTGCACAGATACGCAGTATTTT	CASSDRGPCTDTQYF	TRBV13	TRBJ2-3
TGTGCCAGCAGTTATCAGCCCCAGCATTTT	CASSYQPQHF	TRBV27	TRBJ1-5
TGTGCCAGCAGCCGGGTAACGACCTTCTACGAGCAGTACTTC	CASSRVTTFYEQYF	TRBV7-9	TRBJ2-7
TGCGCCAGCTCCCTGGGGGGCCATAGAGACTATGGCTACACCTTC	CASSLGGHRDYGYTF	TRBV10-1	TRBJ1-2
TGTGCTAGTGGTTCTCACGGGACAAAAAACACTGAAGCTTTCTTT	CASGSHGTKNTEAFF	TRBV12-5	TRBJ1-1
TGCGCCAGCAAAGCTTGGGGGGACGGCTACACCTTC	CASKAWGDGYTF	TRBV10-1	TRBJ1-2
TGCGCCAGCAGCCAACAGCCGAGACGCTATGGCTACACCTTC	CASSQQPRRYGYTF	TRBV4-1	TRBJ1-2
TGTGCCAGCAGACCGGCCGCTGGCAAAATCCGAAGAAATTCACCCCTCCACTTT	CASRPAAGKIRRNSPLHF	TRBV7-9	TRBJ1-6
TGTGCCAGCAGTTACGAGTCCCCAGGCGTCGGGGCCAACGTCCTGACTTTC	CASSYESPGVGANVLTF	TRBV6-6	TRBJ2-6
TGTGCCAGCAGCCCTCATAGAACCCCTGGGGGGGATCGGACCTACGAGCAGTACTTC	CASSPHRTPGGDRTYEQYF	TRBV6-6	TRBJ2-7
TGTGCCAGCAGGACATCAGACCGGACAGGGCCGTCTCATAATTCACCCCTCCACTTT	CASRTSDRTGPSHNSPLHF	TRBV3-1	TRBJ1-6
TGTGCCAGCAGTAAGGCTTTTAACAGGAGGGGGAGGGACGAGCAGTACTTC	CASSKAFNRRGRDEQYF	TRBV12-4	TRBJ2-7
TGTGCCCCCATATACAGCGAGGGGGCGGATTACTTC	CAPIYSEGADYF	TRBV27	TRBJ2-5
TGTGCCAGCAGTGAGGAACGAAAGGGTGGAAACACCATATATTTT	CASSEERKGGNTIYF	TRBV6-1	TRBJ1-3
TGTGCCAGCCCCAAATATGGGATGACGATTAGCTGCACTGAAGCTTTCTTT	CASPKYGMTISCTEAFF	TRBV6-1	TRBJ1-1
TGTGCCAGCAGCCGAGGGGGCTATCAGCCCCAGCATTTT	CASSRGGYQPQHF	TRBV9	TRBJ1-5
TGTGCCAGCAGTTACACACTGCGGATACCGGGACACACGGGCCAAGAGACCCAGTACTTC	CASSYTLRIPGHTGQETQYF	TRBV27	TRBJ2-5
TGTGCCAGCAGTGAAGGGGAGGTTTACGAGCAGTACTTC	CASSEGEVYEQYF	TRBV27	TRBJ2-7
TGTGCCTGGAGTGACCAGGGTAGCAATCAGCCCCAGCATTTT	CAWSDQGSNQPQHF	TRBV30	TRBJ1-5
TGTGCCAGCAGGGCAGGTCGGACCCAGTACTTC	CASRAGRTQYF	TRBV27	TRBJ2-5
TGTGCCATCAGGGTTAGCGGGGGGGGCTACGAGCAGTACTTC	CAIRVSGGGYEQYF	TRBV10-3	TRBJ2-7
TGTGCCAGCAGCTTCAGGGGAACACTAGCGGGAGCCTTAGGGGCCAACGTCCTGACTTTC	CASSFRGTLAGALGANVLTF	TRBV5-4	TRBJ2-6
TGTGCCAGCAGCCGTTCGGGACAGGGTAGCAATCAGCCCCAGCATTTT	CASSRSGQGSNQPQHF	TRBV9	TRBJ1-5
TGTGCCAGCAAAGACAGTGGAATATCCTACGAGCAGTACTTC	CASKDSGISYEQYF	TRBV5-4	TRBJ2-7
TGTGCCAGCAGTTACAATGTCCTAGGGACAGATACGCAGTATTTT	CASSYNVLGTDTQYF	TRBV6-3	TRBJ2-3
TGTGCCAGCAGCTCGACTAGCGGGGAGCAGTACTTC	CASSSTSGEQYF	TRBV13	TRBJ2-7
TGCAGTGCTAGAGGCCCGAGTAAAGACGAGCAGTACTTC	CSARGPSKDEQYF	TRBV20-1	TRBJ2-7
TGTGCCAGCAGCCCGACAGTCCCCAGAAGGGGTGGCTACACCTTC	CASSPTVPRRGGYTF	TRBV5-6	TRBJ1-2
TGCGCCAGCAGCTTAACAGGGGGCCGGTCGACTGGGGCCAACGTCCTGACTTTC	CASSLTGGRSTGANVLTF	TRBV5-1	TRBJ2-6
TGCAGTGCTAGCTACCCAGGGAACGTTGAAAAACTGTTTTTT	CSASYPGNVEKLFF	TRBV20-1	TRBJ1-4
TGTGCCAGCAGTGACTCAGTCACCCGCGGAACAGGGTCGGAAGAGACCCAGTACTTC	CASSDSVTRGTGSEETQYF	TRBV6-4	TRBJ2-5
TGCGCCAGCCTCCGGGCGACTAGCGGGGAGCTGTTTTTT	CASLRATSGELFF	TRBV5-1	TRBJ2-2
TGTGCCAGCAGCGGCATAGGGACAGGGTTGGGGGCTAACTATGGCTACACCTTC	CASSGIGTGLGANYGYTF	TRBV11-2	TRBJ1-2
TGCGCCAGCAGCTTGGTTTGCGGACAGGGCGGGAGCAATCAGCCCCAGCATTTT	CASSLVCGQGGSNQPQHF	TRBV5-1	TRBJ1-5
TGTGCCAGCAGCCCACAGGGGGATCGAAGATATGGCTACACCTTC	CASSPQGDRRYGYTF	TRBV9	TRBJ1-2
TGTGCCAGCAGTTATGGGGATTCATCGGATCCAGCTTTCTTT	CASSYGDSSDPAFF	TRBV6-6	TRBJ1-1
TGTGCCAGCTCATTCCCTGGGGGACAGGGGCAGTCGACCTACGAGCAGTACTTC	CASSFPGGQGQSTYEQYF	TRBV18	TRBJ2-7
TGTGCCTGGAGTCACGGTCTGGGACGGAGACTCTTC	CAWSHGLGRRLF	TRBV30	TRBJ2-1
TGTGCCAGCAGTGAGGGGACATGGGACGTTTCACCCCTCCACTTT	CASSEGTWDVSPLHF	TRBV6-4	TRBJ1-6
TGTGCCAGCAGCTTAGTCCGGGACAAAAGTAGCAATCAGCCCCAGCATTTT	CASSLVRDKSSNQPQHF	TRBV7-2	TRBJ1-5
TGTGCCAGCATCTTCCCCCGGGAGGCTTCGGAGAACACTGAAGCTTTCTTT	CASIFPREASENTEAFF	TRBV7-9	TRBJ1-1
TGCAGTGCTGGACACGCTGAAAAACTGTTTTTT	CSAGHAEKLFF	TRBV20-1	TRBJ1-4
TGCAGTGCGCCGGACAGTGAAAACAATGAGCAGTTCTTC	CSAPDSENNEQFF	TRBV20-1	TRBJ2-1
TGCGCCCCGGGACAGGGGGGGGCGAACACCGGGGAGCTGTTTTTT	CAPGQGGANTGELFF	TRBV4-1	TRBJ2-2
TGCAGTGCTAGGGACAGGGGGCGGTTTGGCTATAATTCACCCCTCCACTTT	CSARDRGRFGYNSPLHF	TRBV20-1	TRBJ1-6
TGTGCCAGCAGTCAGCGGACAGGGGGGCCGGCCGAGCAGTACTTC	CASSQRTGGPAEQYF	TRBV27	TRBJ2-7
TGCAGTGCACAAGATTGTCCTTCCAGGGGGCGCGGGAGCAATCAGCCCCAGCATTTT	CSAQDCPSRGRGSNQPQHF	TRBV20-1	TRBJ1-5
TGTGCCACCAGTGGCCGGGAAAAACTGTTTTTT	CATSGREKLFF	TRBV24-1	TRBJ1-4
TGTGCCAGTACCGGACAGGCCTTCTACGAGCAGTACTTC	CASTGQAFYEQYF	TRBV19	TRBJ2-7
TGCGCCAGCAGTGAGGTAGGACTTGGGGAGCGAAGAAGGAGGTTAGGGTCCTACGAGCAGTACTTC	CASSEVGLGERRRRLGSYEQYF	TRBV10-1	TRBJ2-7
TGTGCCAGCAGAAGGACTAGATTTTGTGAGACCCAGTACTTC	CASRRTRFCETQYF	TRBV6-5	TRBJ2-5
TGTGCCAGCAGTCGACAATGTAGGTTCTATGGCTACACCTTC	CASSRQCRFYGYTF	TRBV2	TRBJ1-2
TGTGCCAGCACCTCTTGGGGCGATTGGGGGGACCCCACCGGGGAGCTGTTTTTT	CASTSWGDWGDPTGELFF	TRBV7-9	TRBJ2-2
