TGTGCCAGCAGTTACCGAGGGGCCGTTGGCTACACCTTC	CASSYRGAVGYTF	TRBV6-5	TRBJ1-2
TGTGCCACCAGTGATTGGGGGGCAGGGCGCTCCTTTCCAATATCCGAATCCTCCTACGAGCAGTACTTC	CATSDWGAGRSFPISESSYEQYF	TRBV24-1	TRBJ2-7
TGCGCCAGCAGCTTGCCGGAGGGTACCTACAATGAGCAGTTCTTC	CASSLPEGTYNEQFF	TRBV5-1	TRBJ2-1
TGTGCCTGGAGTCTCAGTACGGGGGGCATAACGAACACCGGGGAGCTGTTTTTT	CAWSLSTGGITNTGELFF	TRBV30	TRBJ2-2
TGCGCCAGCAGCTTGCGGATCCCTAACACTGAAGCTTTCTTT	CASSLRIPNTEAFF	TRBV5-1	TRBJ1-1
TGTGCCAGCAGCTTAAATCCAAGCCCTAATTCACCCCTCCACTTT	CASSLNPSPNSPLHF	TRBV7-6	TRBJ1-6
TGTGCCAGCAGTGCGATAAACTATGGCTACACCTTC	CASSAINYGYTF	TRBV25-1	TRBJ1-2
TGTGCCAGCAGTGACCCCCACAGGGGACGCTACAATGAGCAGTTCTTC	CASSDPHRGRYNEQFF	TRBV6-1	TRBJ2-1
TGTGCCAGCAGCGGATGGGCAAGGGACAGGGGACCCGATGGTAACTATGGCTACACCTTC	CASSGWARDRGPDGNYGYTF	TRBV13	TRBJ1-2
TGTGCCAGCAGTGATGGCCCTGGGAGGGGGGGCAGGACCTCCTACGAGCAGTACTTC	CASSDGPGRGGRTSYEQYF	TRBV6-1	TRBJ2-7
TGTGCCAGCAGTTCTGGCCCTCTAGGTGAGCAGTTCTTC	CASSSGPLGEQFF	TRBV28	TRBJ2-1
TGTGCCAGCATTCTGGGGGCGGGTAATGAAAAACTGTTTTTT	CASILGAGNEKLFF	TRBV6-5	TRBJ1-4
TGTGCCAGCAGTGGAAGTGTAGGGTGGGTGCACACTGAAGCTTTCTTT	CASSGSVGWVHTEAFF	TRBV6-4	TRBJ1-1
TGTGCCAGCAGCTCGAGGGATCAGCCCCAGCATTTT	CASSSRDQPQHF	TRBV13	TRBJ1-5
TGTGCCAGCAGCGGCTTACAGGGCGTCAATCAGCCCCAGCATTTT	CASSGLQGVNQPQHF	TRBV11-2	TRBJ1-5
TGTGCCAGCAGCCTTAGGACTAGCGGGAAACCCTCCTACAATGAGCAGTTCTTC	CASSLRTSGKPSYNEQFF	TRBV7-9	TRBJ2-1
TGTGCCAGCAGCTTGCCGAAGGGGGGGCCGTCCTCCGAAGATACGCAGTATTTT	CASSLPKGGPSSEDTQYF	TRBV11-2	TRBJ2-3
TGTGCCAGCAGCGTGTACAGGGGGAATCAGCCCCAGCATTTT	CASSVYRGNQPQHF	TRBV7-4	TRBJ1-5
TGTGTACAGGGGAGTACCGGGGAGCTGTTTTTT	CVQGSTGELFF	TRBV12-3	TRBJ2-2
TGTGCCAGCACCGCCAGAGACCCTAGGTCAACCAACAATGAGCAGTTCTTC	CASTARDPRSTNNEQFF	TRBV7-3	TRBJ2-1
TGTGCCAGCAGCTTGAACAGGGGCAAAAACGAGCAGTACTTC	CASSLNRGKNEQYF	TRBV5-6	TRBJ2-7
TGTGCCAGCAGCATAGGAGGAATCGTTGAGCAGTTCTTC	CASSIGGIVEQFF	TRBV7-2	TRBJ2-1
TGTGCCAGCAGTGAGAGGGGGCTTGCCAAAAACATTCAGTACTTC	CASSERGLAKNIQYF	TRBV6-1	TRBJ2-4
TGTGCCAGCAGTCATCCCCGACAGATCTATGGCTACACCTTC	CASSHPRQIYGYTF	TRBV27	TRBJ1-2
TGTGCCAGCTCACGTCTGGGGAAAGATACGCAGTATTTT	CASSRLGKDTQYF	TRBV18	TRBJ2-3
TGCGCCAGCAGTGATTTCCTGGACAGTGGCGGAGAACATAGCAATCAGCCCCAGCATTTT	CASSDFLDSGGEHSNQPQHF	TRBV10-1	TRBJ1-5
TGTGCCAGCAGCGCCGGGGCGCTCCCCGGAAGCACCGGGGAGCTGTTTTTT	CASSAGALPGSTGELFF	TRBV13	TRBJ2-2
TGCGCCAGCAGGTTGCGTGTGTGGGGTCCCAACACTGAAGCTTTCTTT	CASRLRVWGPNTEAFF	TRBV10-1	TRBJ1-1
TGTGCCAGCAGCTCGAGACAGGTCAAGTATGAAAAACTGTTTTTT	CASSSRQVKYEKLFF	TRBV9	TRBJ1-4
TGCGCCAGCAGCCCCCAGAGCTCCGTATCGAAGGAGACCCAGTACTTC	CASSPQSSVSKETQYF	TRBV5-1	TRBJ2-5
TGTGCCATCCAGGAGGTCTACGAGCAGTACTTC	CAIQEVYEQYF	TRBV6-5	TRBJ2-7
TGTGCCAGCAGTGCTTCCTTCATTGCTAGGAGAACTAGCACAGATACGCAGTATTTT	CASSASFIARRTSTDTQYF	TRBV6-4	TRBJ2-3
TGTGCCAGCAGCTTCGAACTCCCCATGAACACTGAAGCTTTCTTT	CASSFELPMNTEAFF	TRBV7-4	TRBJ1-1
TGTGCCAGCAGCGACAGGGGGGGGGCCTACGAGCAGTACTTC	CASSDRGGAYEQYF	TRBV5-4	TRBJ2-7
TGTGCCAGCAGCCATAGGACAGGGCGGAAGCTGTTTTTT	CASSHRTGRKLFF	TRBV14	TRBJ2-2
TGCGCCAGCATACTCTACGAGCAGTACTTC	CASILYEQYF	TRBV10-2	TRBJ2-7
TGTGCCAGCAGTGTCCCTGGCGAGTTAGATGAAAAACTGTTTTTT	CASSVPGELDEKLFF	TRBV6-4	TRBJ1-4
TGTGCTAGTACTAGCGGGGGGGCCGGAAGGGCCACAGATACGCAGTATTTT	CASTSGGAGRATDTQYF	TRBV12-5	TRBJ2-3
TGTGCCAGCAGCCAGGGGCCCGACGGGGTTTGCTACGAGCAGTACTTC	CASSQGPDGVCYEQYF	TRBV13	TRBJ2-7
TGTGCCAGCAGCTCCCGGAGGGCCAGCACAGATACGCAGTATTTT	CASSSRRASTDTQYF	TRBV5-4	TRBJ2-3
TGTGCCATCAGTGAGCTCATCCCGTTGACGTTAAACACCATATATTTT	CAISELIPLTLNTIYF	TRBV10-3	TRBJ1-3
TGCGCCAGCAGCCAAGATGACAGGGACTTTGGGAACACCGGGGAGCTGTTTTTT	CASSQDDRDFGNTGELFF	TRBV4-3	TRBJ2-2
TGTGCCAGCAGCGTAGGGGGCCGGGACAGGGAAGGAGACACTGAAGCTTTCTTT	CASSVGGRDREGDTEAFF	TRBV9	TRBJ1-1
TGTGCCAGCTCACCCAGCAGAGGCCAGCCCCAGCATTTT	CASSPSRGQPQHF	TRBV18	TRBJ1-5
TGTGCCAGCATTCGACCCTTCGAAAGCGGGAACAGGCCCCAGCATTTT	CASIRPFESGNRPQHF	TRBV2	TRBJ1-5
TGTGCCCGGGGGGATTCCTACGAGCAGTACTTC	CARGDSYEQYF	TRBV5-5	TRBJ2-7
TGTGCCAGCAGCCAAGACCCGATGGAGCGGGAGGGCGGCCGAAACTACGAGCAGTACTTC	CASSQDPMEREGGRNYEQYF	TRBV4-2	TRBJ2-7
TGTGCCACCAGTGATTTTGGGAGGGGAGGGGCAGGGAGAACAGATACGCAGTATTTT	CATSDFGRGGAGRTDTQYF	TRBV24-1	TRBJ2-3
TGTGCCATCAGTGAGTCCAACGAGGGGTGGGGGAAGGGGTACTACGAGCAGTACTTC	CAISESNEGWGKGYYEQYF	TRBV10-3	TRBJ2-7
TGTGCCAGCAGCTTCCAGAGCTCCTACGAGCAGTACTTC	CASSFQSSYEQYF	TRBV7-2	TRBJ2-7
TGTGCCAGCAGCTTAAGTGGGACAGCAAACATCACAGCTTTCTTT	CASSLSGTANITAFF	TRBV7-6	TRBJ1-1
TGCAGTGCACTAGCGGGAGTACCTGGCTACACCTTC	CSALAGVPGYTF	TRBV20-1	TRBJ1-2
TGTGCCAGCAGAAGGACAGGGGGGGGGGCCTATAATTCACCCCTCCACTTT	CASRRTGGGAYNSPLHF	TRBV6-5	TRBJ1-6
TGTGCCAGCAGGTCCAGGGGTCGCCGTCACGAGCAGTACTTC	CASRSRGRRHEQYF	TRBV12-4	TRBJ2-7
TGTGCCAGCAGTCGAGACAGGGGCTTCTTGCCACAGTACTTC	CASSRDRGFLPQYF	TRBV6-5	TRBJ2-4
TGTGCCAGCACGTCATCCATCATGTACGAGCAGTACTTC	CASTSSIMYEQYF	TRBV5-5	TRBJ2-7
TGTGCCCGGAGGACAGGAACTTGTTCGGTGAACACTGAAGCTTTCTTT	CARRTGTCSVNTEAFF	TRBV7-9	TRBJ1-1
TGCGCCAGCTCCCGTCAGGGGAAGCATCAGCCCCAGCATTTT	CASSRQGKHQPQHF	TRBV5-1	TRBJ1-5
TGCGCCAGCACCCTCGGTAGAACGGGTATACTGGGAGATACGCAGTATTTT	CASTLGRTGILGDTQYF	TRBV10-1	TRBJ2-3
TGCGCCAGCATCTCAGACAGGATGGAGGATTTGGGCTTGCTCACTGAAGCTTTCTTT	CASISDRMEDLGLLTEAFF	TRBV4-3	TRBJ1-1
TGTGCCAGCAGCCCTTACCCGGGACAGGGGGTAGCCGAAGCTTTCTTT	CASSPYPGQGVAEAFF	TRBV7-3	TRBJ1-1
TGTGCCAGCTCCGTTCGTTGGTCGGGACAGTCTGGAAACACCATATATTTT	CASSVRWSGQSGNTIYF	TRBV6-6	TRBJ1-3
TGTGCCTGGCCTCTAGGGGAGAGCTCTGGGGCCAACGTCCTGACTTTC	CAWPLGESSGANVLTF	TRBV28	TRBJ2-6
TGCAGTGCTAGGTATAAGAGTTCCTACGAGCAGTACTTC	CSARYKSSYEQYF	TRBV20-1	TRBJ2-7
TGTGCCAGCTCACTTACAGGGAGACAAACCACTGAAGCTTTCTTT	CASSLTGRQTTEAFF	TRBV18	TRBJ1-1
TGCAGTGCTCCCCCCAGGGGGCGCGTTTATGGCTACACCTTC	CSAPPRGRVYGYTF	TRBV20-1	TRBJ1-2
TGTGCCAGCCCTGGGGGGAGGGATCAGCCCCAGCATTTT	CASPGGRDQPQHF	TRBV12-4	TRBJ1-5
TGTGCCAGCAGTTATTCAGGGACTAACGAGCAGTACTTC	CASSYSGTNEQYF	TRBV28	TRBJ2-7
TGTGCCAGTAGTTTTAGGACTGACAGGAGGTATTTT	CASSFRTDRRYF	TRBV19	TRBJ2-3
TGTGCCAGCAGGGATAAAAGGGACAGGGCGAAGTCTGGAAACACCATATATTTT	CASRDKRDRAKSGNTIYF	TRBV27	TRBJ1-3
TGCGCCAGCAGCCATCGTCCGGGACAGGGCATCCGGGAGACCCAGTACTTC	CASSHRPGQGIRETQYF	TRBV4-3	TRBJ2-5
TGTGCCACCGAGACAGGGGGTACTGAAGCTTTCTTT	CATETGGTEAFF	TRBV24-1	TRBJ1-1
TGCGCCAGCAGCCAAGAGCCCATGACAGGGAACACCGGGGAGCTGTTTTTT	CASSQEPMTGNTGELFF	TRBV4-1	TRBJ2-2
TGTGCCAGCAGCTTGCGGCTAGTTAAAGTAGATACGCAGTATTTT	CASSLRLVKVDTQYF	TRBV5-4	TRBJ2-3
TGCGCCAGCAGCTATTCCGGAAAGATTGGGCCCAACGAGCAGTACTTC	CASSYSGKIGPNEQYF	TRBV5-1	TRBJ2-7
TGTGCCAGCAGCCGGTTCTGGCGGAAGAGCTCCTACAATGAGCAGTTCTTC	CASSRFWRKSSYNEQFF	TRBV5-4	TRBJ2-1
TGTGCCAGCAGTTACTTTCGGGGGCGAAATTCACCCCTCCACTTT	CASSYFRGRNSPLHF	TRBV6-6	TRBJ1-6
TGCGCCAGCAGCTTGGCAAACAGGGGGAACACTGAAGCTTTCTTT	CASSLANRGNTEAFF	TRBV5-1	TRBJ1-1
TGTGCCAGCAGTGCCGGAGGACAGAATCAGGAGACCCAGTACTTC	CASSAGGQNQETQYF	TRBV12-3	TRBJ2-5
TGCGCCAGCAGCCACCGGGGCCGCACAGATACGCAGTATTTT	CASSHRGRTDTQYF	TRBV4-1	TRBJ2-3
TGCCTCTGGACAGAAGCTTTCTTT	CLWTEAFF	TRBV20-1	TRBJ1-1
TGCAGCCCGTGGAACGGGGGGACTAGCGGGAGAGAGCCCGCCGAGCAGTACTTC	CSPWNGGTSGREPAEQYF	TRBV20-1	TRBJ2-7
TGTGCCAGCAGCCTTGAAGGACAGGGGTTAATCAATCAGCCCCAGCATTTT	CASSLEGQGLINQPQHF	TRBV11-2	TRBJ1-5
TGTGCCAGCAGGGCAACTAGCGGGGAACGACGAGAGCAGTTCTTC	CASRATSGERREQFF	TRBV12-4	TRBJ2-1
TGTGCCAGCGTCCGGGGGGCCACAGATACGCAGTATTTT	CASVRGATDTQYF	TRBV9	TRBJ2-3
TGTGGACCGTCAGGGCCTCAACCCCAAGAGACCCAGTACTTC	CGPSGPQPQETQYF	TRBV14	TRBJ2-5
TGTGCCAGCAGTGGTCGTGCGGGACAGTGGAACTATGGCTACACCTTC	CASSGRAGQWNYGYTF	TRBV6-1	TRBJ1-2
TGTGCCACCAGTGACCCTGGAGTCACGGAGGGTAATTCACCCCTCCACTTT	CATSDPGVTEGNSPLHF	TRBV24-1	TRBJ1-6
TGTGCCAGCACCCGTAGTGTCACACTGGCCTCTGGAAACACCATATATTTT	CASTRSVTLASGNTIYF	TRBV12-3	TRBJ1-3
TGTGCCAGCTTCCTACAGGGGGCCTACGAGCAGTACTTC	CASFLQGAYEQYF	TRBV6-5	TRBJ2-7
TGTGCCAAGGCACAGGGGTCTGAAGCTTTCTTT	CAKAQGSEAFF	TRBV6-4	TRBJ1-1
TGCAGTGCTAGCCCGCAGGCCCAAGAGACCCAGTACTTC	CSASPQAQETQYF	TRBV20-1	TRBJ2-5
TGTGCCAGCAGCTGGGGGGGAAATGAAGCTTTCTTT	CASSWGGNEAFF	TRBV7-3	TRBJ1-1
TGCAGCGTTGTCGTTGGACAGGGCTTTCTCTACGAGCAGTACTTC	CSVVVGQGFLYEQYF	TRBV29-1	TRBJ2-7
TGTGCCAGCAGGGGGTGGGGTGCCTACGAGCAGTACTTC	CASRGWGAYEQYF	TRBV6-5	TRBJ2-7
TGCGCCAGCAGCCAAGATGGGACTAGCGGGCAAGAGACCCAGTACTTC	CASSQDGTSGQETQYF	TRBV4-1	TRBJ2-5
TGTGCCAGCAGCTGTTTGGGACAGGGGTACGAGCAGTACTTC	CASSCLGQGYEQYF	TRBV13	TRBJ2-7
TGTGCCAGCAGTCCTACACAGGTAAACAAGGTCCCAGGGGGCAATCAGCCCCAGCATTTT	CASSPTQVNKVPGGNQPQHF	TRBV2	TRBJ1-5
TGTGCCAGCAGCTTCGGGCCTGGGACAGGCAACACTGAAGCTTTCTTT	CASSFGPGTGNTEAFF	TRBV11-3	TRBJ1-1
TGTGCCAGTAGTATTACCCATGAGCCCTATAACAAAAACATTCAGTACTTC	CASSITHEPYNKNIQYF	TRBV19	TRBJ2-4
