TGTGCCAGCAGTTACGGCCTGTACCCCCAGGGTGAAGCTTTCTTT	CASSYGLYPQGEAFF	TRBV6-2	TRBJ1-1
TGTGCCAGCAGTGAAGCTTCGGCCACTGAAGCTTTCTTT	CASSEASATEAFF	TRBV25-1	TRBJ1-1
TGCGCCAGCAGCTGCCCCGGGAATCGGAACACTGAAGCTTTCTTT	CASSCPGNRNTEAFF	TRBV5-1	TRBJ1-1
TGCAGTGCTAGAGAGGGGGACAACGCCCAAGAGACCCAGTACTTC	CSAREGDNAQETQYF	TRBV20-1	TRBJ2-5
TGTGCCAGCTCTGACCCCGGACGGCCCCCTTCCGGGGAGCTGTTTTTT	CASSDPGRPPSGELFF	TRBV18	TRBJ2-2
TGTGCCAGCAGCTTAGATTATCAGAGGGGCTATGGCTACACCTTC	CASSLDYQRGYGYTF	TRBV11-3	TRBJ1-2
TGTGCCAGCAGCCCGGGGGGACAGGGGGGGTATAACTATGGCTACACCTTC	CASSPGGQGGYNYGYTF	TRBV5-6	TRBJ1-2
TGCGCCAGCAGCTGCGGGGACAGATTTGACTGGCAAGCTTTCTTT	CASSCGDRFDWQAFF	TRBV5-1	TRBJ1-1
TGCGCCAGCAGCTTGGTACCAGGGCGTGTACAAGAGACCCAGTACTTC	CASSLVPGRVQETQYF	TRBV5-1	TRBJ2-5
TGTGCCAGCAGCTTAGCGTTTATACAACATAGACAAGAGACCCAGTACTTC	CASSLAFIQHRQETQYF	TRBV7-9	TRBJ2-5
TGTGCCAGCAGCGCAGGGGGATCGGGAGTGAACTATGGCTACACCTTC	CASSAGGSGVNYGYTF	TRBV9	TRBJ1-2
TGTGCCAGCAGCTTAGCCACGTCCGGGACATACACTGAAGCTTTCTTT	CASSLATSGTYTEAFF	TRBV7-9	TRBJ1-1
TGTGCCACCAGTTCGCAGGATGCCCCCAATCAGCCCCAGCATTTT	CATSSQDAPNQPQHF	TRBV24-1	TRBJ1-5
TGTGCCAGCAGTTTAAAGGCGATGTACGAGCAGTACTTC	CASSLKAMYEQYF	TRBV28	TRBJ2-7
TGTGCCAGCAGTGCGGCTCTCTATGGCTACACCTTC	CASSAALYGYTF	TRBV6-5	TRBJ1-2
TGTGCCAGTAAGGGTTACAATTGTTATGGCTACACCTTC	CASKGYNCYGYTF	TRBV19	TRBJ1-2
TGTGCCAGCAGTTGGCCCAGGGGCTACGAGCAGTACTTC	CASSWPRGYEQYF	TRBV28	TRBJ2-7
TGCGCCAGCACTTCGTGGGACAGCTTGGGGAACACCGGGGAGCTGTTTTTT	CASTSWDSLGNTGELFF	TRBV10-1	TRBJ2-2
TGCGCCAGCAGCTTGGCGGGACTAGCGGAGGCCTACGAGCAGTACTTC	CASSLAGLAEAYEQYF	TRBV5-1	TRBJ2-7
TGTGCCAGCAGCGAGAGGGGCTTCATGAACACTGAAGCTTTCTTT	CASSERGFMNTEAFF	TRBV5-4	TRBJ1-1
TGCAGTGCCCGCGGGGGGGGTGACAATGAGCAGTTCTTC	CSARGGGDNEQFF	TRBV20-1	TRBJ2-1
TGTGTGGGGGACAGGGACAGTGGAAACACCATATATTTT	CVGDRDSGNTIYF	TRBV25-1	TRBJ1-3
TGTGCCAGCAGCGCCGGGCCTTACTATGGCTACACCTTC	CASSAGPYYGYTF	TRBV7-4	TRBJ1-2
TGCAGTGCTCGCCAGGATAAACAAGATACGCAGTATTTT	CSARQDKQDTQYF	TRBV20-1	TRBJ2-3
TGTGCCAGCAGGGATCCGGGACTAGCGGGAGAGGGGACAGATACGCAGTATTTT	CASRDPGLAGEGTDTQYF	TRBV11-1	TRBJ2-3
TGCGCCAGCAGCCGTCCTCCACAGGGAGCTGGGGCCAACGTCCTGACTTTC	CASSRPPQGAGANVLTF	TRBV4-1	TRBJ2-6
TGCAGTGCAAGGGGGCCCAACACCGGGGAGCTGTTTTTT	CSARGPNTGELFF	TRBV20-1	TRBJ2-2
TGTGCCACGACGATCTACGAGCAGTACTTC	CATTIYEQYF	TRBV6-1	TRBJ2-7
TGTGCCAGCAGTCCTGGGTATTTTGCTACTAGCGGGAGGGCGTATCCCGAGACCCAGTACTTC	CASSPGYFATSGRAYPETQYF	TRBV12-4	TRBJ2-5
TGTGCCAGCACGAACGCAGGGGGATCCAATCAGCCCCAGCATTTT	CASTNAGGSNQPQHF	TRBV27	TRBJ1-5
TGCGCCACATTTGGACATACGAGCACCTCCGGCACAGATACGCAGTATTTT	CATFGHTSTSGTDTQYF	TRBV10-1	TRBJ2-3
TGTGCCAGCAGCTTAGAGGTTTTGACAACTAGCGGGGTGGGCACCGGGGAGCTGTTTTTT	CASSLEVLTTSGVGTGELFF	TRBV11-2	TRBJ2-2
TGTGCCAGCAGTTCTGGGGGGGGCATACAGGGCTACACCTTC	CASSSGGGIQGYTF	TRBV27	TRBJ1-2
TGTGCCAGCAGACCTGGACTAGCGGGGGGGCCTCACCGGTCCGAGCAGTACTTC	CASRPGLAGGPHRSEQYF	TRBV27	TRBJ2-7
TGTGCCACCCCGGGGGTGACAGAGGGCCGACACACTGAAGCTTTCTTT	CATPGVTEGRHTEAFF	TRBV15	TRBJ1-1
TGTGCCAGCCCGGGACAGGGAACAGATACGCAGTATTTT	CASPGQGTDTQYF	TRBV27	TRBJ2-3
TGCAGTGCTCCTGGACTCTCGCCGGGGTCCCAGTACTTC	CSAPGLSPGSQYF	TRBV20-1	TRBJ2-5
TGTGCCAGTGTCCCGGGACGAAATCAGCCCCAGCATTTT	CASVPGRNQPQHF	TRBV11-2	TRBJ1-5
TGTGCCAGCAGCCTGGGGAGGGAAGCTTTCTTT	CASSLGREAFF	TRBV11-3	TRBJ1-1
TGTGCCAGCAGTTACATAAGGGGGGGGGGAATTTACAATGAGCAGTTCTTC	CASSYIRGGGIYNEQFF	TRBV6-5	TRBJ2-1
TGTGCCAGTAGATGCAGCACGACTTCTCAGGGGCGAAACTATGGCTACACCTTC	CASRCSTTSQGRNYGYTF	TRBV19	TRBJ1-2
TGTGCCAGCAGCCAAGAGGAGGGGGGAGAGACCCAGTACTTC	CASSQEEGGETQYF	TRBV3-1	TRBJ2-5
TGTGCCAGCCCTCTACCTGGCTACACCTTC	CASPLPGYTF	TRBV25-1	TRBJ1-2
TGTGCCAGCAGCTTACGTTTCAGTCTAACTGGAAACACCATATATTTT	CASSLRFSLTGNTIYF	TRBV13	TRBJ1-3
TGTGCCAGCAGTTACATTCCGACAGGATCGAACACTGAAGCTTTCTTT	CASSYIPTGSNTEAFF	TRBV6-5	TRBJ1-1
TGCGCCAGCAGTGAGTCCGGCCTTCGAGTCACAGATACGCAGTATTTT	CASSESGLRVTDTQYF	TRBV10-1	TRBJ2-3
TGTGCCAAAGGGACTAGGCAGTACTTC	CAKGTRQYF	TRBV2	TRBJ2-7
TGCGCCAGCAGTGAAAGGGGACTAGCGGGCACGAACACCGGGGAGCTGTTTTTT	CASSERGLAGTNTGELFF	TRBV10-1	TRBJ2-2
TGTGCCACCAGTGATTTGCTGGGGAGGTTTGAGCCCCAGCATTTT	CATSDLLGRFEPQHF	TRBV24-1	TRBJ1-5
TGTGCCAGCAGCGGAGGATTACGCCATGAGCAGTTCTTC	CASSGGLRHEQFF	TRBV13	TRBJ2-1
TGTGCCAGCAGCTTCTGCTCTTTTGGGGGGGGCACAGATACGCAGTATTTT	CASSFCSFGGGTDTQYF	TRBV5-5	TRBJ2-3
TGTGCCAGCAAAGACAGGGGACTTCCCTCCTATAATTCACCCCTCCACTTT	CASKDRGLPSYNSPLHF	TRBV28	TRBJ1-6
TGTGCCAGCAGCACAGCCGGGACAGGGGTAGAGACCCAGTACTTC	CASSTAGTGVETQYF	TRBV13	TRBJ2-5
TGTGCCAGCAGCGCGGGGGCATGCTGGGGTGACACTGAAGCTTTCTTT	CASSAGACWGDTEAFF	TRBV9	TRBJ1-1
TGCAGCGTTAGCGGACGGGACGATCAGCCCCAGCATTTT	CSVSGRDDQPQHF	TRBV29-1	TRBJ1-5
TGCGCCAGCAGCCGGCGGGACACAGATACGCAGTATTTT	CASSRRDTDTQYF	TRBV4-1	TRBJ2-3
TGTGCCAGCAGCCGGGGCAACGTTTACCGGTACGAGCAGTACTTC	CASSRGNVYRYEQYF	TRBV7-3	TRBJ2-7
TGCGCCAGCAGTGGAGGGGGGCAGTACGAGCAGTACTTC	CASSGGGQYEQYF	TRBV10-1	TRBJ2-7
TGCGCCAGCTATGGGGGGTTATACACCTTC	CASYGGLYTF	TRBV5-1	TRBJ1-2
TGTGCCAGCAGCTTAGATTTTAAAAGGACAGGGCGTGGCTACACCTTC	CASSLDFKRTGRGYTF	TRBV11-3	TRBJ1-2
TGCAATTACTCTAGGGCCCGGAATGGCTACACCTTC	CNYSRARNGYTF	TRBV29-1	TRBJ1-2
TGTGCCACCAGTGCGGCGACTAGCGGCCGCCCTAGCTCCTACGAGCAGTACTTC	CATSAATSGRPSSYEQYF	TRBV24-1	TRBJ2-7
TGTGCCAGCAGTTTAGGGAAATGTACCCCGGGACTGGGAACGGGAAATGCAGATACGCAGTATTTT	CASSLGKCTPGLGTGNADTQYF	TRBV28	TRBJ2-3
TGTGCCCACGGGGAGGGGAGCTCCTACAATGAGCAGTTCTTC	CAHGEGSSYNEQFF	TRBV19	TRBJ2-1
TGTGCCAGAAAAACCACCAACAAGGGGGGGATGATAGATAGCACAGATACGCAGTATTTT	CARKTTNKGGMIDSTDTQYF	TRBV7-9	TRBJ2-3
TGTGCCATCAAGCGAGTCTTGACTAGCTGGAACTACAATGAGCAGTTCTTC	CAIKRVLTSWNYNEQFF	TRBV10-3	TRBJ2-1
TGTGCCAGCAGTGGCGGGAGAGGAAACACCATATATTTT	CASSGGRGNTIYF	TRBV5-5	TRBJ1-3
TGCAGTGCGGGCGCTCTATTCAGATCCCCCCCCTACGAGCAGTACTTC	CSAGALFRSPPYEQYF	TRBV20-1	TRBJ2-7
TGTGCCAGCAGCTACAACAGGGTATCCTATGGCTACACCTTC	CASSYNRVSYGYTF	TRBV5-6	TRBJ1-2
TGTGCCATCACAACAGGGGGAGCCAAAAACATTCAGTACTTC	CAITTGGAKNIQYF	TRBV6-5	TRBJ2-4
TGTGCCAGCAGTGACACCCATCAAGAGGAGAATGAAAAACTGTTTTTT	CASSDTHQEENEKLFF	TRBV25-1	TRBJ1-4
TGTGCCAGCAGCTATTTAACAGGGGGCGCGGCTGGAAAACTGTTTTTT	CASSYLTGGAAGKLFF	TRBV7-2	TRBJ1-4
TGCGCCAGCAGCCAAGTGGACAGGGGGATCCAAGAGACCCAGTACTTC	CASSQVDRGIQETQYF	TRBV4-1	TRBJ2-5
TGCGCCAGCAGCTGGGACAGGGGCCGAGGTCATGACTCGGGCGGGGAGCTGTTTTTT	CASSWDRGRGHDSGGELFF	TRBV5-1	TRBJ2-2
TGTGCCAGCAGCTTGGCCGGACCCTTAATTAGCGGGCCAACCTACAATGAGCAGTTCTTC	CASSLAGPLISGPTYNEQFF	TRBV5-6	TRBJ2-1
TGTGCTAGCAGCGAAGGGGGCCTCTCACCCCTCCACTTT	CASSEGGLSPLHF	TRBV7-7	TRBJ1-6
TGCAGTGCTAGAGATCTCCGTTCCTACAGAAACCGCTACGAGCAGTACTTC	CSARDLRSYRNRYEQYF	TRBV20-1	TRBJ2-7
TGTGCCACCAGCAGAAAGGGGGAACGGGCCCGGGAAAAACTGTTTTTT	CATSRKGERAREKLFF	TRBV15	TRBJ1-4
TGTGCCAGCAGCGTACAGCGGGATACGCTCTTC	CASSVQRDTLF	TRBV13	TRBJ2-1
TGTGCCAGCAGTGACAAAGTTGACGGGACAGGGGGTTTAGAGCAGTTCTTC	CASSDKVDGTGGLEQFF	TRBV6-4	TRBJ2-1
TGTGCCAGCACCCGTGGGGCCCCCTGCGACACCTTC	CASTRGAPCDTF	TRBV6-6	TRBJ1-2
TGTGCCAGCAGTCTCCTGCCCTGGTCCTGCAATCAGCCCCAGCATTTT	CASSLLPWSCNQPQHF	TRBV6-1	TRBJ1-5
TGTGCCAGCAGCTTGGGGGGGGAGTTGATTAAGTCCTCTAACAATGAGCAGTTCTTC	CASSLGGELIKSSNNEQFF	TRBV7-4	TRBJ2-1
TGTGCCAGCGAAACAGGGGCTTTGGGGTGGTATGGCTACACCTTC	CASETGALGWYGYTF	TRBV11-3	TRBJ1-2
TGTGCCAGCAAACGGTCCTACAGGGAAGGGCAGCCCTACGAGCAGTACTTC	CASKRSYREGQPYEQYF	TRBV11-2	TRBJ2-7
TGTGGACCGGGACTAGGGGCTACGCAGTATTTT	CGPGLGATQYF	TRBV6-5	TRBJ2-3
TGTGCCACCCTGGCGATGTCAGCTGAAGCTTTCTTT	CATLAMSAEAFF	TRBV6-5	TRBJ1-1
TGCAGACAGGGCCCAAGTAATTCACCCCTCCACTTT	CRQGPSNSPLHF	TRBV20-1	TRBJ1-6
TGTGCCAGTACGGGGGGGGGGTCGGGATCCTCCTACAATGAGCAGTTCTTC	CASTGGGSGSSYNEQFF	TRBV19	TRBJ2-1
TGTGCCAGCAGTTTGAAGAGTATCAGGGTCAGCACAGATACGCAGTATTTT	CASSLKSIRVSTDTQYF	TRBV12-3	TRBJ2-3
TGTGCCATCAGTGAGTCGGACCTTTGGCCAGGACTTAAAGAGACCCAGTACTTC	CAISESDLWPGLKETQYF	TRBV10-3	TRBJ2-5
TGTGCCAGCAGCTTGGCGACAGGGGGCAGGCAACTTAGGGACGAGCAGTACTTC	CASSLATGGRQLRDEQYF	TRBV5-4	TRBJ2-7
TGTGCCAGCAGTAAGACAGAATGGTGTCATGAGCAGTTCTTC	CASSKTEWCHEQFF	TRBV28	TRBJ2-1
TGTGCCAGCAGTGATCCAAGTACGAACACTGAAGCTTTCTTT	CASSDPSTNTEAFF	TRBV6-1	TRBJ1-1
TGTGCCAGTAAAGACCTTGAATACTTCTACGAGCAGTACTTC	CASKDLEYFYEQYF	TRBV19	TRBJ2-7
TGTGCCAGCAGTTATGGAGTCGACAGAGTCGAGAGGGGGAAGGCTTTCTTT	CASSYGVDRVERGKAFF	TRBV6-5	TRBJ1-1
TGTGCCAGCAGTTTACCCGACAGGGACGCCAAAAACATTCAGTACTTC	CASSLPDRDAKNIQYF	TRBV12-4	TRBJ2-4
TGCGCCAGCAGCGAATTAACGCGCCAAGAGACCCAGTACTTC	CASSELTRQETQYF	TRBV4-1	TRBJ2-5
TGTGCCAGCATTCTCTGCCCTAATTCCACAGATACGCAGTATTTT	CASILCPNSTDTQYF	TRBV7-9	TRBJ2-3
TGCGCCAGCAGATTAATAGTTTACGAGCAGTACTTC	CASRLIVYEQYF	TRBV10-1	TRBJ2-7
