TGCGAACAGGGTAACCCCTACGAGCAGTACTTC	CEQGNPYEQYF	TRBV10-2	TRBJ2-7
TGTGCCAGCAGTGAAGCCCCGGCGTCTGGAAACACCATATATTTT	CASSEAPASGNTIYF	TRBV6-1	TRBJ1-3
TGCGCCAGCAGCTTGGCATCCAACAAGGGGGACTACACCGGGGAGCTGTTTTTT	CASSLASNKGDYTGELFF	TRBV5-1	TRBJ2-2
TGTGCCAGCAGTTTGTTTTCGCCCTTGTTACTGAACAATGAGCAGTTCTTC	CASSLFSPLLLNNEQFF	TRBV25-1	TRBJ2-1
TGCAGTGCTAGAGAGGCCGGGACAGCAAACACTGAAGCTTTCTTT	CSAREAGTANTEAFF	TRBV20-1	TRBJ1-1
TGTGCCAGCGAGTTGCAAACCCCGGCCGGGGTGCAGTACTTC	CASELQTPAGVQYF	TRBV28	TRBJ2-7
TGTGCCACCAGCAGAAAGACTCGTCCACGGTTCTACGAGCAGTACTTC	CATSRKTRPRFYEQYF	TRBV15	TRBJ2-7
TGTGCCAGCAGTTCCAGGAGGCGGGAGGGGACTACTGAAGCTTTCTTT	CASSSRRREGTTEAFF	TRBV28	TRBJ1-1
TGTGCCAGCAGAGGCACGACAGGGAGTGGGGGTGGCTATGGCTACACCTTC	CASRGTTGSGGGYGYTF	TRBV7-4	TRBJ1-2
TGCGCCAGCAAGGACAGGCCTAGCACAGATACGCAGTATTTT	CASKDRPSTDTQYF	TRBV10-1	TRBJ2-3
TGTGCCAGCAGCCAAGTAAGGACTAGCGGGAGGGGCTACGAGCAGTACTTC	CASSQVRTSGRGYEQYF	TRBV4-2	TRBJ2-7
TGTGCCAGCAGCAGACAGGGGGCGCGGCTTGTAGCTTTCTTT	CASSRQGARLVAFF	TRBV6-2	TRBJ1-1
TGTGCCAGCTGTGACAGGGTGAACACTGAAGCTTTCTTT	CASCDRVNTEAFF	TRBV19	TRBJ1-1
TGTGCCAGCAGCCAAACGGAAGTCTTC	CASSQTEVF	TRBV3-1	TRBJ2-1
TGTGCCAGCTCACCAAGACTAGACCCTTACAATGAGCAGTTCTTC	CASSPRLDPYNEQFF	TRBV18	TRBJ2-1
TGCAGCGAGCCGGGGCGACCAAACACCATATATTTT	CSEPGRPNTIYF	TRBV29-1	TRBJ1-3
TGTGCCAGCAGCCAAGGTGGGAAGACCCAGTACTTC	CASSQGGKTQYF	TRBV3-1	TRBJ2-5
TGTGCCAGCAAAGGCGCTGAAGCTTTCTTT	CASKGAEAFF	TRBV2	TRBJ1-1
TGTGCCAGCTCCCTTGGGGGGGCCAGCTCCTACAATGAGCAGTTCTTC	CASSLGGASSYNEQFF	TRBV25-1	TRBJ2-1
TGTGCCAGCAGCCAAGATGAGCCCCAGGAGCCCCAGCATTTT	CASSQDEPQEPQHF	TRBV3-1	TRBJ1-5
TGTGCCAGTACACTAGCGGGAGAGATTACCTACAATGAGCAGTTCTTC	CASTLAGEITYNEQFF	TRBV19	TRBJ2-1
TGCGCCAGCCCCAGGAGAGGCTCCTACGAGCAGTACTTC	CASPRRGSYEQYF	TRBV10-1	TRBJ2-7
TGCAGCGTTGTGCTAGGTCCTCTAGCGGTAGTGGGCTCCTACGAGCAGTACTTC	CSVVLGPLAVVGSYEQYF	TRBV29-1	TRBJ2-7
TGTGCCAGCAGCTTGGCGATCGGGAACACTGAAGCTTTCTTT	CASSLAIGNTEAFF	TRBV5-6	TRBJ1-1
TGTGCCAGCAGTTACGCCTCCGGGGCCGGTCCCCAGAGATACAATGAGCAGTTCTTC	CASSYASGAGPQRYNEQFF	TRBV6-2	TRBJ2-1
TGTGCCAGCAGCCTTCGTGGGGGTGAAAGGGGGGGGAAAGAATACGAGCAGTACTTC	CASSLRGGERGGKEYEQYF	TRBV13	TRBJ2-7
TGTGCCAGCAGTGAACCCGCGTCACCCCTCCACTTT	CASSEPASPLHF	TRBV2	TRBJ1-6
TGTGCCAACACCCATGGGGGTTTCTTAGAGACCCAGTACTTC	CANTHGGFLETQYF	TRBV12-4	TRBJ2-5
TGTGCCACCAGCCCCCTCGGACCCGAAGAGACCCAGTACTTC	CATSPLGPEETQYF	TRBV24-1	TRBJ2-5
TGTGCCAGCAGCCGAACAGGGGGGAACACTGAAGCTTTCTTT	CASSRTGGNTEAFF	TRBV11-2	TRBJ1-1
TGTGCCATCAGCTGGCCCAGGGAAAGCTCCTACAATGAGCAGTTCTTC	CAISWPRESSYNEQFF	TRBV10-3	TRBJ2-1
TGCAGTGCTAGCCCCAGTATAGATTCACCCCTCCACTTT	CSASPSIDSPLHF	TRBV20-1	TRBJ1-6
TGTGCCAGTAGTAGATGGCTCTTCCGCACACTCCGTAAGCAGCCCCAGCATTTT	CASSRWLFRTLRKQPQHF	TRBV19	TRBJ1-5
TGTGCCAGCAGTTTATTGGCTAGCGGGAGGGTAAATGAGCAGTTCTTC	CASSLLASGRVNEQFF	TRBV27	TRBJ2-1
TGTGCCAGTAGCGACACCGGGGAGCTGTTTTTT	CASSDTGELFF	TRBV19	TRBJ2-2
TGCGCCACCGGGGCGGGAGGTGGGCTCATTCAGTACTTC	CATGAGGGLIQYF	TRBV10-1	TRBJ2-4
TGTGCCAGCAGTTACTGGCCGGGTACCTATGGCTACACCTTC	CASSYWPGTYGYTF	TRBV6-5	TRBJ1-2
TGTGCCAGCAGCCAAGATCCTGAAGTCGAGCAGTACTTC	CASSQDPEVEQYF	TRBV3-1	TRBJ2-7
TGTGCCAGCAGTCCATGGGGGGCTGGGCCTGGGTTTACCTACAATGAGCAGTTCTTC	CASSPWGAGPGFTYNEQFF	TRBV12-4	TRBJ2-1
TGTGCTAGTGGTTTGGTACGTAGAATCGACCCCCCTTACGAGCAGTACTTC	CASGLVRRIDPPYEQYF	TRBV12-5	TRBJ2-7
TGCAGCGCGAAGGGACATACCGGGGAGCTGTTTTTT	CSAKGHTGELFF	TRBV29-1	TRBJ2-2
TGTGCCAGCAGTGACTCCCGGGACGGTGGCAATCAGCCCCAGCATTTT	CASSDSRDGGNQPQHF	TRBV6-4	TRBJ1-5
TGTGCCAGTAGTATTACTAGCGAGACCCAGTACTTC	CASSITSETQYF	TRBV19	TRBJ2-5
TGTGCCAGCAGTTTGTCAGGACACACTGAAGCTTTCTTT	CASSLSGHTEAFF	TRBV12-3	TRBJ1-1
TGTGCCAGCAGCTTGGTTAGACAACGTTCTGACAGGGGGAACACCGGGGAGCTGTTTTTT	CASSLVRQRSDRGNTGELFF	TRBV5-4	TRBJ2-2
TGTGCCAGCAGCTTAACGAAGTCTAGCAATGAGCAGTTCTTC	CASSLTKSSNEQFF	TRBV7-3	TRBJ2-1
TGTGCCAGCCCATCTGACCAGTACTTC	CASPSDQYF	TRBV27	TRBJ2-5
TGCGCCAGCAGCTTGGAAAGAGGGACAGGGGACGAGCAGTACTTC	CASSLERGTGDEQYF	TRBV5-1	TRBJ2-7
TGCGCCAGCGGGCCCCGGGGCACAGATACGCAGTATTTT	CASGPRGTDTQYF	TRBV5-1	TRBJ2-3
TGCAGCGGACAGGGTGGGTCTAATGAAAAACTGTTTTTT	CSGQGGSNEKLFF	TRBV29-1	TRBJ1-4
TGTGCCAGCAGCTTAACCTCATCTAACCGGGGTAGTTTGACTGAAGCTTTCTTT	CASSLTSSNRGSLTEAFF	TRBV11-2	TRBJ1-1
TGTGCCAGCACGTGTCTCGGGACAGTGAATCAGCCCCAGCATTTT	CASTCLGTVNQPQHF	TRBV7-6	TRBJ1-5
TGTGCTAGTGGTTTGGTACCGGGAGGGTGCTCTGGAAACACCATATATTTT	CASGLVPGGCSGNTIYF	TRBV12-5	TRBJ1-3
TGCAGTGCTGCCTCTGGTACAGGGTTCAATGAGCAGTTCTTC	CSAASGTGFNEQFF	TRBV20-1	TRBJ2-1
TGCGCCAGCACCCGGGACAGAAGGGGCTACACCTTC	CASTRDRRGYTF	TRBV10-2	TRBJ1-2
TGCGCCAGCAGCCCAGGGCCCGGGGGGGCCTACGAGCAGTACTTC	CASSPGPGGAYEQYF	TRBV10-1	TRBJ2-7
TGCAGCCTGTTCAGGGACAGGAGTGACTTGTACTATGGCTACACCTTC	CSLFRDRSDLYYGYTF	TRBV20-1	TRBJ1-2
TGTGCCAGCTGGGAATTGGGGGACAGTAAAAATCAGCCCCAGCATTTT	CASWELGDSKNQPQHF	TRBV5-6	TRBJ1-5
TGCATAGCGGTTGATGAGCAGTTCTTC	CIAVDEQFF	TRBV20-1	TRBJ2-1
TGTGCCAGCTCACAAATTGAGACCCAGTACTTC	CASSQIETQYF	TRBV18	TRBJ2-5
TGTGCCAGCAGCTTCCAGACCCTGGACAGGGACGCTGAAGCTTTCTTT	CASSFQTLDRDAEAFF	TRBV7-3	TRBJ1-1
TGTGCCACCAGCAGAGGACTCGGGAAGCGGGGCCATGGAGCCTACGAGCAGTACTTC	CATSRGLGKRGHGAYEQYF	TRBV15	TRBJ2-7
TGTGCCAGCAGCGGCGGGACCCATGGAACCCCGAGCTTGGACTACAATGAGCAGTTCTTC	CASSGGTHGTPSLDYNEQFF	TRBV9	TRBJ2-1
TGTGCCAGCAGCTTAAACGTGAGGAGTGATGAGCAGTTCTTC	CASSLNVRSDEQFF	TRBV7-3	TRBJ2-1
TGTGCCAGCAGTTACTGTAGGGGGACTAGCGGGTCCGAAAACATTCAGTACTTC	CASSYCRGTSGSENIQYF	TRBV6-5	TRBJ2-4
TGTGCCAGCAGTGAAGCGCCCTTGGGACTAGCGGGGTGCTCCTACGAGCAGTACTTC	CASSEAPLGLAGCSYEQYF	TRBV6-1	TRBJ2-7
TGTGCCAGCAGCGGGGAAATAATAGCCAGGGACAGGGCTAGTCGGTACAATGAGCAGTTCTTC	CASSGEIIARDRASRYNEQFF	TRBV7-3	TRBJ2-1
TGTGCCAGCAGCCCAGGGACTGGCGACACAGATACGCAGTATTTT	CASSPGTGDTDTQYF	TRBV11-2	TRBJ2-3
TGCGCCAGGTCTCTTACAGCAACCTACAATGAGCAGTTCTTC	CARSLTATYNEQFF	TRBV5-1	TRBJ2-1
TGCAGCGTCTCCAGGGGGTCGATGGACGAGCAGTACTTC	CSVSRGSMDEQYF	TRBV29-1	TRBJ2-7
TGTGCCAGCAGTTGGACAGCACTAGCTTTCTTT	CASSWTALAFF	TRBV12-3	TRBJ1-1
TGCAGTGCTAGAGATTTAGGGGGAGCGTTTAATTCACCCCTCCACTTT	CSARDLGGAFNSPLHF	TRBV20-1	TRBJ1-6
TGCAGTGCTAGAGCTGGGGGGTTCGGGGCAGATACGCAGTATTTT	CSARAGGFGADTQYF	TRBV20-1	TRBJ2-3
TGTGCCAGCAGTTCGAAGGGCCCCAGGTACGAGCAGTACTTC	CASSSKGPRYEQYF	TRBV27	TRBJ2-7
TGTGCCAGCAGTTACTCTATGGATTTCTCGGGGACTAGTAGCCAGCCATACAATGAGCAGTTCTTC	CASSYSMDFSGTSSQPYNEQFF	TRBV6-3	TRBJ2-1
TGCAGTGCTAGCCTGAGGACAGGGGAGCGGGAAAAACTGTTTTTT	CSASLRTGEREKLFF	TRBV20-1	TRBJ1-4
TGTGCCAGCAGTCCCGATGAGACAGGTAGGGGTAAAGAGACCCAGTACTTC	CASSPDETGRGKETQYF	TRBV27	TRBJ2-5
TGCGCCAGCAGTGATGCGGGGGCTGGGAGTTGGAGCTCCTACAATGAGCAGTTCTTC	CASSDAGAGSWSSYNEQFF	TRBV10-1	TRBJ2-1
TGCGCCAGCAGCCACAACAGGAGCAATCAGCCCCAGCATTTT	CASSHNRSNQPQHF	TRBV4-1	TRBJ1-5
TGCGCCAGCAGTTACCTCAGGGGACGAAGTCTGAACACTGAAGCTTTCTTT	CASSYLRGRSLNTEAFF	TRBV10-2	TRBJ1-1
TGTGGGGAGGTTGCCGGGGAGCTGTTTTTT	CGEVAGELFF	TRBV6-4	TRBJ2-2
TGTGCCTGGACGAGACTAGCGGCGCAAGAGACCCAGTACTTC	CAWTRLAAQETQYF	TRBV30	TRBJ2-5
TGTGCCAGCAGCCTAACGACAGGGATATATGGCTACACCTTC	CASSLTTGIYGYTF	TRBV11-2	TRBJ1-2
TGTGCCAGCAGCTTAGCTAACCGATCGTCCAGGGACACAGATACGCAGTATTTT	CASSLANRSSRDTDTQYF	TRBV7-9	TRBJ2-3
TGTGCCAGCAGCTTAGAGGAGGACAGAAACTATGGCTACACCTTC	CASSLEEDRNYGYTF	TRBV7-6	TRBJ1-2
TGCAGTGATCACAGGGATCCCTATGGCTACACCTTC	CSDHRDPYGYTF	TRBV20-1	TRBJ1-2
TGTGCCAGCAGTCGGGGGGGGAACACCGGGGAGCTGTTTTTT	CASSRGGNTGELFF	TRBV7-9	TRBJ2-2
TGTGCCAGCAGCTTAGTGGGCTGGACAAGGGAGTACTCCTACGAGCAGTACTTC	CASSLVGWTREYSYEQYF	TRBV7-9	TRBJ2-7
TGCGCCAGCAGCTTGGTCCTTCGGACGTTGTGCTACGAGCAGTACTTC	CASSLVLRTLCYEQYF	TRBV5-1	TRBJ2-7
TGCGCCAGCAGCTCCTGCACAGATACGCAGTATTTT	CASSSCTDTQYF	TRBV10-1	TRBJ2-3
TGCAGTGCAGAAGGCCCGGCCGGGAGACGAGAGGACCGGAGGGCCCCTGGAAACACCATATATTTT	CSAEGPAGRREDRRAPGNTIYF	TRBV20-1	TRBJ1-3
TGTGCCACCAGTGCTCCCCTCAGGGCCGGCGCGAACACCGGGGAGCTGTTTTTT	CATSAPLRAGANTGELFF	TRBV24-1	TRBJ2-2
TGTGCTAGTGGTTTGAGGGGGACAGGGGCACCGGCCTACGAGCAGTACTTC	CASGLRGTGAPAYEQYF	TRBV12-5	TRBJ2-7
TGTGCCAGCAGTGTTAAGGGTGGTTGCACCGGGGAGCTGTTTTTT	CASSVKGGCTGELFF	TRBV6-5	TRBJ2-2
TGTGCCAGCAGCTTATTGACAGGGACGAACACCGGGGAGCTGTTTTTT	CASSLLTGTNTGELFF	TRBV7-2	TRBJ2-2
TGTGCCAGCAGTGTAGGGCGATTGCGGAATTCACCCCTCCACTTT	CASSVGRLRNSPLHF	TRBV25-1	TRBJ1-6
TGTGCCAGCAGCTTGGAGGGGAATGAGTTCTTGCGGCGGCAAAGATTTCAGCCCCAGCATTTT	CASSLEGNEFLRRQRFQPQHF	TRBV5-6	TRBJ1-5
TGTGCCTGGATCGGGGCTAGCGGGGAAAAGGGATGGCGGAATGAGCAGTTCTTC	CAWIGASGEKGWRNEQFF	TRBV30	TRBJ2-1
TGTGCCAGCAGCCAAGGGGGGGCCGCTCTCAATGAGCAGTTCTTC	CASSQGGAALNEQFF	TRBV3-1	TRBJ2-1
TGCGCCAGCAGCTTGGTAGGGAACACTGAAGCTTTCTTT	CASSLVGNTEAFF	TRBV5-1	TRBJ1-1
