TGCGCCAGCTTATGGACAGGGTCCTATAATTCACCCCTCCACTTT	CASLWTGSYNSPLHF	TRBV5-1	TRBJ1-6
TGTGCCAGCAGCAACCGCGGAAGACGGGGGAAAGAGACCCAGTACTTC	CASSNRGRRGKETQYF	TRBV13	TRBJ2-5
TGTGCCAGCAGTTGTTCCGGAACGGAAGGCCCAGGCTACACCTTC	CASSCSGTEGPGYTF	TRBV28	TRBJ1-2
TGCGCCAGCACAGGGGGGGGGCAGCCCCAGCATTTT	CASTGGGQPQHF	TRBV5-1	TRBJ1-5
TGCGCCAGCAGCCACCGGGACAAAGCAACCGGGGAGCTGTTTTTT	CASSHRDKATGELFF	TRBV4-1	TRBJ2-2
TGCAGTGCCGTACGGGGGGGCCGGAGCACAGATACGCAGTATTTT	CSAVRGGRSTDTQYF	TRBV20-1	TRBJ2-3
TGTGCCAGCAGCCAACCTCTGATGAACAGGCTGTACTTC	CASSQPLMNRLYF	TRBV3-1	TRBJ2-7
TGTGCCAGCAGCTTACCAAGTGCAGGGGTATCCTATAATTCACCCCTCCACTTT	CASSLPSAGVSYNSPLHF	TRBV7-4	TRBJ1-6
TGTGCCAGCAGCTTGGCCGCACCAGACAGGGGGCAAACCCGCACAGATACGCAGTATTTT	CASSLAAPDRGQTRTDTQYF	TRBV5-6	TRBJ2-3
TGCAGTGCTAGTCCCAGCGGGGTTAAGAATGAGCAGTTCTTC	CSASPSGVKNEQFF	TRBV20-1	TRBJ2-1
TGCAGTGCCTTGATGTGCACAGATACGCAGTATTTT	CSALMCTDTQYF	TRBV20-1	TRBJ2-3
TGTGCCAGCCCAACTGGACAGGGGGCCTACGAGCAGTACTTC	CASPTGQGAYEQYF	TRBV6-4	TRBJ2-7
TGTGCCAGCAGCTTCCCGGGTCTCACAGATACGCAGTATTTT	CASSFPGLTDTQYF	TRBV11-3	TRBJ2-3
TGCAGCGTACGGACTATGAATGAGCAGTTCTTC	CSVRTMNEQFF	TRBV29-1	TRBJ2-1
TGTGCCAGCACCACTAATGGGGGGGCCCACATGCAGTTCTTC	CASTTNGGAHMQFF	TRBV9	TRBJ2-1
TGTGCCAGCAGTTTATCCAGGGATTCGGAAGGAGAGCAGTACTTC	CASSLSRDSEGEQYF	TRBV28	TRBJ2-7
TGTGCCAGCAGCGTCGGGCCCGCCACAGATACGCAGTATTTT	CASSVGPATDTQYF	TRBV13	TRBJ2-3
TGCGCCAGCAGTGCGACAGTGTCGTTGAACACTGAAGCTTTCTTT	CASSATVSLNTEAFF	TRBV10-1	TRBJ1-1
TGTGCCAGCCAGGGGGCCAGATTGAAATTAGGCTACGAGCAGTACTTC	CASQGARLKLGYEQYF	TRBV5-8	TRBJ2-7
TGTGCCACCAGTGATGGAGGCCGGGACCGGAATCAGCCCCAGCATTTT	CATSDGGRDRNQPQHF	TRBV24-1	TRBJ1-5
TGTGCCAGCAGCGAGCCTCGCGGTGGGGGGAACATATATAGCAATCAGCCCCAGCATTTT	CASSEPRGGGNIYSNQPQHF	TRBV9	TRBJ1-5
TGTGCCAGCAGCGGACAGGGGGTGAGCTCCTACGAGCAGTACTTC	CASSGQGVSSYEQYF	TRBV13	TRBJ2-7
TGTGCCACCAGATCTAGCGGATTCTACAATGAGCAGTTCTTC	CATRSSGFYNEQFF	TRBV24-1	TRBJ2-1
TGTGCCAGCAGTTACTCGAGGCCACAGCGCTCCTACAATGAGCAGTTCTTC	CASSYSRPQRSYNEQFF	TRBV6-5	TRBJ2-1
TGTGCCAGCAGGCGGAGATACTATCGTACAGATACGCAGTATTTT	CASRRRYYRTDTQYF	TRBV6-6	TRBJ2-3
TGTGCCAGCAGTTTACCGCAGGGGCCCTACGAGCAGTACTTC	CASSLPQGPYEQYF	TRBV27	TRBJ2-7
TGTGCCAGCAGGGAAAAACCGGACAGGGAGACCCAGTACTTC	CASREKPDRETQYF	TRBV2	TRBJ2-5
TGCGCCAGCCACGACACTAGCGGGAGGGCCTATGGCTACACCTTC	CASHDTSGRAYGYTF	TRBV10-1	TRBJ1-2
TGTGCCACCAGTGACCAGAAAACAGATACGCAGTATTTT	CATSDQKTDTQYF	TRBV24-1	TRBJ2-3
TGTGCCAGCAGCTCTTTCCGGACACATAAGGGGAACTATGGCTACACCTTC	CASSSFRTHKGNYGYTF	TRBV7-4	TRBJ1-2
TGTGCCAGCAGTGATGGGACTAGCGGGGTAGACAATGAGCAGTTCTTC	CASSDGTSGVDNEQFF	TRBV2	TRBJ2-1
TGTGCTAGTGCCCCCAGGGGTTCCGAGCAGTACTTC	CASAPRGSEQYF	TRBV12-5	TRBJ2-7
TGTGCCAAACCCTTAGGTGTTTCCGGGGAGCTGTTTTTT	CAKPLGVSGELFF	TRBV4-2	TRBJ2-2
TGTGCCAGCAGCTTGGACTTGTATAGCACAGATACGCAGTATTTT	CASSLDLYSTDTQYF	TRBV5-6	TRBJ2-3
TGTGCCAGCAGCCCGGCGGGGGGGGGACCCATCTATGGCTACACCTTC	CASSPAGGGPIYGYTF	TRBV13	TRBJ1-2
TGTGCTAGTGGTTTGGACATATGGGGGATCAAACTTGGGGCCAACGTCCTGACTTTC	CASGLDIWGIKLGANVLTF	TRBV12-5	TRBJ2-6
TGTGCCAGCAGTTTACTAGGCATTTACGTTAGGGGCTATGGCTACACCTTC	CASSLLGIYVRGYGYTF	TRBV27	TRBJ1-2
TGTGCCAGCAGTTTGGGACAGGGGGGGGAGCTGTTTTTT	CASSLGQGGELFF	TRBV12-3	TRBJ2-2
TGTGCCAGTAGTATCTTAGGGAGGGGCCACAATGAGCAGTTCTTC	CASSILGRGHNEQFF	TRBV19	TRBJ2-1
TGTGCCAGACAGGGGGCTGAAGCTTTCTTT	CARQGAEAFF	TRBV2	TRBJ1-1
TGTGCCAGTAGACAAGAACGGGCCCGTGAAAAACTGTTTTTT	CASRQERAREKLFF	TRBV19	TRBJ1-4
TGTGCTAGTGGTTGTGAGGTTCGTGAAAAACTGTTTTTT	CASGCEVREKLFF	TRBV12-5	TRBJ1-4
TGCAGTGCTGTCAGGGCCTACGAGCAGTACTTC	CSAVRAYEQYF	TRBV20-1	TRBJ2-7
TGCGCCAGCGTGGGGTGCGGGAACACTGAAGCTTTCTTT	CASVGCGNTEAFF	TRBV10-1	TRBJ1-1
TGTGCCAGCATCTCGGATATCGGGACTTGCTCCTACAATGAGCAGTTCTTC	CASISDIGTCSYNEQFF	TRBV7-9	TRBJ2-1
TGCGCCAGCAGCCAGTCTTTACATGGCTACACCTTC	CASSQSLHGYTF	TRBV4-1	TRBJ1-2
TGCGCCAGCAGTGAGCTTTTTCTGACGGAAAGGGGCCCCTCCTACGAGCAGTACTTC	CASSELFLTERGPSYEQYF	TRBV10-1	TRBJ2-7
TGCAGCGCTCTCCGGGACAGGGAGAACACTGAAGCTTTCTTT	CSALRDRENTEAFF	TRBV29-1	TRBJ1-1
TGTGCCAGCAGTTTACAGGGGTTCTACTATGGCTACACCTTC	CASSLQGFYYGYTF	TRBV28	TRBJ1-2
TGTGCCAGCAGCTCATTTAAAGCTTATGGCTACACCTTC	CASSSFKAYGYTF	TRBV7-3	TRBJ1-2
TGTGCCAGCACGGGAACTAGCGGGAGTTGGGGGTGCAAATGTGGGGCCAACGTCCTGACTTTC	CASTGTSGSWGCKCGANVLTF	TRBV6-1	TRBJ2-6
TGTGCCAGCAGTCCGGGAATTGACAGGGGGCAGGGCAATCAGCCCCAGCATTTT	CASSPGIDRGQGNQPQHF	TRBV6-1	TRBJ1-5
TGCAGTGCCCCTAACCAATACCGGGACAGGGAAACCGGGGAGCTGTTTTTT	CSAPNQYRDRETGELFF	TRBV20-1	TRBJ2-2
TGTGCCAGCAGTTACCCGACAGGTTCTAACTATGGCTACACCTTC	CASSYPTGSNYGYTF	TRBV6-5	TRBJ1-2
TGCGCCAGCAGCTTGGAATTTCCGGGACAGATGTACGAGCAGTACTTC	CASSLEFPGQMYEQYF	TRBV5-1	TRBJ2-7
TGTGCCAGCAGCTTAGCGACACCGACAGGCAGTTACTATGGCTACACCTTC	CASSLATPTGSYYGYTF	TRBV7-9	TRBJ1-2
TGCAGTGCTCCCCAGCGGCATATAGATACGCAGTATTTT	CSAPQRHIDTQYF	TRBV20-1	TRBJ2-3
TGTGCCAGCAGAGGGGGGCAGTACCAAGAGACCCAGTACTTC	CASRGGQYQETQYF	TRBV12-4	TRBJ2-5
TGTGCTAAGGCTAAGGAGGAAGGTGGCTACGAGCAGTACTTC	CAKAKEEGGYEQYF	TRBV4-2	TRBJ2-7
TGTGCCCATTCCGTAGACAGCTCCCTGAACACTGAAGCTTTCTTT	CAHSVDSSLNTEAFF	TRBV27	TRBJ1-1
TGTGCCAGCAGCTTGGAGTACCCCTACGAGCAGTACTTC	CASSLEYPYEQYF	TRBV11-3	TRBJ2-7
TGCGCCAGCAGCCGAACTCCGGTCGGAGGGTCCTACGAGCAGTACTTC	CASSRTPVGGSYEQYF	TRBV5-1	TRBJ2-7
TGTGCCAGCAGCCCTACCTACGAGCAGTACTTC	CASSPTYEQYF	TRBV13	TRBJ2-7
TGCAGCGTTGACACAGGGTTGGAATCTTACAATGAGCAGTTCTTC	CSVDTGLESYNEQFF	TRBV29-1	TRBJ2-1
TGCGCCAGCAGCCGGACAGGGGCTGAAGCTTTCTTT	CASSRTGAEAFF	TRBV10-1	TRBJ1-1
TGTGCCAGCAGGGTAGCCCCCCGATCCGGGACATACGTTGTTTCTGGGGCCAACGTCCTGACTTTC	CASRVAPRSGTYVVSGANVLTF	TRBV5-4	TRBJ2-6
TGCGCCAGCAGCTACCTAACCACCGATAACTATGGCTACACCTTC	CASSYLTTDNYGYTF	TRBV5-1	TRBJ1-2
TGTGCCAGCAGTGAAGCGTGGAGGCCCGAGATCTACAATGAGCAGTTCTTC	CASSEAWRPEIYNEQFF	TRBV6-1	TRBJ2-1
TGTGCCAGCAGCGGGAGGTCAGGGGGCGTGCTTACTGAAGCTTTCTTT	CASSGRSGGVLTEAFF	TRBV7-3	TRBJ1-1
TGCGCCAGCAGCCAAGCTCCGGGACAGGGGAGGGACAGGGTCACAGATACGCAGTATTTT	CASSQAPGQGRDRVTDTQYF	TRBV4-1	TRBJ2-3
TGTGCCAGCAGGGACGTCCGGGGCAGTAGGGGACCACCTCTCCGCTCTGGAAACACCATATATTTT	CASRDVRGSRGPPLRSGNTIYF	TRBV2	TRBJ1-3
TGTGCCAGCAGCCCAGACAGGGGCTACGAGCAGTACTTC	CASSPDRGYEQYF	TRBV13	TRBJ2-7
TGCAGTGCTAGAAAGGAACCGAGGACAGGGGAGAGGGTCGGAGGGAATCAGCCCCAGCATTTT	CSARKEPRTGERVGGNQPQHF	TRBV20-1	TRBJ1-5
TGTGCCAGCAGTGATGGGGACAGGGGGGGCTACACCTTC	CASSDGDRGGYTF	TRBV6-4	TRBJ1-2
TGTGCCAGCACCGCAGGGGCCGATGGCTACACCTTC	CASTAGADGYTF	TRBV28	TRBJ1-2
TGTGCCAGCACCGGCGAGCAGTACTTC	CASTGEQYF	TRBV6-2	TRBJ2-7
TGTGCCAGCAGCCAAGGGGGAGTGAACACTGAAGCTTTCTTT	CASSQGGVNTEAFF	TRBV7-7	TRBJ1-1
TGCGCCAGCAGCGGGGGAGGGGGCTTTAATGAAAAACTGTTTTTT	CASSGGGGFNEKLFF	TRBV5-1	TRBJ1-4
TGTGCCAGCAGCCAGGGCCCAGAGCTCTACGAGCAGTACTTC	CASSQGPELYEQYF	TRBV3-1	TRBJ2-7
TGTGCCAGCGTGGGGAAGGATAGCTCCTACAATGAGCAGTTCTTC	CASVGKDSSYNEQFF	TRBV7-4	TRBJ2-1
TGCGCCAGCACGACAGGGAGAAGCTCCTACGAGCAGTACTTC	CASTTGRSSYEQYF	TRBV10-2	TRBJ2-7
TGTGCCAGTATTCAGGAATCACAGGCCACCTACAATGAGCAGTTCTTC	CASIQESQATYNEQFF	TRBV19	TRBJ2-1
TGCGCCAGCAGCTTACAGGGGGCGGCAGAGCCCCAGCATTTT	CASSLQGAAEPQHF	TRBV5-1	TRBJ1-5
TGTGCCACCAAAAGGGAGGGGGCCAGAGATGAGCAGTTCTTC	CATKREGARDEQFF	TRBV24-1	TRBJ2-1
TGCAGCGTTGGGACCGGTGTGCCCCAGCATTTT	CSVGTGVPQHF	TRBV29-1	TRBJ1-5
TGTGCCTGGAGCCGTCAGCGAATCTTT	CAWSRQRIF	TRBV30	TRBJ1-1
TGTGCCAGCAGCGGGTGGCTAGACAGGGATTGCTACGAGCAGTACTTC	CASSGWLDRDCYEQYF	TRBV7-3	TRBJ2-7
TGTGCCAGCAGTAGGGGGTACCAGGAGAATGAAAAACTGTTTTTT	CASSRGYQENEKLFF	TRBV6-4	TRBJ1-4
TGTGCCAGCAGCTTAGGGACTAGCGGGGGGGCTTTAAGCCCTAGCACAGATACGCAGTATTTT	CASSLGTSGGALSPSTDTQYF	TRBV7-6	TRBJ2-3
TGTGCCAGCAGTGCCTCCCCTGGACTAGCGGGCCGTCGCTACGAGCAGTACTTC	CASSASPGLAGRRYEQYF	TRBV6-1	TRBJ2-7
TGTGCCAGCAGCCAAGGTCCCGGGACTAGCGGGGGGGGAGATACGCAGTATTTT	CASSQGPGTSGGGDTQYF	TRBV3-1	TRBJ2-3
TGCAGTGCTTTCCGACAGGGAGATGGCTACACCTTC	CSAFRQGDGYTF	TRBV20-1	TRBJ1-2
TGCAGTTTACATACAGGGGGGGACCGCGTCACGACCCAGTACTTC	CSLHTGGDRVTTQYF	TRBV20-1	TRBJ2-5
TGTGCCAGCAGCTTAATACTGAGGGAAGAGACCCAGTACTTC	CASSLILREETQYF	TRBV7-3	TRBJ2-5
TGTGCCAGCAGCGTCGGTCAGAGTGGCTACGAGCAGTACTTC	CASSVGQSGYEQYF	TRBV5-6	TRBJ2-7
TGTGCCAGCAGTGATGTAATACTTAATGAAAAACTGTTTTTT	CASSDVILNEKLFF	TRBV6-4	TRBJ1-4
TGTGCCACCGAGGGACTCAGTCCTGAGCAGTTCTTC	CATEGLSPEQFF	TRBV13	TRBJ2-1
TGTGCCAGCAGCGTATCCAGGACCGCGAACACTGAAGCTTTCTTT	CASSVSRTANTEAFF	TRBV9	TRBJ1-1
TGTGCCAGCAGCTTTCGCAGCCCAGGGGTGGAACCTACCGGGGAGCTGTTTTTT	CASSFRSPGVEPTGELFF	TRBV5-4	TRBJ2-2
TGTGCCAGCAGCTCCGGCAAAAGTACCGGGGAGCTGTTTTTT	CASSSGKSTGELFF	TRBV6-5	TRBJ2-2
