TGTGCCAGCAGCTTAGGAACGACAGGGGAACGTAACTATGGCTACACCTTC	CASSLGTTGERNYGYTF	TRBV11-3	TRBJ1-2
TGTGCCACCAGTGATTTGCAGCGACAGGGTTCCTACAATGAGCAGTTCTTC	CATSDLQRQGSYNEQFF	TRBV24-1	TRBJ2-1
TGTGCCAGCAGCGTAGAGGACCATGGGGACCTTAGGGTGAACACTGAAGCTTTCTTT	CASSVEDHGDLRVNTEAFF	TRBV9	TRBJ1-1
TGTGCCAGCAGTGAAGCGCGACCCGCCAGGGGCCCCTACGAGCAGTACTTC	CASSEARPARGPYEQYF	TRBV6-1	TRBJ2-7
TGTGCTAGTGGTTTGGTAAAAGCCCCACGGGGGGATAGCTCCTACAATGAGCAGTTCTTC	CASGLVKAPRGDSSYNEQFF	TRBV12-5	TRBJ2-1
TGCAGTGCTCGCGGGACAGGGACAGTGTACCAAGAGACCCAGTACTTC	CSARGTGTVYQETQYF	TRBV20-1	TRBJ2-5
TGTGCCAGCAGCGTTAGGCCGGACAGCACTAAGGACACTGAAGCTTTCTTT	CASSVRPDSTKDTEAFF	TRBV7-8	TRBJ1-1
TGCGCCAGCACCAGCGGGAAGCGCAAAGCCTCCTACGAGCAGTACTTC	CASTSGKRKASYEQYF	TRBV5-1	TRBJ2-7
TGTGCTAGCAGCTTACGGGACAATAGATACAATGAGCAGTTCTTC	CASSLRDNRYNEQFF	TRBV7-7	TRBJ2-1
TGCGCCAGCAGCTTCAGTCAGGGGGGGAATCAGCCCCAGCATTTT	CASSFSQGGNQPQHF	TRBV5-1	TRBJ1-5
TGTGCCACCAGTGATTCCCAACCAGCTGAAGCTTTCTTT	CATSDSQPAEAFF	TRBV24-1	TRBJ1-1
TGTGCCAGCAGTTCATATCAGGGTGGACTCACCGGGGAGCTGTTTTTT	CASSSYQGGLTGELFF	TRBV6-3	TRBJ2-2
TGTGCCAGTGAGACTGGCTACGAGCAGTACTTC	CASETGYEQYF	TRBV27	TRBJ2-7
TGCAGTGCTAGCCCCGCGACAGGGGGTAGCAATCAGCCCCAGCATTTT	CSASPATGGSNQPQHF	TRBV20-1	TRBJ1-5
TGTGCCAGCAGCAGCGCCAGGGTCGGCTACACCTTC	CASSSARVGYTF	TRBV7-3	TRBJ1-2
TGTGCCAGACGACAGGGGGACTTCTACGAGCAGTACTTC	CARRQGDFYEQYF	TRBV19	TRBJ2-7
TGTGCCAGCAGTTACTCGACCCCTTGGACAGGGGGGCGCTACGAGCAGTACTTC	CASSYSTPWTGGRYEQYF	TRBV6-5	TRBJ2-7
TGTGCCAGCAGTTACCCCCTCGGGGGATATAGCAATCAGCCCCAGCATTTT	CASSYPLGGYSNQPQHF	TRBV6-2	TRBJ1-5
TGTGCCAGCAGCCCGTGTGGGACAGGGGACTACGAGCAGTACTTC	CASSPCGTGDYEQYF	TRBV9	TRBJ2-7
TGTGCCACCAGCAGAGATAGTCCAGGGGGGTCAGATACGCAGTATTTT	CATSRDSPGGSDTQYF	TRBV15	TRBJ2-3
TGTGCCACCAGTGATGGGACGGTTACTAATGAAAAACTGTTTTTT	CATSDGTVTNEKLFF	TRBV24-1	TRBJ1-4
TGTGCCAGCAGCGGGACAGGCCCTTCCAAAAACATTCAGTACTTC	CASSGTGPSKNIQYF	TRBV9	TRBJ2-4
TGTGCCAGCAGCCCGCCGGAGGGGGATGGCTACACCTTC	CASSPPEGDGYTF	TRBV14	TRBJ1-2
TGTGCCAGCAGTAAAAGGGGGGGATCCGGGGAGCTGTTTTTT	CASSKRGGSGELFF	TRBV12-3	TRBJ2-2
TGCGCCAGCAGTGAAAGGTTCCCCCCTACAGAACAGAACACCGGGGAGCTGTTTTTT	CASSERFPPTEQNTGELFF	TRBV10-2	TRBJ2-2
TGCGCCAGCAGCTTGCCGCCCGGGAAGGAGACCCAGTACTTC	CASSLPPGKETQYF	TRBV5-1	TRBJ2-5
TGTGCCTCCGGGACACACTATGGCTACACCTTC	CASGTHYGYTF	TRBV6-4	TRBJ1-2
TGCGCCAGCAGCCAAGATTCCGTTCAACCACCGGCAATATACGAGCAGTACTTC	CASSQDSVQPPAIYEQYF	TRBV4-1	TRBJ2-7
TGTGCCAGCAGCTTAAAGGGGGTGACCACCGGGGAGCTGTTTTTT	CASSLKGVTTGELFF	TRBV11-2	TRBJ2-2
TGCAGTGCTAGAGCCACGGGGGAGGGGACTAATGAAAAACTGTTTTTT	CSARATGEGTNEKLFF	TRBV20-1	TRBJ1-4
TGCGCCAGCAGTCCAGGGGGCGCGAATTCACCCCTCCACTTT	CASSPGGANSPLHF	TRBV10-1	TRBJ1-6
TGTGCCAGCCGCGTCGAAGACAGGGCGACCGGGCATAGCAATCAGCCCCAGCATTTT	CASRVEDRATGHSNQPQHF	TRBV27	TRBJ1-5
TGTGCCAGCAGCTTAGAGCAAAGTCGATGGGACAAGCCTGAAGCTTTCTTT	CASSLEQSRWDKPEAFF	TRBV5-4	TRBJ1-1
TGTGCCAGCAGCCGGGGACATAGGAACACTGAAGCTTTCTTT	CASSRGHRNTEAFF	TRBV7-3	TRBJ1-1
TGTGCCAGCAGCAGGCACAGGGGGGACACCGGGGAGCTGTTTTTT	CASSRHRGDTGELFF	TRBV7-3	TRBJ2-2
TGTGCCAGTAGTATAGGGGTATGCTACGAGCAGTACTTC	CASSIGVCYEQYF	TRBV19	TRBJ2-7
TGTGCCAGCAGCGCGTGTAACGGAAGCGGGAGAAGCGAAGACGAGCAGTACTTC	CASSACNGSGRSEDEQYF	TRBV11-3	TRBJ2-7
TGCAGCGCAGTGGAGGGGGACTGCAGAAACATTCAGTACTTC	CSAVEGDCRNIQYF	TRBV29-1	TRBJ2-4
TGTGCCATCAGTGTGGGGGGACTAGCGGGGGGGCCCTCAGATACGCAGTATTTT	CAISVGGLAGGPSDTQYF	TRBV10-3	TRBJ2-3
TGCGCCAGCCAAGACAGGGGGGTTGCCGGGGAGCTGTTTTTT	CASQDRGVAGELFF	TRBV4-3	TRBJ2-2
TGTGCCAGCATCAGGGGCGAGCAGTACTTC	CASIRGEQYF	TRBV6-5	TRBJ2-7
TGTGCCAGCAGTAGGGTGACCGGGTTCAGGGGTCTTTCCTACTTC	CASSRVTGFRGLSYF	TRBV6-5	TRBJ2-7
TGCGCCAGCAGCTCCCGGTGTCGGGGGCCATGTTTTGAAGCTTTCTTT	CASSSRCRGPCFEAFF	TRBV5-1	TRBJ1-1
TGTGCCAGCAGCTTAGAGGGCAGGGTCGTCTGCACCGGGGAGCTGTTTTTT	CASSLEGRVVCTGELFF	TRBV7-4	TRBJ2-2
TGTGCCAGTAGTGGCCAAACTAGCGGGAGGATGAATTACGAGCAGTACTTC	CASSGQTSGRMNYEQYF	TRBV19	TRBJ2-7
TGTGCCAGCATAAGGCTCCTACTAGCGGGAGGGGTTGAAGCTTTCTTT	CASIRLLLAGGVEAFF	TRBV5-6	TRBJ1-1
TGTGCCAGCAGGCAATGCGGGGAAGAGACCCAGTACTTC	CASRQCGEETQYF	TRBV6-1	TRBJ2-5
TGCGCCAGCAACGAATGGTACAATGAGCAGTTCTTC	CASNEWYNEQFF	TRBV5-1	TRBJ2-1
TGTGCCAGCAGCCAGTACAGGGAATGGTCCTATAGCAATCAGCCCCAGCATTTT	CASSQYREWSYSNQPQHF	TRBV6-4	TRBJ1-5
TGCGCCAGCAGCTTGCGGACAGGGGGGGGCAATCAGCCCCAGCATTTT	CASSLRTGGGNQPQHF	TRBV5-1	TRBJ1-5
TGTGCCAGCAAGCGCATTGTCGGGGTAAACGAGCAGTACTTC	CASKRIVGVNEQYF	TRBV7-7	TRBJ2-7
TGCGCCAGCAGCCAAGATCCCTCGGGGAAGTGCTTAGAGACCCAGTACTTC	CASSQDPSGKCLETQYF	TRBV4-1	TRBJ2-5
TGTGCCAGCAGTGACCGGGCTAGCGGGGGGAGCTCCTACAATGAGCAGTTCTTC	CASSDRASGGSSYNEQFF	TRBV6-4	TRBJ2-1
TGTGCCAGCGAACCCGGCAGGGGCGGCATCGAAGATACGCAGTATTTT	CASEPGRGGIEDTQYF	TRBV7-3	TRBJ2-3
TGTGCCAGTAGTATTATCCTCACTGAAGCTTTCTTT	CASSIILTEAFF	TRBV19	TRBJ1-1
TGCAGTGCTAGTGGGGGGGCCACAGAGACCCAGTACTTC	CSASGGATETQYF	TRBV20-1	TRBJ2-5
TGTGCCAGCACCCTGGCGGTTAGCGGGAACCAAGAGACCCAGTACTTC	CASTLAVSGNQETQYF	TRBV9	TRBJ2-5
TGCAAACATCAGAACAATGAAAAACTGTTTTTT	CKHQNNEKLFF	TRBV29-1	TRBJ1-4
TGTGCCAGCAGCTTGGGGCGGACGGCCAGCGGGAACACTGAAGCTTTCTTT	CASSLGRTASGNTEAFF	TRBV5-4	TRBJ1-1
TGTGCCACCAGTGGGGTTTGGGCTGGGACTATTCCCTACAATGAGCAGTTCTTC	CATSGVWAGTIPYNEQFF	TRBV24-1	TRBJ2-1
TGTGCCAGCAGTTACTTTCAAGGAGGCGGAGAGAACACTGAAGCTTTCTTT	CASSYFQGGGENTEAFF	TRBV6-5	TRBJ1-1
TGTGCCAGGATCGGGCCTACCACCGGGGAGCTGTTTTTT	CARIGPTTGELFF	TRBV2	TRBJ2-2
TGTGCCAGGGCGGGACAGGGCGCCGCTTTCTTT	CARAGQGAAFF	TRBV19	TRBJ1-1
TGCGCCAGCAGCTTGCCGGGGTTCCGAGGGCATGAAGGGAATCAGCCCCAGCATTTT	CASSLPGFRGHEGNQPQHF	TRBV5-1	TRBJ1-5
TGTGCCAGCAACTTACGCCGGGACAGGGATAATGAAAAACTGTTTTTT	CASNLRRDRDNEKLFF	TRBV11-3	TRBJ1-4
TGTGCCAGCAAACTGGGGTCCAGACAACCCGGGTATAGCTACAATGAGCAGTTCTTC	CASKLGSRQPGYSYNEQFF	TRBV6-4	TRBJ2-1
TGTGCCAGCAGCCACTGCAGGGGCCAGGGCGCCCATTCACCCCTCCACTTT	CASSHCRGQGAHSPLHF	TRBV14	TRBJ1-6
TGTGCCAGTACGGCCCGGCGGGAGCCTAGCAACTATGGCTACACCTTC	CASTARREPSNYGYTF	TRBV19	TRBJ1-2
TGTGCCAGCAGAGGGTTGGAAGAGACCCAGTACTTC	CASRGLEETQYF	TRBV6-1	TRBJ2-5
TGTGCCAGCAGTTACTCTAAACCGGGACAGGGGGGACCCTCCTACGAGCAGTACTTC	CASSYSKPGQGGPSYEQYF	TRBV6-5	TRBJ2-7
TGCGCCAGCAGCCAAGATGAGGTAGACTACGAGCAGTACTTC	CASSQDEVDYEQYF	TRBV4-1	TRBJ2-7
TGTGCCACCAGTGATTTGCACCAGGGGGCATACGAGCAGTACTTC	CATSDLHQGAYEQYF	TRBV24-1	TRBJ2-7
TGTGCCAGAAGCGAGGCCGAAGCTTTCTTT	CARSEAEAFF	TRBV6-4	TRBJ1-1
TGTGCCAGCAGCTTGTCGGGACATGAGACTGAAGCTTTCTTT	CASSLSGHETEAFF	TRBV5-6	TRBJ1-1
TGTGCCAGCAGCCAAGACCGACAGGGGGCAAGGGGCTCCTACGAGCAGTACTTC	CASSQDRQGARGSYEQYF	TRBV3-1	TRBJ2-7
TGTGCCAGCAGCTTGGGGGGGCACCCACCCGGGGAGCTGTTTTTT	CASSLGGHPPGELFF	TRBV9	TRBJ2-2
TGCGCCAGCTTTAAAAGAGGACCCTACGAGCAGTACTTC	CASFKRGPYEQYF	TRBV5-1	TRBJ2-7
TGTGCCAGCAGCAAACCTTCTCCTGGCTACACCTTC	CASSKPSPGYTF	TRBV7-2	TRBJ1-2
TGTGCCAGTTGCCGGGACAGAAGGGCCTACGAGCAGTACTTC	CASCRDRRAYEQYF	TRBV2	TRBJ2-7
TGTGCCAGCAGCACTAAGGGGCGTGATGCGAAGAGCTCCTACGAGCAGTACTTC	CASSTKGRDAKSSYEQYF	TRBV13	TRBJ2-7
TGTGCCAGCAGCCCGGGACTATACGAGCAGTACTTC	CASSPGLYEQYF	TRBV7-2	TRBJ2-7
TGTGCCATCAGTGAGTCGCCCGGGGGGCTCTACGAGCAGTACTTC	CAISESPGGLYEQYF	TRBV10-3	TRBJ2-7
TGTGCCAGCAGCAACCGAGATACCCGTGGGAATAATGAAAAACTGTTTTTT	CASSNRDTRGNNEKLFF	TRBV9	TRBJ1-4
TGTGCCAGCAGCCGAGGACTAGCGGGGGGTCGGGAGCATGAGCAGTTCTTC	CASSRGLAGGREHEQFF	TRBV13	TRBJ2-1
TGTGCCAGCAGCTGGAGGGTCAAAGAAGGACGGGATCAGCCCCAGCATTTT	CASSWRVKEGRDQPQHF	TRBV6-3	TRBJ1-5
TGCGCCAGTCTTCTTGGACAGGGACCTCACACTGAAGCTTTCTTT	CASLLGQGPHTEAFF	TRBV4-3	TRBJ1-1
TGTGCCACCGGAACCGTGGGGACTAGCGAACTAATCGATACGCAGTATTTT	CATGTVGTSELIDTQYF	TRBV24-1	TRBJ2-3
TGTGCCAGTCAGCGGGGGGCCGTTGTTGAAAAACTGTTTTTT	CASQRGAVVEKLFF	TRBV19	TRBJ1-4
TGTGCCAGCAGCGGTGCAGGGGGCGCGGAAAAACTGTTTTTT	CASSGAGGAEKLFF	TRBV7-3	TRBJ1-4
TGTGCCAGCAGTTACGGTACGAGAACCGGGCCCGGTGCCGGGGAGCTGTTTTTT	CASSYGTRTGPGAGELFF	TRBV6-3	TRBJ2-2
TGCAGTGCGAGACGAGCTATTGCAACTAATGAAAAACTGTTTTTT	CSARRAIATNEKLFF	TRBV20-1	TRBJ1-4
TGTGCCAGCAGTGACTTATGGGGGGCGGAGGATGGCTACACCTTC	CASSDLWGAEDGYTF	TRBV6-4	TRBJ1-2
TGTGCCAGCAGTGAACCGTCACAGGGGACCGAGCAGTACTTC	CASSEPSQGTEQYF	TRBV6-1	TRBJ2-7
TGTGCCAGCCCGGGGCTGGGGGTGAACTATGGCTACACCTTC	CASPGLGVNYGYTF	TRBV28	TRBJ1-2
TGTGCCAGCAGTCACAGTTTCATGAGCTCTGGGGCCAACGTCCTGACTTTC	CASSHSFMSSGANVLTF	TRBV27	TRBJ2-6
TGTGCCAGCAGCTCTGGGCACGGCGTTGTCTATGGCTACACCTTC	CASSSGHGVVYGYTF	TRBV7-8	TRBJ1-2
TGTGCCAGCAGGGGGCTTGGGAACACCGGGGAGCTGTTTTTT	CASRGLGNTGELFF	TRBV6-2	TRBJ2-2
TGCAGTGCTAGACCCCGTCGGTGGGCTAGCACAGATACGCAGTATTTT	CSARPRRWASTDTQYF	TRBV20-1	TRBJ2-3
TGCGCCAGCAGCCTCCCGGGACAGATCGAGCAGTTCTTC	CASSLPGQIEQFF	TRBV4-1	TRBJ2-1
TGTGCCATCGGATTTAGAACTGAAGCTTTCTTT	CAIGFRTEAFF	TRBV10-3	TRBJ1-1
