TGTGCCCCTAAGGGGTCTAGCAATCAGCCCCAGCATTTT	CAPKGSSNQPQHF	TRBV24-1	TRBJ1-5
TGTGCCAGCAGCACTAGCGGGAGGGAGAGTGGCTACACCTTC	CASSTSGRESGYTF	TRBV7-8	TRBJ1-2
TGTGCCTGGAGTGTTTCTGGCGTGTGCAGGGTTCCAGTGAACACTGAAGCTTTCTTT	CAWSVSGVCRVPVNTEAFF	TRBV30	TRBJ1-1
TGTGCCAGCATCCGGGGGGGCCTCTCCTACGAGCAGTACTTC	CASIRGGLSYEQYF	TRBV6-5	TRBJ2-7
TGTGCCAGCAGTTACTCAGAACTATTAGCTTTCTTT	CASSYSELLAFF	TRBV6-5	TRBJ1-1
TGTGCCAGCCAGGTATGGCCGTACGAGCAGTACTTC	CASQVWPYEQYF	TRBV27	TRBJ2-7
TGTGCCAGCATCAGGGTAGGAGGCAATCAGCCCCAGCATTTT	CASIRVGGNQPQHF	TRBV27	TRBJ1-5
TGTGCCAGCAGCGGGGCGGGACAGGCAACAGAGACCCAGTACTTC	CASSGAGQATETQYF	TRBV7-6	TRBJ2-5
TGTGCTAGTGGTTTGGGGGCCGGGGGGGCGGGAGCAGATACGCAGTATTTT	CASGLGAGGAGADTQYF	TRBV12-5	TRBJ2-3
TGTGCCGGACAAAATCTTCTTTACGAGCAGTACTTC	CAGQNLLYEQYF	TRBV7-3	TRBJ2-7
TGTGCCAGCAGCTTTCCCTGGACAGGCTCCTCCGGCTATGGCTACACCTTC	CASSFPWTGSSGYGYTF	TRBV5-5	TRBJ1-2
TGTGCCAGCAGTTTTCCTCGGGAGAATCAGCCCCAGCATTTT	CASSFPRENQPQHF	TRBV27	TRBJ1-5
TGTGCCAGCAGTTCGGAAACCCTTAAGGGGGTCTGTTGCTACGAGCAGTACTTC	CASSSETLKGVCCYEQYF	TRBV6-6	TRBJ2-7
TGTGCCAGCAGCCAAGGGTGTACAGGACGGACTAACTATGGCTACACCTTC	CASSQGCTGRTNYGYTF	TRBV14	TRBJ1-2
TGTGCCAGCAGCTTAGCACACCTCTACGAGCAGTACTTC	CASSLAHLYEQYF	TRBV7-3	TRBJ2-7
TGTGCCTGGAGTCCCGGGCGCTGGGGTTACACCGGGGAGCTGTTTTTT	CAWSPGRWGYTGELFF	TRBV30	TRBJ2-2
TGCGCCAGCAGATGCAGGGGGCGAAACACCATATATTTT	CASRCRGRNTIYF	TRBV10-1	TRBJ1-3
TGCGCCAGCACTACCGACAGCCCGCCCTACGAGCAGTACTTC	CASTTDSPPYEQYF	TRBV10-1	TRBJ2-7
TGTGCCAGCAGCGGAAGGAGGTACGTCGAGACCCAGTACTTC	CASSGRRYVETQYF	TRBV7-9	TRBJ2-5
TGTGCCAGCAGCAGGCGCTTACGGGGACTAGGAAAAGAGACCCAGTACTTC	CASSRRLRGLGKETQYF	TRBV5-4	TRBJ2-5
TGTGCCAGCAGCTTATTATTGGCGGACTACGAGCAGTACTTC	CASSLLLADYEQYF	TRBV7-3	TRBJ2-7
TGTGCCAGCAGCCAAGGAGCACGGCCTAGCGGCAATGAGCAGTTCTTC	CASSQGARPSGNEQFF	TRBV3-1	TRBJ2-1
TGTGCCAGCAGACTGGTAATACCGACAGGGTATGGCTACACCTTC	CASRLVIPTGYGYTF	TRBV12-3	TRBJ1-2
TGTGCCAGCAGCGCGTCATTCCTAGGGAGACCCAACATTCAGTACTTC	CASSASFLGRPNIQYF	TRBV27	TRBJ2-4
TGTGCCAGCAGCAGGGACGGGATAGCTAACTATGGCTACACCTTC	CASSRDGIANYGYTF	TRBV11-3	TRBJ1-2
TGTGCCAGCAGCTTAACCCCGGGGCGCAGGAGCTACGAGCAGTACTTC	CASSLTPGRRSYEQYF	TRBV7-6	TRBJ2-7
TGTGCCATCAGTGAGTCGCCTTCAGGGGGGGCCTACGAGCAGTACTTC	CAISESPSGGAYEQYF	TRBV10-3	TRBJ2-7
TGTGCCAGCAGTTTACGGGACAGGGGTTTACCCGGGCAGCCCCAGCATTTT	CASSLRDRGLPGQPQHF	TRBV12-3	TRBJ1-5
TGTGCCAGCAGCGCCCTTGGACTAGTAGTAGCCTACAATGAGCAGTTCTTC	CASSALGLVVAYNEQFF	TRBV13	TRBJ2-1
TGTGCCAGCAGTGATTATATTTATAGCAATCAGCCCCAGCATTTT	CASSDYIYSNQPQHF	TRBV6-4	TRBJ1-5
TGCAGTGCTAGCGAAGGGACGGACTCTGGGGCCAACGTCCTGACTTTC	CSASEGTDSGANVLTF	TRBV20-1	TRBJ2-6
TGTGCCAGCAGCGGCTCAGGCGGTGAGGGTTCTTTGGGCAAGGTGCAGCCCCAGCATTTT	CASSGSGGEGSLGKVQPQHF	TRBV7-9	TRBJ1-5
TGTGCCAGCAGCTTAGCGCCGGCCGGAAGGCGGGAGACCGGGGAGCTGTTTTTT	CASSLAPAGRRETGELFF	TRBV7-8	TRBJ2-2
TGTGCCAGCAGTGACCGGGGGGGAAGGCTGAGTGCCTACGAGCAGTACTTC	CASSDRGGRLSAYEQYF	TRBV6-4	TRBJ2-7
TGTGCCAGCAGCTTGATGGGAGGGCTAAACACCGGGGAGCTGTTTTTT	CASSLMGGLNTGELFF	TRBV5-4	TRBJ2-2
TGCAGTGCTAGCGATCGGGGCCCGCGAAATAACACTGAAGCTTTCTTT	CSASDRGPRNNTEAFF	TRBV20-1	TRBJ1-1
TGTGCCAGCTCCTGTTCGGGACAGGGGGAGACCCAGTACTTC	CASSCSGQGETQYF	TRBV6-5	TRBJ2-5
TGCAGTGCCGGGGGGACAGGGGTCGTGAGGGTCACAGATACGCAGTATTTT	CSAGGTGVVRVTDTQYF	TRBV20-1	TRBJ2-3
TGTGCCAGCAGTTTGCCCCGGACAGTCAAGGACACTGAAGCTTTCTTT	CASSLPRTVKDTEAFF	TRBV27	TRBJ1-1
TGTGCCTGGAATGCGATTAACACTCCGTCCTCACGTAATGCAGACCTAGCCAAAAACATTCAGTACTTC	CAWNAINTPSSRNADLAKNIQYF	TRBV30	TRBJ2-4
TGCAGTGCTAGGACCGGGACAGGGGGCTACAATGAAAAACTGTTTTTT	CSARTGTGGYNEKLFF	TRBV20-1	TRBJ1-4
TGCGCCAGCAGCGGCCCCGGGGTTACTAACTATGGCTACACCTTC	CASSGPGVTNYGYTF	TRBV5-1	TRBJ1-2
TGCAGTGCTAGAGATCCGGACAAGTGGCTGGCCACAGATACGCAGTATTTT	CSARDPDKWLATDTQYF	TRBV20-1	TRBJ2-3
TGCGCCAGCAGCTTACTTCACAGGGGGCAGAAAGAACCACACTCTGGAAACACCATATATTTT	CASSLLHRGQKEPHSGNTIYF	TRBV5-1	TRBJ1-3
TGCAGCGGAGACAGGGGGTTAGGCTACACCTTC	CSGDRGLGYTF	TRBV29-1	TRBJ1-2
TGTGCCAGCAGCCAACGGGGTGGGGGGCCCGGGGATACGCAGTATTTT	CASSQRGGGPGDTQYF	TRBV3-1	TRBJ2-3
TGTGCCAGCAGCACCCGCAAAATAAGGGTTCTGGGGGGCTACACCTTC	CASSTRKIRVLGGYTF	TRBV13	TRBJ1-2
TGTGCCAGCAGCCAGGGGGCTTTCTTT	CASSQGAFF	TRBV13	TRBJ1-1
TGCGCCAGCAGCGGGGGAGGTAATTCCTATAATTCACCCCTCCACTTT	CASSGGGNSYNSPLHF	TRBV5-1	TRBJ1-6
TGCAGTAGGGACCCCGGGACGCTTTACAATGAGCAGTTCTTC	CSRDPGTLYNEQFF	TRBV20-1	TRBJ2-1
TGCGCCAGCAGTGAGGGCTCCCAGTTGGCCTACGAGCAGTACTTC	CASSEGSQLAYEQYF	TRBV10-1	TRBJ2-7
TGCAGCGTCCAGGGGTCTACCCTCCACTTT	CSVQGSTLHF	TRBV29-1	TRBJ1-6
TGTGCCACCAGTTTCCAGGCCAATGAGCAGTTCTTC	CATSFQANEQFF	TRBV24-1	TRBJ2-1
TGCAGCGTTGCTTCCAGAATCCCCCAACAAACCTACAATGAGCAGTTCTTC	CSVASRIPQQTYNEQFF	TRBV29-1	TRBJ2-1
TGTGCCAGCAGTTGGGGTACCGAGGGCACAGATACGCAGTATTTT	CASSWGTEGTDTQYF	TRBV7-6	TRBJ2-3
TGTGCCTTGAGGGGCGGGGCCTTTGGCTACACCTTC	CALRGGAFGYTF	TRBV6-1	TRBJ1-2
TGTGCCAGCAGCAGGGGGGCATCTAACTATGGCTACACCTTC	CASSRGASNYGYTF	TRBV7-3	TRBJ1-2
TGTGCCAGCAGTTTCGTGAGACAGGTGGTCGGAAACACCATATATTTT	CASSFVRQVVGNTIYF	TRBV27	TRBJ1-3
TGCGCCATAATAGACAGGGCCGGCAATCAGCCCCAGCATTTT	CAIIDRAGNQPQHF	TRBV5-1	TRBJ1-5
TGCAGTGCTAGGGAAGGCGGGCCAGAGACCCAGTACTTC	CSAREGGPETQYF	TRBV20-1	TRBJ2-5
TGTGCCAGCAGTGGGTTCCCCGGGACAGGCACAGATACGCAGTATTTT	CASSGFPGTGTDTQYF	TRBV6-5	TRBJ2-3
TGTGCCAGCAGCGTAATAGGGAGCAAGGGGTATGGCTACACCTTC	CASSVIGSKGYGYTF	TRBV7-7	TRBJ1-2
TGTGCCAGCAGCGTGGACGGCCACCGGGACAGGGGGGCAGATACGCAGTATTTT	CASSVDGHRDRGADTQYF	TRBV9	TRBJ2-3
TGTGCCAGCAGCTCCACCGGACTAGCGGGGCTCTACGAGCAGTACTTC	CASSSTGLAGLYEQYF	TRBV5-6	TRBJ2-7
TGTGCCGGGGTTCCTAGAGACTATAATCAGCCCCAGCATTTT	CAGVPRDYNQPQHF	TRBV6-4	TRBJ1-5
TGCAGTGCTAGCGAAGTTTCGCAGAGCCTAGCCAAAAACATTCAGTACTTC	CSASEVSQSLAKNIQYF	TRBV20-1	TRBJ2-4
TGTGCCAGCAGTTTGCACAGGGGGGTCACTGAAGCTTTCTTT	CASSLHRGVTEAFF	TRBV6-5	TRBJ1-1
TGTGCCAGCAGCTTCCAGCGGGAGGGCCCGAGTTATGAGCAGTTCTTC	CASSFQREGPSYEQFF	TRBV7-6	TRBJ2-1
TGTGCCAGCAGCAGGGACAGGGGAGGGTCAGATACGCAGTATTTT	CASSRDRGGSDTQYF	TRBV5-6	TRBJ2-3
TGCAGCGTAGGCGACTTTACCTCTGGAAACACCATATATTTT	CSVGDFTSGNTIYF	TRBV29-1	TRBJ1-3
TGTGCCACCAGTGAAGGGACAGGCTCTGGGGCCAACGTCCTGACTTTC	CATSEGTGSGANVLTF	TRBV24-1	TRBJ2-6
TGTGCCAGCAGTGCCCGTGGACCGAATCATAACTATGGCTACACCTTC	CASSARGPNHNYGYTF	TRBV27	TRBJ1-2
TGTGCCAGTAGTGCAGCCGAAGAGACCCAGTACTTC	CASSAAEETQYF	TRBV19	TRBJ2-5
TGTGCCAGCAGTTCGGGCGTTCCTAACTATGGCTACACCTTC	CASSSGVPNYGYTF	TRBV6-1	TRBJ1-2
TGCAGTGCTTCAGGGGGCTTGGATGGCGCCGAGACCCAGTACTTC	CSASGGLDGAETQYF	TRBV20-1	TRBJ2-5
TGTGCCAGCACCGCCCCCTGGGGCTTGTCCCAAGATACGCAGTATTTT	CASTAPWGLSQDTQYF	TRBV28	TRBJ2-3
TGTGCCATCAGTGCGGACTCTTCTGAAGGAAGCAGGGAGACCCAGTACTTC	CAISADSSEGSRETQYF	TRBV10-3	TRBJ2-5
TGTGCCAGCAGCCCACCCATTGAGGGGATGACTGAAGCTTTCTTT	CASSPPIEGMTEAFF	TRBV4-2	TRBJ1-1
TGTGCCAGCAGCTGCGACATTTACTATGGCTACACCTTC	CASSCDIYYGYTF	TRBV5-6	TRBJ1-2
TGTGCCAGCAGACCCAGGGGATTACATACCAACTACTCCTACAATGAGCAGTTCTTC	CASRPRGLHTNYSYNEQFF	TRBV25-1	TRBJ2-1
TGTGCCTGGTCCAGGTGCCCGGGGGAGCCCCAGCATTTT	CAWSRCPGEPQHF	TRBV30	TRBJ1-5
TGTGCCAGCAGGGGGGCCCTCTCTTACACCGGGGAGCTGTTTTTT	CASRGALSYTGELFF	TRBV6-4	TRBJ2-2
TGTGCCAGCAGTTGTAGGGGTGAGCAGTTCTTC	CASSCRGEQFF	TRBV28	TRBJ2-1
TGTGCCAGCAGCCAAGTAGGGGAACAAGATACGCAGTATTTT	CASSQVGEQDTQYF	TRBV3-1	TRBJ2-3
TGTGCCAGCAGCGAGTGGGGACCGGTCTCTGGGGCCAACGTCCTGACTTTC	CASSEWGPVSGANVLTF	TRBV9	TRBJ2-6
TGTGCCAGCAGCACACCGGGACAGGATTTAGCTAACTATGGCTACACCTTC	CASSTPGQDLANYGYTF	TRBV11-2	TRBJ1-2
TGTGCCAGCAGGTGCGGACAGTTCAGCTCCTACGAGCAGTACTTC	CASRCGQFSSYEQYF	TRBV6-5	TRBJ2-7
TGCATCGTGGCAATAACCGGGGAGCTGTTTTTT	CIVAITGELFF	TRBV20-1	TRBJ2-2
TGCAGCGTTGGGGGCAAGGGTTCCTACGAGCAGTACTTC	CSVGGKGSYEQYF	TRBV29-1	TRBJ2-7
TGTGCCAGCAGCTTACAGGGGGAGGGCACAGATACGCAGTATTTT	CASSLQGEGTDTQYF	TRBV7-9	TRBJ2-3
TGTGCCACCAGGCGACAGGGGCTCGGCGGGGAGCTGTTTTTT	CATRRQGLGGELFF	TRBV24-1	TRBJ2-2
TGTGCCAGCAGTGCTGCCGGGACTAGCGCGGGAGGTGACTACGAGCAGTACTTC	CASSAAGTSAGGDYEQYF	TRBV6-1	TRBJ2-7
TGTGCCAGCACTCCTAATCAGGACAGGGTCCCCGCAAAGCAGTTCTTC	CASTPNQDRVPAKQFF	TRBV7-2	TRBJ2-1
TGCGCCAGCAGCCAAGGCTTCCACAGGGGGTTCAAGACCACCGGGGAGCTGTTTTTT	CASSQGFHRGFKTTGELFF	TRBV4-1	TRBJ2-2
TGCGCCAGCAGCCGAGGACTAGCGGGGGGGCAGGCCTACGAGCAGTACTTC	CASSRGLAGGQAYEQYF	TRBV4-3	TRBJ2-7
TGTGCAAAGTTTGGGACATACCACGAGCAGTACTTC	CAKFGTYHEQYF	TRBV11-3	TRBJ2-7
TGTGCCAGCAGCTTAAAGGGGACTGAAGCTTTCTTT	CASSLKGTEAFF	TRBV11-2	TRBJ1-1
TGCAGTGCATTGGACAGGGTAAGGGGCAATCAGCCCCAGCATTTT	CSALDRVRGNQPQHF	TRBV20-1	TRBJ1-5
TGTGCCAGCAGCTGGGACAGGGGTTACTCATCCCTGGATCACTCCTACGAGCAGTACTTC	CASSWDRGYSSLDHSYEQYF	TRBV27	TRBJ2-7
TGCAGTGCTAGGAGTGGTCTAGGGACCGCGACGGGCGAGCAGTACTTC	CSARSGLGTATGEQYF	TRBV20-1	TRBJ2-7
