TGTGCCAGCAGCGTAAAGACCGAGGCCACGGGTTTTGGCTACGAGCAGTACTTC	CASSVKTEATGFGYEQYF	TRBV9	TRBJ2-7
TGTGCCAATTCGGCCTACAATGAGCAGTTCTTC	CANSAYNEQFF	TRBV11-2	TRBJ2-1
TGCGCCAGCCAAGCGACAGGGGGAGGCAGCAATCAGCCCCAGCATTTT	CASQATGGGSNQPQHF	TRBV10-1	TRBJ1-5
TGTGCCAGCAGTGAAGCGCGGACAGGGAGGGCTCGGGAGCTGTTTTTT	CASSEARTGRARELFF	TRBV6-4	TRBJ2-2
TGTGCCAGCAGCTTGACAGGGGTCCTATCGGATCAGCCCCAGCATTTT	CASSLTGVLSDQPQHF	TRBV5-6	TRBJ1-5
TGTGCCAGCAGCTCGGGGGGGACCCAGTACTTC	CASSSGGTQYF	TRBV7-2	TRBJ2-5
TGTGCCAGCAGCCGGGACACCACTGAAGCTTTCTTT	CASSRDTTEAFF	TRBV28	TRBJ1-1
TGTGCCACCAGCTTGTTAAGCGGGAGACTGGCCTACAATGAGCAGTTCTTC	CATSLLSGRLAYNEQFF	TRBV15	TRBJ2-1
TGTGCCAGCAGCCCTACCGTGGACGGTACCGGGGAGCTGTTTTTT	CASSPTVDGTGELFF	TRBV9	TRBJ2-2
TGTGCCAGCAGCCATTCAGGTAGTCTGGGCGGGGAGCTGTTTTTT	CASSHSGSLGGELFF	TRBV4-2	TRBJ2-2
TGTGCCAGCAGTTCCGGCCGGGGAGATGAGCAGTTCTTC	CASSSGRGDEQFF	TRBV12-3	TRBJ2-1
TGTGCCAGCAGTTTCCGCGGGGTAGGTTGTTACTTC	CASSFRGVGCYF	TRBV27	TRBJ2-4
TGCGCCAGCAGCTTGGTCTTCAGGGAACATTCACCCCTCCACTTT	CASSLVFREHSPLHF	TRBV5-1	TRBJ1-6
TGTGCCACCAGTGATTTGCATCCCCGGGACAGGGAGGTCTACGAGCAGTACTTC	CATSDLHPRDREVYEQYF	TRBV24-1	TRBJ2-7
TGTGCCAGCAGTTCTTGTAGGATATGGGTTGGCAATCAGCCCCAGCATTTT	CASSSCRIWVGNQPQHF	TRBV6-9	TRBJ1-5
TGCAGTGCTAGAGATCCGGGACTAGCGGAAGAGACCCAGTACTTC	CSARDPGLAEETQYF	TRBV20-1	TRBJ2-5
TGTGCCAGCAGTTACTCGATCGTAGGACGCCCGGCAGATACGCAGTATTTT	CASSYSIVGRPADTQYF	TRBV6-5	TRBJ2-3
TGTGCCAGCAGCCACAGGGACGAGCAGTACTTC	CASSHRDEQYF	TRBV11-2	TRBJ2-7
TGTGCCTGGCAAGGGGGGGCACCCCTCCACTTT	CAWQGGAPLHF	TRBV30	TRBJ1-6
TGCAGCGTTGAAGTTGTGATAGACAGGGGCAGGGAAAAACTGTTTTTT	CSVEVVIDRGREKLFF	TRBV29-1	TRBJ1-4
TGTGCCAGCAGTGAATACCGGGACAGGGGAGATACGCAGTATTTT	CASSEYRDRGDTQYF	TRBV25-1	TRBJ2-3
TGTGCCAGCAGTGGGGCAGACCTGGTTACCTACGAGCAGTACTTC	CASSGADLVTYEQYF	TRBV25-1	TRBJ2-7
TGTGCCAGCAGCGACTCAACCAAGAATCAGCCCCAGCATTTT	CASSDSTKNQPQHF	TRBV7-3	TRBJ1-5
TGTGCCAGCAGCCAGGACAAGGACAGGATTCTTTACTCTGGAAACACCATATATTTT	CASSQDKDRILYSGNTIYF	TRBV3-1	TRBJ1-3
TGCGCCAGCCCTAGCCACAACAATCAGCCCCAGCATTTT	CASPSHNNQPQHF	TRBV10-1	TRBJ1-5
TGTGCCAGCAGCAAGCCCAAAGGAGAGGATACGCAGTATTTT	CASSKPKGEDTQYF	TRBV7-8	TRBJ2-3
TGTGCCGGGAGGGGCCCCTACGAGCAGTACTTC	CAGRGPYEQYF	TRBV30	TRBJ2-7
TGTGCCAGCAGTTATTCGGGGAGACTAGCGGGCAAATCCTACAATGAGCAGTTCTTC	CASSYSGRLAGKSYNEQFF	TRBV12-3	TRBJ2-1
TGTGCCACCGAAGACGGGGTGATGTACTCCTATAATTCACCCCTCCACTTT	CATEDGVMYSYNSPLHF	TRBV19	TRBJ1-6
TGCAGTGCTAGAGAGCAGGGGAAAAAGGACACTGAAGCTTTCTTT	CSAREQGKKDTEAFF	TRBV20-1	TRBJ1-1
TGTGCCAGCAGCGGGGAGGACACTGAAGCTTTCTTT	CASSGEDTEAFF	TRBV7-9	TRBJ1-1
TGCGCCAGCAGCCAAGATTCTAGGGCTAGCGGGGCCCGCTACGAGCAGTACTTC	CASSQDSRASGARYEQYF	TRBV4-1	TRBJ2-7
TGTGCCAGCAGTGACTGGGCTGCATATGACAATCAGCCCCAGCATTTT	CASSDWAAYDNQPQHF	TRBV6-4	TRBJ1-5
TGTGCCAGCAGCTTTTACAGGGGCTGCAATCAGCCCCAGCATTTT	CASSFYRGCNQPQHF	TRBV6-3	TRBJ1-5
TGTGCCAGCAGTGAAATGGACAGAGTAGACAATCAGCCCCAGCATTTT	CASSEMDRVDNQPQHF	TRBV2	TRBJ1-5
TGTGCCAGCCGCCGACCGCGAGGGATGAACACTGAAGCTTTCTTT	CASRRPRGMNTEAFF	TRBV25-1	TRBJ1-1
TGTGCCAGCCCAGGGATTAGAAACGGTAGCAATCAGCCCCAGCATTTT	CASPGIRNGSNQPQHF	TRBV27	TRBJ1-5
TGTGCCAGCACCCCGGGTGGGCAGTACTTC	CASTPGGQYF	TRBV27	TRBJ2-7
TGTGCCAGCAGCCTGGAGGGGGACGAGCAGTACTTC	CASSLEGDEQYF	TRBV3-1	TRBJ2-7
TGTGCCAGCAGTGAATTTGACTTAGAAGAGCTCAATGAGCAGTTCTTC	CASSEFDLEELNEQFF	TRBV6-1	TRBJ2-1
TGTGCCCGGGGTAGGTATGGCTACACCTTC	CARGRYGYTF	TRBV11-2	TRBJ1-2
TGTGCCAGCAGCTTCCCCCAGGGGGGTCGCCTAGAGACCCAGTACTTC	CASSFPQGGRLETQYF	TRBV11-2	TRBJ2-5
TGTGCCAGCAGCCAACAAAAGGGAGATGGGATAAACTATGGCTACACCTTC	CASSQQKGDGINYGYTF	TRBV3-1	TRBJ1-2
TGTGCCAGCTTTCCGGGACGCTCCTACAATGAGCAGTTCTTC	CASFPGRSYNEQFF	TRBV12-4	TRBJ2-1
TGTGCCAGCAGAATGACTAGCGGGAGGGGCAAAAACATTCAGTACTTC	CASRMTSGRGKNIQYF	TRBV28	TRBJ2-4
TGCAGCGGCCGGAGGGGACAGTACAATGAGCAGTTCTTC	CSGRRGQYNEQFF	TRBV29-1	TRBJ2-1
TGTGCTAGTGGTTCCTATTCCCCCAGCCCTATTAGTTATGGCTACACCTTC	CASGSYSPSPISYGYTF	TRBV12-5	TRBJ1-2
TGTGCCAGCAGCTTCAGTCCAGGGAGGGACGGCTCCTACAATGAGCAGTTCTTC	CASSFSPGRDGSYNEQFF	TRBV6-4	TRBJ2-1
TGTGCCAGCAGCAAATCCAGCGGGATTGGACTTCGGGGCTACACCTTC	CASSKSSGIGLRGYTF	TRBV4-2	TRBJ1-2
TGTGCCAGCAGCTCCGGTAAACTGGCCATAGCGGGGGGGGATGATGAGCAGTTCTTC	CASSSGKLAIAGGDDEQFF	TRBV7-3	TRBJ2-1
TGTGCCAGCAGTTACATAGGATGGCTCGGACAGGGCCTATCAAGCAATCAGCCCCAGCATTTT	CASSYIGWLGQGLSSNQPQHF	TRBV6-5	TRBJ1-5
TGTGCCAGCAGTCCGGGACAGGGGAGCGGTTCCTATGGCTACACCTTC	CASSPGQGSGSYGYTF	TRBV28	TRBJ1-2
TGTGCCAGCAGCCAAGATGTGGTACCCATTTCGGGCTACACCTTC	CASSQDVVPISGYTF	TRBV14	TRBJ1-2
TGTGCCAGCAGCAGGGCCCCAGGGAACACTGAAGCTTTCTTT	CASSRAPGNTEAFF	TRBV6-5	TRBJ1-1
TGTGCCAGCAGCTCCCGGACAGTTTGTTCCTACGAGCAGTACTTC	CASSSRTVCSYEQYF	TRBV11-3	TRBJ2-7
TGCGCCAGCAGCCAAGGTAATCCCCGGGGGAAGAAGGGCTACACCTTC	CASSQGNPRGKKGYTF	TRBV4-1	TRBJ1-2
TGTGCCAGCAGCCAAGTTGGGGGCCTAGAGACCCAGTACTTC	CASSQVGGLETQYF	TRBV4-2	TRBJ2-5
TGTGCCACCCCAGGGTATCGTAACTATGGCTACACCTTC	CATPGYRNYGYTF	TRBV24-1	TRBJ1-2
TGCAGTGTCTATGTCAGAGGCACAGATACGCAGTATTTT	CSVYVRGTDTQYF	TRBV20-1	TRBJ2-3
TGTGCCAGCAGCTTATCCCAGAATCAGCATCAGCCCCAGCATTTT	CASSLSQNQHQPQHF	TRBV7-6	TRBJ1-5
TGTGCCAGCAGCAGCACGGGACCAGACTCCTACGAGCAGTACTTC	CASSSTGPDSYEQYF	TRBV13	TRBJ2-7
TGTGCCAAGGACGAGAGCTATGGCTACACCTTC	CAKDESYGYTF	TRBV28	TRBJ1-2
TGCAGTGCTCTCCGAGCCGGGCGGAAAGGGTACGAGCAGTACTTC	CSALRAGRKGYEQYF	TRBV20-1	TRBJ2-7
TGTGCCAGCCTAGCAGGGAGGGGCTCCTACGAGCAGTACTTC	CASLAGRGSYEQYF	TRBV2	TRBJ2-7
TGTGCCAGCAGCGTAGTTTCGGGACAAGACATGAACACTGAAGCTTTCTTT	CASSVVSGQDMNTEAFF	TRBV9	TRBJ1-1
TGTGCCAGCATCAGCGGGTCAGATACGCAGTATTTT	CASISGSDTQYF	TRBV6-4	TRBJ2-3
TGTGCCACACAGGAGGGGGGAAACACCATATATTTT	CATQEGGNTIYF	TRBV24-1	TRBJ1-3
TGTGCCATTTCAGGACAGGGGGCAGGGGACACTGAAGCTTTCTTT	CAISGQGAGDTEAFF	TRBV10-3	TRBJ1-1
TGTGCCAGCAGCTTAGGCGTCGGGACAATCGTAGCTAGCACAGATACGCAGTATTTT	CASSLGVGTIVASTDTQYF	TRBV11-2	TRBJ2-3
TGCGCCAGCATACGGTTAATGGGCACTGAAGCTTTCTTT	CASIRLMGTEAFF	TRBV10-1	TRBJ1-1
TGCGCCACGCCTACGTGGAGCGAGGGCTACACCTTC	CATPTWSEGYTF	TRBV5-1	TRBJ1-2
TGTGCCAGCAGCACTAGGGCCGGCTTTAATTCACCCCTCCACTTT	CASSTRAGFNSPLHF	TRBV13	TRBJ1-6
TGTGAGACGAGGGGCACAGATACGCAGTATTTT	CETRGTDTQYF	TRBV3-1	TRBJ2-3
TGTGCCGGGGGGGCTAACTATGGCTACACCTTC	CAGGANYGYTF	TRBV5-4	TRBJ1-2
TGTGCCAGCAGCTTAGGTCAGGGAGGGCAGTTCTTC	CASSLGQGGQFF	TRBV7-9	TRBJ2-1
TGTGCCACCAGCAGAAGGGAAAGCCGGGACAGGGGGCCACTCACCGGGGAGCTGTTTTTT	CATSRRESRDRGPLTGELFF	TRBV15	TRBJ2-2
TGTGCCAGCAGTCGGTCGGAGCCGGGCGGCCAGGACTCTGGAAACACCATATATTTT	CASSRSEPGGQDSGNTIYF	TRBV12-4	TRBJ1-3
TGTGCCAGCGGGACATCCCAGCATTTT	CASGTSQHF	TRBV6-1	TRBJ1-5
TGTGCCAGCAGCTTTAGGACTAGATGTGAAGGGAGAGACAATGAGCAGTTCTTC	CASSFRTRCEGRDNEQFF	TRBV7-8	TRBJ2-1
TGTGCCAGCATGGGCCCTTGGTTCCGATTCGAGCAAGAGACCCAGTACTTC	CASMGPWFRFEQETQYF	TRBV6-1	TRBJ2-5
TGTGCCTGGCCCTCTACTAGCGGGAAGGGCTACAATGAGCAGTTCTTC	CAWPSTSGKGYNEQFF	TRBV30	TRBJ2-1
TGTGCCAGTAGTTGCGGGGCCTACGAGCAGTACTTC	CASSCGAYEQYF	TRBV19	TRBJ2-7
TGTGCCAGCAGTGAAACCCATCCCCCGGGAGCGCTACATCAGCCCCAGCATTTT	CASSETHPPGALHQPQHF	TRBV2	TRBJ1-5
TGCAGCGAGGTCGACAGGGTTACCGGCTACACCTTC	CSEVDRVTGYTF	TRBV29-1	TRBJ1-2
TGTGCCAGCAGTTACACGAGGGGGGAGACCCAGTACTTC	CASSYTRGETQYF	TRBV6-5	TRBJ2-5
TGTGCCAGCAGCGTAGGACGGCTAGCGGGCCAGTACTTC	CASSVGRLAGQYF	TRBV9	TRBJ2-5
TGTGCCAGCAGTTGGCGTGGGAGCAACATTCAGTACTTC	CASSWRGSNIQYF	TRBV27	TRBJ2-4
TGTGCCAGCAGTGGTCCCCGGGATCAATACTATGGCTACACCTTC	CASSGPRDQYYGYTF	TRBV25-1	TRBJ1-2
TGTGCCAGCAGTGACCGAAAATATTACACTGAAGCTTTCTTT	CASSDRKYYTEAFF	TRBV6-4	TRBJ1-1
TGTGCCAGCGTAAGGGGGGGGGCAATTGGGAGCTCCTACGAGCAGTACTTC	CASVRGGAIGSSYEQYF	TRBV7-9	TRBJ2-7
TGTGCCAGCAGCAGTCTAAGCACAGATACGCAGTATTTT	CASSSLSTDTQYF	TRBV13	TRBJ2-3
TGTGCCACCAGCCACCGGACAGGCTCTGAGACCCAGTACTTC	CATSHRTGSETQYF	TRBV15	TRBJ2-5
TGCGCCAGCAGTCAGACGGGACAGGGGTGGAGAAAACTTTATGGCTACACCTTC	CASSQTGQGWRKLYGYTF	TRBV10-1	TRBJ1-2
TGCGCCAGCAGCTCAGGGGACAGGGGTTTCTACGAGCAGTACTTC	CASSSGDRGFYEQYF	TRBV5-1	TRBJ2-7
TGTGCCAGCACGGGGGGGCCGGGGGATGAGCAGTTCTTC	CASTGGPGDEQFF	TRBV6-4	TRBJ2-1
TGTGCCAGGACGGGAGACAATGAGCAGTTCTTC	CARTGDNEQFF	TRBV6-1	TRBJ2-1
TGCAGTGCTAGAGCATCTAGGGCGAGAAACACTGAAGCTTTCTTT	CSARASRARNTEAFF	TRBV20-1	TRBJ1-1
TGTGCCAGCAGCTTACGTCAGGGCGGGGATATGAACACTGAAGCTTTCTTT	CASSLRQGGDMNTEAFF	TRBV7-2	TRBJ1-1
TGCGCCAGCAAGGGGCTAGCGGGAGCCTACGAGCAGTACTTC	CASKGLAGAYEQYF	TRBV10-1	TRBJ2-7
TGTGCCCAAACAACTAGGGCTTTCTTT	CAQTTRAFF	TRBV24-1	TRBJ1-1
