TGCAGTGCTAGAGATTGCACCCTAGCGGGGTGCACAGATACGCAGTATTTT	CSARDCTLAGCTDTQYF	TRBV20-1	TRBJ2-3
TGCAGTGCGTCGGGGAGCGAGCAGTACTTC	CSASGSEQYF	TRBV20-1	TRBJ2-7
TGTGCCAGCAGCCAATGCTCAACAAGGACAGTCGGTTCTGGAAACACCATATATTTT	CASSQCSTRTVGSGNTIYF	TRBV14	TRBJ1-3
TGCAGTGCTAGCCTGGGAGATAGCAATCAGCCCCAGCATTTT	CSASLGDSNQPQHF	TRBV20-1	TRBJ1-5
TGTGCCAGCAGCTCCCCCCCAAGACAGCCCACGAACACTGAAGCTTTCTTT	CASSSPPRQPTNTEAFF	TRBV7-3	TRBJ1-1
TGCGCCAGCAGCTTGCCCCCGCCGGGACAGGGGGGCGGGGAGCTGTTTTTT	CASSLPPPGQGGGELFF	TRBV5-1	TRBJ2-2
TGTGCCAGCAGCCGCGGGAGTGGGGCCTACGAGCAGTACTTC	CASSRGSGAYEQYF	TRBV13	TRBJ2-7
TGTGCCAGCACGCAGGACAGGAGGGGTTGGCGATTAGTCCGGGAGGATGGCTACACCTTC	CASTQDRRGWRLVREDGYTF	TRBV6-1	TRBJ1-2
TGTGCCACCAGTGCAAAGACAGGGTCAGACTGGGAGCAGTTCTTC	CATSAKTGSDWEQFF	TRBV24-1	TRBJ2-1
TGCAGTGCTATGGGCACAGGGGCGGTGGGGGGATTCAGGTCTGGAAACACCATATATTTT	CSAMGTGAVGGFRSGNTIYF	TRBV20-1	TRBJ1-3
TGCAGTGCCATCCGGCCCGGGGAGCTGTTTTTT	CSAIRPGELFF	TRBV20-1	TRBJ2-2
TGTGCCAGCAGCTTCCCCTCCCGGGACAGGGTTGGGGGGGCGGAGCAGTACTTC	CASSFPSRDRVGGAEQYF	TRBV5-4	TRBJ2-7
TGTGCCAGGTGGGTAAGCCGACGCGGCTTACGGTACGAGCAGTACTTC	CARWVSRRGLRYEQYF	TRBV19	TRBJ2-7
TGTGCCAGCAGCTTCCTCAGGGAGCAGTACTTC	CASSFLREQYF	TRBV11-2	TRBJ2-7
TGCAGTGCTAGCCTTCGGGACGGCAATGAGCAGTTCTTC	CSASLRDGNEQFF	TRBV20-1	TRBJ2-1
TGTGCCAGCAGTGACCGCGGTGACGAGCAGTACTTC	CASSDRGDEQYF	TRBV27	TRBJ2-7
TGTGCCAGCAGACAGGGAAGGGGCTACACCTTC	CASRQGRGYTF	TRBV7-7	TRBJ1-2
TGTGCCAGCAGGGGCCGGACTAGCCGGAACATTCAGTACTTC	CASRGRTSRNIQYF	TRBV11-3	TRBJ2-4
TGTGCCAGCACGAGGCTAGATACGCAGTATTTT	CASTRLDTQYF	TRBV6-4	TRBJ2-3
TGTGCCAGCAGCTACCGTGACAGGGATCAGCCCCAGCATTTT	CASSYRDRDQPQHF	TRBV13	TRBJ1-5
TGTGCCAGCTCACCACTCGGGACTAGCGGCAGCACCTCCTACAATGAGCAGTTCTTC	CASSPLGTSGSTSYNEQFF	TRBV18	TRBJ2-1
TGTGCCAGCAGTAATAGCCCAGGGGATCACGAGCAGTACTTC	CASSNSPGDHEQYF	TRBV28	TRBJ2-7
TGTGCCAGCAGCTTAGTTGGTTACGAGCAGTACTTC	CASSLVGYEQYF	TRBV7-3	TRBJ2-7
TGTGCCAGCAGCTTAGGGAAGGGGTTTTACGAGCAGTACTTC	CASSLGKGFYEQYF	TRBV7-9	TRBJ2-7
TGTGCCAGCAGTGGCGCCTGCGCAGGGTTATACAATCAGCCCCAGCATTTT	CASSGACAGLYNQPQHF	TRBV27	TRBJ1-5
TGTGCTCTGGAACAGTTTCCCTCTGGAAACACCATATATTTT	CALEQFPSGNTIYF	TRBV30	TRBJ1-3
TGCGCCAGCAGCCTTCCAGGGGGCGGGGGGGGACCCTACGAGCAGTACTTC	CASSLPGGGGGPYEQYF	TRBV4-1	TRBJ2-7
TGTGCCAGCAGTTTAAGTCCGTGTGTACGCTACAATGAGCAGTTCTTC	CASSLSPCVRYNEQFF	TRBV27	TRBJ2-1
TGTGCCAATCTACTCCTGAACACTGAAGCTTTCTTT	CANLLLNTEAFF	TRBV28	TRBJ1-1
TGTGCCAGCAGAAGTCCCGGGACCGGGGGGGGCAATCAGCCCCAGCATTTT	CASRSPGTGGGNQPQHF	TRBV25-1	TRBJ1-5
TGCAGTGCCCCGCGACAGGGCTATCTCCACTCTGGAAACACCATATATTTT	CSAPRQGYLHSGNTIYF	TRBV20-1	TRBJ1-3
TGCGCCAGCAGCTTCTCGCATAACACGAGCACAGATACGCAGTATTTT	CASSFSHNTSTDTQYF	TRBV5-1	TRBJ2-3
TGCAGTGTCCCCACGTTGGGGTACTACAATGAGCAGTTCTTC	CSVPTLGYYNEQFF	TRBV20-1	TRBJ2-1
TGTGCCAGCAGCTTGAAAACGGGCCGGTACGAGCAGTACTTC	CASSLKTGRYEQYF	TRBV5-5	TRBJ2-7
TGTGCCAGTAGGAAACGGGGTTCGGAGGCCAAAGATACGCAGTATTTT	CASRKRGSEAKDTQYF	TRBV19	TRBJ2-3
TGTGCCAGCAGTGAACCTGGGGGGGAAGAGACCCAGTACTTC	CASSEPGGEETQYF	TRBV25-1	TRBJ2-5
TGCGCCAGCAGCTTGCCGAGACAATCCCCCAACAGGGGGAACTATGGCTACACCTTC	CASSLPRQSPNRGNYGYTF	TRBV5-1	TRBJ1-2
TGTGCCAGCAGCTTAACACCTCCGGACTACGGGTATGAGCAGTTCTTC	CASSLTPPDYGYEQFF	TRBV7-9	TRBJ2-1
TGTGCCAGCAGCTTAACTGATATTTCAGCGGGAGCTCAGTACTTC	CASSLTDISAGAQYF	TRBV7-3	TRBJ2-7
TGTGCCAGCAGTTACTCGGGGGTTGAGCCGTCAGCCAAAAACATTCAGTACTTC	CASSYSGVEPSAKNIQYF	TRBV6-5	TRBJ2-4
TGTGCCAGCAGTTACTTAAGCGGAAGTATGAACACTGAAGCTTTCTTT	CASSYLSGSMNTEAFF	TRBV6-5	TRBJ1-1
TGTGCCAGCAGCGGGGGTAAGGTCTATGGCTACACCTTC	CASSGGKVYGYTF	TRBV9	TRBJ1-2
TGTGCCAGCAGTGAGGGGAAGGGGCGGACAGATACGCAGTATTTT	CASSEGKGRTDTQYF	TRBV25-1	TRBJ2-3
TGTGCCAGCAGCCAAGAGATCAATGGACAGGGCGGGTGGGTTAATGAAAAACTGTTTTTT	CASSQEINGQGGWVNEKLFF	TRBV4-2	TRBJ1-4
TGTGCCAGCCCGGCCGGGACTAGATTAGAGACCCAGTACTTC	CASPAGTRLETQYF	TRBV27	TRBJ2-5
TGTGCCAGCAGCTACCATTGGGACCCCTATGGCTACACCTTC	CASSYHWDPYGYTF	TRBV13	TRBJ1-2
TGCAGTGCTAGGGGTCGCAATCAGCCCCAGCATTTT	CSARGRNQPQHF	TRBV20-1	TRBJ1-5
TGTGCCAGCACCTTTGGGGCACATTCACCCCTCCACTTT	CASTFGAHSPLHF	TRBV2	TRBJ1-6
TGCGCCAGCAGTTCCGGGACAGGGGGTGAAGCTTTCTTT	CASSSGTGGEAFF	TRBV10-1	TRBJ1-1
TGCGCCAGCAGCTTCCCCCCCGCTAGAGAGTCCTACGAGCAGTACTTC	CASSFPPARESYEQYF	TRBV5-1	TRBJ2-7
TGTGCCAGCAGCCTTTTATGGTGGACAGGGGAGGGGGAGCTGTTTTTT	CASSLLWWTGEGELFF	TRBV7-3	TRBJ2-2
TGTGCCAGCAGTGACTTCGCCCGGGACAGTTTGTGCACGAACACTGAAGCTTTCTTT	CASSDFARDSLCTNTEAFF	TRBV6-4	TRBJ1-1
TGTGCCAGTAATCGGGGGACAGGTAGGACCTACGAGCAGTACTTC	CASNRGTGRTYEQYF	TRBV19	TRBJ2-7
TGTGCCAGTAGTCCGCGGGCAGGGGCTGAAGCTTTCTTT	CASSPRAGAEAFF	TRBV19	TRBJ1-1
TGTGCCACCAGTGATTTCCCGCCAGGGGAAAATTACAATGAGCAGTTCTTC	CATSDFPPGENYNEQFF	TRBV24-1	TRBJ2-1
TGCAGCGTTGCATGTTGTCGCGGAGGATGTCTCTCACCCCTCCACTTT	CSVACCRGGCLSPLHF	TRBV29-1	TRBJ1-6
TGTGCCAGCAAGGGGGCAACCAATGAAAAACTGTTTTTT	CASKGATNEKLFF	TRBV6-1	TRBJ1-4
TGTGCCAGCAACCAGCTCTTCAATCAGCCCCAGCATTTT	CASNQLFNQPQHF	TRBV27	TRBJ1-5
TGTGCCAGCAGCTTAGGAGTGTCCCGGGACAGCACCGAGCAGTACTTC	CASSLGVSRDSTEQYF	TRBV11-3	TRBJ2-7
TGTGCCATCAGTGCACCCGGGGTCCTTGAGCAGTACTTC	CAISAPGVLEQYF	TRBV10-3	TRBJ2-7
TGTGCCAGCAGTTACGGGGCAGGGACAAACATTCAGTACTTC	CASSYGAGTNIQYF	TRBV6-2	TRBJ2-4
TGTGCCAGCAGCTTGGGGGGCGCCTACGAGCAGTACTTC	CASSLGGAYEQYF	TRBV7-4	TRBJ2-7
TGTGCCTGGAGTGTGAGGGGGGAGAGCCAAGAGACCCAGTACTTC	CAWSVRGESQETQYF	TRBV30	TRBJ2-5
TGTGCCAGCAGCTTACGAGCCCCCGGAACTACGCAGTATTTT	CASSLRAPGTTQYF	TRBV11-1	TRBJ2-3
TGTGCCAGCAGCTTCCGGGGGAGGGAGGCCGCCTACAATGAGCAGTTCTTC	CASSFRGREAAYNEQFF	TRBV5-4	TRBJ2-1
TGTGCCAGCAGGGACAGGGATGGCTACACCTTC	CASRDRDGYTF	TRBV2	TRBJ1-2
TGCAGTGCCGCTAAACTAGCGGGGCTTGGAAATGAGCAGTTCTTC	CSAAKLAGLGNEQFF	TRBV20-1	TRBJ2-1
TGTGCCAGCTCCCTAAGGGGGCCCTTAGAAGCTTTCTTT	CASSLRGPLEAFF	TRBV6-5	TRBJ1-1
TGTGCCAGCAGCAACGGGGGCACAGATACGCAGTATTTT	CASSNGGTDTQYF	TRBV9	TRBJ2-3
TGTGCCAGCAGTTTCCACCCGGGACACGGGCGGAGAGGCTACACCTTC	CASSFHPGHGRRGYTF	TRBV27	TRBJ1-2
TGCGCCAGCAGTGAGGCGGGGGTAGGCAATCAGCCCCAGCATTTT	CASSEAGVGNQPQHF	TRBV10-1	TRBJ1-5
TGTGCCAGCAGTGACGGGCAGGGGGCAGGGACTGAAGCTTTCTTT	CASSDGQGAGTEAFF	TRBV6-4	TRBJ1-1
TGTGCCAGCAGCAGGGGAGCGGGCAATGAGCAGTTCTTC	CASSRGAGNEQFF	TRBV7-3	TRBJ2-1
TGTGCCAGCAGCCCAAGGACAGGAACTGGTGGCTACACCTTC	CASSPRTGTGGYTF	TRBV28	TRBJ1-2
TGTGCCCCAGTCATCCATACAGGGGTGCTTCCGAACACTGAAGCTTTCTTT	CAPVIHTGVLPNTEAFF	TRBV10-3	TRBJ1-1
TGTGCCAGCAGCAGAGAGGATCAGCCCCAGCATTTT	CASSREDQPQHF	TRBV9	TRBJ1-5
TGTGCCAGCAGCTCGGAGTTGCGGCTCGAAGAGACCCAGTACTTC	CASSSELRLEETQYF	TRBV5-6	TRBJ2-5
TGTGCCAGCAGTTCCCCGGGGACAGGGGGAGGGAGAGGAGACACCTTC	CASSSPGTGGGRGDTF	TRBV6-2	TRBJ1-2
TGTGCCAGCAGTTGGAAGACAGGGGAGGAGACACAGCCCCAGCATTTT	CASSWKTGEETQPQHF	TRBV6-9	TRBJ1-5
TGTGCCAGCAGCGTAGCACTTCCCCCCGACAGGGACTATGGCTACACCTTC	CASSVALPPDRDYGYTF	TRBV9	TRBJ1-2
TGTGCCAGCAGTGCATTACCGGTCAGTCAGGGCGAGGTGGGCACAGATACGCAGTATTTT	CASSALPVSQGEVGTDTQYF	TRBV12-3	TRBJ2-3
TGTGCCAGCAGCGGTTGGGAGGACAGGGGCATGAGCAATCAGCCCCAGCATTTT	CASSGWEDRGMSNQPQHF	TRBV7-3	TRBJ1-5
TGTGCCAGTAGTCGCCCCATTCAGTACTTC	CASSRPIQYF	TRBV6-2	TRBJ2-4
TGTGCCAGCAGCGAGCCGGGACATCTTTATAATGAAAAACTGTTTTTT	CASSEPGHLYNEKLFF	TRBV7-3	TRBJ1-4
TGTGCCAGCAGTGCCATGAGGGTGGGAGACAATGAGCAGTTCTTC	CASSAMRVGDNEQFF	TRBV6-1	TRBJ2-1
TGTGCCAGCAGCTTACCCAGGACAGGGAAAAACATTCAGTACTTC	CASSLPRTGKNIQYF	TRBV7-3	TRBJ2-4
TGTGCCAGCAGTTGCGGGAGGGAGCTTGTTTTGTCCTACGAGCAGTACTTC	CASSCGRELVLSYEQYF	TRBV6-2	TRBJ2-7
TGTGCCAGCAGCCCTCGCGGGTGGGGGGTGGGGGGAGATACGCAGTATTTT	CASSPRGWGVGGDTQYF	TRBV13	TRBJ2-3
TGCAGTGCTCCGGGTTTGGGCCCGACACAACATTCGGGCGAAGCTTTCTTT	CSAPGLGPTQHSGEAFF	TRBV20-1	TRBJ1-1
TGTGCCAGCAGGGTAAAGCCGGGACGGGATGAGCAGTTCTTC	CASRVKPGRDEQFF	TRBV7-2	TRBJ2-1
TGTGCCAGCAGCGACACTGTACGAGAGGCAAACTATGGCTACACCTTC	CASSDTVREANYGYTF	TRBV7-3	TRBJ1-2
TGTGCCAGCAGCTTGGCAGGGGGGCATCAGCCCCAGCATTTT	CASSLAGGHQPQHF	TRBV5-4	TRBJ1-5
TGCGCCAGCAGCACCCTCCGCCCCCCGGGATTTTACAATGAGCAGTTCTTC	CASSTLRPPGFYNEQFF	TRBV5-1	TRBJ2-1
TGTGCCTGGAGGCGGTGCTACGAGCAGTACTTC	CAWRRCYEQYF	TRBV30	TRBJ2-7
TGTGCCAGTGGGAAGGACAGGGGACCCTACGAGCAGTACTTC	CASGKDRGPYEQYF	TRBV19	TRBJ2-7
TGTGCCAGCATTGGGAAATCCCAGGGATGGCAAGGTTCTGGGGCCAACGTCCTGACTTTC	CASIGKSQGWQGSGANVLTF	TRBV6-1	TRBJ2-6
TGTGCCAGCAGCTTACTCCTGGTCAGGGACGAGCAGTACTTC	CASSLLLVRDEQYF	TRBV7-9	TRBJ2-7
TGTGCCAGCAGTCTCTGCGGACAGGGCCGGACCAATCAGCCCCAGCATTTT	CASSLCGQGRTNQPQHF	TRBV6-8	TRBJ1-5
TGTGCCAGCAGAAAGGGTCAGGCCGGCCCCCACTCCTACGAGCAGTACTTC	CASRKGQAGPHSYEQYF	TRBV7-8	TRBJ2-7
TGTGCCAGCAGCTTATTTCCGCGACAGGGGCAGGAGGTAGGCTACACCTTC	CASSLFPRQGQEVGYTF	TRBV7-2	TRBJ1-2
