TGTGCCAGCAGCGGTCCAGAGGGGAGAGACGAGCAGTACTTC	CASSGPEGRDEQYF	TRBV9	TRBJ2-7
TGTGCCAGCAGGACGTCCTACGAGCAGTACTTC	CASRTSYEQYF	TRBV6-2	TRBJ2-7
TGTGCCAGCAGTATTCTAACGGACAGCCAAACTTCCTATAATTCACCCCTCCACTTT	CASSILTDSQTSYNSPLHF	TRBV6-4	TRBJ1-6
TGCAGTGCTAGATTTCGGACTAGCGGAGGAGAGACCCAGTACTTC	CSARFRTSGGETQYF	TRBV20-1	TRBJ2-5
TGTGCCATCAGCGATGACAGGGCTGGGTACGAGCAGTACTTC	CAISDDRAGYEQYF	TRBV10-3	TRBJ2-7
TGTGCCAGCAGGAGGCGACTTGGCTACACCTTC	CASRRRLGYTF	TRBV7-3	TRBJ1-2
TGTGCCAGCAGTACCTGGGGAATGCACGAGCAGTACTTC	CASSTWGMHEQYF	TRBV6-4	TRBJ2-7
TGTGCCAGCAGCCCGGGACAAGCACGACAGCCCCAGCATTTT	CASSPGQARQPQHF	TRBV7-9	TRBJ1-5
TGCGCCAGCCCCCGGGTAACCCTAGAGACTCCTCAGCCCCAGCATTTT	CASPRVTLETPQPQHF	TRBV5-1	TRBJ1-5
TGTGCCCCCACGGGGGGACAGGGCGGACGCCGAGCCCAGCATTTT	CAPTGGQGGRRAQHF	TRBV6-4	TRBJ1-5
TGTGCCAGCAGTTGTCCTAGCGAGGGGAGCTACAATGAGCAGTTCTTC	CASSCPSEGSYNEQFF	TRBV12-4	TRBJ2-1
TGTGCCAGCAGCCAAGCGGTAAGCAACTGTGGAAATCAGCCCCAGCATTTT	CASSQAVSNCGNQPQHF	TRBV14	TRBJ1-5
TGTGCCAGCAGCCGTAACAGAAGGGGCTACGAGCAGTACTTC	CASSRNRRGYEQYF	TRBV5-5	TRBJ2-7
TGTGCCAGCAGTGAGAGAGGGGACCACGAGCAGTACTTC	CASSERGDHEQYF	TRBV12-3	TRBJ2-7
TGTGCCAGCAGCTTCTGGTACGGGGTATACACCATATATTTT	CASSFWYGVYTIYF	TRBV5-4	TRBJ1-3
TGTGCCAGCAGGGTAGTCCAGGTAGCCTACAATGAGCAGTTCTTC	CASRVVQVAYNEQFF	TRBV28	TRBJ2-1
TGTGCCAGCAGTTACTGCCGGGACAGGGGGCGAGTGATGAACACTGAAGCTTTCTTT	CASSYCRDRGRVMNTEAFF	TRBV6-5	TRBJ1-1
TGTGCCAGCAGGGGCTTGTTTTCTCGGACAAGAGGACCTGCCGGGACGACCAGCTCCTACAATGAGCAGTTCTTC	CASRGLFSRTRGPAGTTSSYNEQFF	TRBV7-9	TRBJ2-1
TGTGCCAGCAGCGGCCCTGGGGGGACAGAACAAGAGACCCAGTACTTC	CASSGPGGTEQETQYF	TRBV9	TRBJ2-5
TGTGCCAGCAAAGAATCAGGGTGCTACACCTTC	CASKESGCYTF	TRBV14	TRBJ1-2
TGCAGCGCATCGGGATTAACTGACAATGAGCAGTTCTTC	CSASGLTDNEQFF	TRBV29-1	TRBJ2-1
TGTGCCAGCAGAAGGCTGGCCAAAAACATTCAGTACTTC	CASRRLAKNIQYF	TRBV2	TRBJ2-4
TGTGCCAGCAGTACTGGACCCATTCTACAAGAGACCCAGTACTTC	CASSTGPILQETQYF	TRBV28	TRBJ2-5
TGTGCCAGCAGCTTAACTCTCAGGCACCACTACGAGCAGTACTTC	CASSLTLRHHYEQYF	TRBV11-3	TRBJ2-7
TGTGCCAGCAGCTTACCTAACTTAATGTTGACAGGTGGCTACACCTTC	CASSLPNLMLTGGYTF	TRBV11-2	TRBJ1-2
TGTGCCACCAGCCCGCCCACTACTTACACCAGCTCCTACGAGCAGTACTTC	CATSPPTTYTSSYEQYF	TRBV15	TRBJ2-7
TGTGCCAGCAGTTTCGTGGTTGACAGGGCCCATGAAAAACTGTTTTTT	CASSFVVDRAHEKLFF	TRBV27	TRBJ1-4
TGTGCCAGCAGCCTAGGGGGATCCACTGAAGCTTTCTTT	CASSLGGSTEAFF	TRBV27	TRBJ1-1
TGTGCCAGCAGCCCTTTGACAGGGGAATCTGGGGCCAACGTCCTGACTTTC	CASSPLTGESGANVLTF	TRBV13	TRBJ2-6
TGTGCCAGCAGCGAGATGTTAAGGACAGGCAGCAATCAGCCCCAGCATTTT	CASSEMLRTGSNQPQHF	TRBV5-6	TRBJ1-5
TGCGCCAGCAGCTTGCTGAAACTTTTATATGAGCAGTTCTTC	CASSLLKLLYEQFF	TRBV5-1	TRBJ2-1
TGTGCCAGCAGCTTAGGCTACCTAAATAGGGCCGGCTATGGCTACACCTTC	CASSLGYLNRAGYGYTF	TRBV7-9	TRBJ1-2
TGCAGTGAGGACCAGGGGGTACAGAAAAGTATGAACACTGAAGCTTTCTTT	CSEDQGVQKSMNTEAFF	TRBV20-1	TRBJ1-1
TGTGCCAGCAGTAATGACAGGGGAAGGGGCCACGAGCAGTACTTC	CASSNDRGRGHEQYF	TRBV27	TRBJ2-7
TGTGCCAGCAGCCCGTTACAGGGGCAGGAGCCCCAGCATTTT	CASSPLQGQEPQHF	TRBV14	TRBJ1-5
TGTGCCAGCAGCCAAGATGGGGTAGCGGACCAAGGCACAGATACGCAGTATTTT	CASSQDGVADQGTDTQYF	TRBV3-1	TRBJ2-3
TGTGCCAGCAGCGTCGCCCGTAAGCGGGACCCTGGAAACACCATATATTTT	CASSVARKRDPGNTIYF	TRBV9	TRBJ1-3
TGTGCCAGCAAAATCGCTAGTACTTCCTACGAGCAGTACTTC	CASKIASTSYEQYF	TRBV6-4	TRBJ2-7
TGTGCCAGCAGGCTCACAGGACAGGGACGGAATGAGCAGTTCTTC	CASRLTGQGRNEQFF	TRBV7-2	TRBJ2-1
TGTGCCAGCAGTCCCCCGGGGATGGAGACCCAGTACTTC	CASSPPGMETQYF	TRBV27	TRBJ2-5
TGTGCCCCCTATACAGTTCTAGCTTTCTTT	CAPYTVLAFF	TRBV10-3	TRBJ1-1
TGTGCCAGCCGGGTGCTGGGGGAAGGGTACACCTTC	CASRVLGEGYTF	TRBV25-1	TRBJ1-2
TGCAGTGCATATCGGGATAGGAGGGAAACCCATCGATACGAGCAGTACTTC	CSAYRDRRETHRYEQYF	TRBV20-1	TRBJ2-7
TGTGCCAGCAGTTGCCGACTAGCGGGCAACCAAGAGACCCAGTACTTC	CASSCRLAGNQETQYF	TRBV27	TRBJ2-5
TGTGCCAGCAGCTTGGAAACAGGGGTTGCTTTCTTT	CASSLETGVAFF	TRBV5-4	TRBJ1-1
TGTGCTAGTGGTTCTGAAGTGCGGGGGTTAGGGGGGAGAGCTAGCACAGATACGCAGTATTTT	CASGSEVRGLGGRASTDTQYF	TRBV12-5	TRBJ2-3
TGTGCCAGAGGTCGGCATCACTACGAGCAGTACTTC	CARGRHHYEQYF	TRBV6-2	TRBJ2-7
TGTGCCAGCAGGAAGCGGGCCGGGGACCAAGAGACCCAGTACTTC	CASRKRAGDQETQYF	TRBV2	TRBJ2-5
TGTGCCAGCAACAAGGGGGGGGGGAAGTGGTACAATGAGCAGTTCTTC	CASNKGGGKWYNEQFF	TRBV9	TRBJ2-1
TGTGCCTGGACGGTAATACTAGCGGGAGAGGGCTACGAGCAGTACTTC	CAWTVILAGEGYEQYF	TRBV30	TRBJ2-7
TGCAGTGCCACAGGGAAAGAAAAACTGTTTTTT	CSATGKEKLFF	TRBV20-1	TRBJ1-4
TGCGCCAGCAGCCCGTCCCTTGGGGCCGAGCAGTACTTC	CASSPSLGAEQYF	TRBV5-1	TRBJ2-7
TGTGCTAGTGGTAGGGGAGAGGTGCGGTGGGAGCAGTACTTC	CASGRGEVRWEQYF	TRBV12-5	TRBJ2-7
TGTGCCAGCAGCTTTCGGACAGTAGGACAGCCCCAGCATTTT	CASSFRTVGQPQHF	TRBV5-6	TRBJ1-5
TGTGCCAGCACCGGACGGGGGGGCCAAGCCTACGAGCAGTACTTC	CASTGRGGQAYEQYF	TRBV6-2	TRBJ2-7
TGTGCCAGCAGTTCCTCTGGCGAGGAAGAGCAGTACTTC	CASSSSGEEEQYF	TRBV6-2	TRBJ2-7
TGTGCCAGCAGCGACAGGGGGGAGACCCAGTACTTC	CASSDRGETQYF	TRBV13	TRBJ2-5
TGCAGACGCGACAGGGGTTACAAAACTAATGAAAAACTGTTTTTT	CRRDRGYKTNEKLFF	TRBV20-1	TRBJ1-4
TGTGCCAGCAGTTACACGGGGGACTATGGCTACACCTTC	CASSYTGDYGYTF	TRBV6-6	TRBJ1-2
TGCAGTGCTAGAGTATATGAAAAGAATCAGCCCCAGCATTTT	CSARVYEKNQPQHF	TRBV20-1	TRBJ1-5
TGTGCCAGCAGCGGCTACCCTAGCAGGCCGGTACCCACAGATACGCAGTATTTT	CASSGYPSRPVPTDTQYF	TRBV11-3	TRBJ2-3
TGTGCCAGCAGTTTGACCACCCCCAGGGACAGTCGTCGCCTTTATGGCTACACCTTC	CASSLTTPRDSRRLYGYTF	TRBV27	TRBJ1-2
TGTGCCAGCAGTTCGGGGGGCCCCTGTACTGAGCAGTACTTC	CASSSGGPCTEQYF	TRBV12-3	TRBJ2-7
TGTGCCAGCAGCGGGGGCACGGGGGGCTCTGGGGCCAACGTCCTGACTTTC	CASSGGTGGSGANVLTF	TRBV7-2	TRBJ2-6
TGTGCCACCAGTGATTTGGGTAGGGTGATGAACACTGAAGCTTTCTTT	CATSDLGRVMNTEAFF	TRBV24-1	TRBJ1-1
TGTGCCAGCAGCTTAGCTCGAGACAGTCGTGGCTACACCTTC	CASSLARDSRGYTF	TRBV11-2	TRBJ1-2
TGTGCCAGCAGTGAAGGTCGGACTAGGGGGAGCTCCTACAATGAGCAGTTCTTC	CASSEGRTRGSSYNEQFF	TRBV6-4	TRBJ2-1
TGCAGTGCAGGGAAGGGGCCGGGCCAGCCCCAGCATTTT	CSAGKGPGQPQHF	TRBV20-1	TRBJ1-5
TGTGCCAGCAGCGATAGCCCCCCGGGGACCGTTTTTGATAATTCACCCCTCCACTTT	CASSDSPPGTVFDNSPLHF	TRBV13	TRBJ1-6
TGTGCCAGCAGCTTAGCCCAGAGCGTTGACGAGCAGTACTTC	CASSLAQSVDEQYF	TRBV7-9	TRBJ2-7
TGTGCCAGCAGTGGCAGGAAGGGAGGTCTTACGAGAGATCCACGGCAGCCCCAGCATTTT	CASSGRKGGLTRDPRQPQHF	TRBV6-5	TRBJ1-5
TGTGCCAGCAGCCGACAGCACCGATCTAACTATGGCTACACCTTC	CASSRQHRSNYGYTF	TRBV3-1	TRBJ1-2
TGTGCCAGCAGCTGTGGTGACCAGGATCTTCAAACCGGGGAGCTGTTTTTT	CASSCGDQDLQTGELFF	TRBV7-3	TRBJ2-2
TGTGCCAGCAGCTTAACGCGGGATCTAGCAAGGTTAAGAGAGACCCAGTACTTC	CASSLTRDLARLRETQYF	TRBV7-3	TRBJ2-5
TGTGCCAGCAGTGACTCGCCCGGGACTTACAATGAGCAGTTCTTC	CASSDSPGTYNEQFF	TRBV6-4	TRBJ2-1
TGTGCCAGCAGCTATACTCCTGGACTAGCGGGCGGGAACACCGGGGAGCTGTTTTTT	CASSYTPGLAGGNTGELFF	TRBV7-9	TRBJ2-2
TGTGCCAGCAGCCCAGGGGGGGACAGAGTGTACGAGCAGTACTTC	CASSPGGDRVYEQYF	TRBV6-1	TRBJ2-7
TGTGCCTGGAGTGTACAGAATGGCGCGGGAGGGGGATACAATGAGCAGTTCTTC	CAWSVQNGAGGGYNEQFF	TRBV30	TRBJ2-1
TGTGCCACCAGTGATAAGACCCGGGACAGGGAACTATACGAGCAGTACTTC	CATSDKTRDRELYEQYF	TRBV24-1	TRBJ2-7
TGTGCCAGAACTACAGGGAGAGGCAATCAGCCCCAGCATTTT	CARTTGRGNQPQHF	TRBV28	TRBJ1-5
TGTGCCAGCAGACGGGACAGGGGGAACACCTTC	CASRRDRGNTF	TRBV2	TRBJ1-2
TGCGCCAGCAGCTTGCGGTTCCAGGGGAAACAGCCCCAGCATTTT	CASSLRFQGKQPQHF	TRBV5-1	TRBJ1-5
TGCGCCAGCAGCGACCCAGACAGGGGATTCTGCAATCAGCCCCAGCATTTT	CASSDPDRGFCNQPQHF	TRBV5-1	TRBJ1-5
TGTGCCAGTTATCAAAAAAGGCAAACCTACGAGCAGTACTTC	CASYQKRQTYEQYF	TRBV2	TRBJ2-7
TGTGCCAGCAGTTTCCTTCGGGGATACGAGCAGTACTTC	CASSFLRGYEQYF	TRBV12-4	TRBJ2-7
TGTGCCAGCAGTCCCTACAGACCGCAGCCCCAGCATTTT	CASSPYRPQPQHF	TRBV6-4	TRBJ1-5
TGCGCCAGCAGCTATTTGGACAGGGGGAGTAGGGACTTCACCCCAGACTACACCTTC	CASSYLDRGSRDFTPDYTF	TRBV5-1	TRBJ1-2
TGTGCCACCAGTGGATACGGCACCGGGGGGCCCTGGGGCGATGAGCAGTTCTTC	CATSGYGTGGPWGDEQFF	TRBV24-1	TRBJ2-1
TGTCAGGGGGGGCCGGGGGAGCTGTTTTTT	CQGGPGELFF	TRBV27	TRBJ2-2
TGCAGTGCTAGAATACCTGGGACATGGGGGTATAGCAATCAGCCCCAGCATTTT	CSARIPGTWGYSNQPQHF	TRBV20-1	TRBJ1-5
TGCAGTGCTAGAGTCATACCCCCGGGGACAGACGTGAACACTGAAGCTTTCTTT	CSARVIPPGTDVNTEAFF	TRBV20-1	TRBJ1-1
TGTGCCAGCAGTCCTTTCAGAACCGGGGAGCTGTTTTTT	CASSPFRTGELFF	TRBV7-4	TRBJ2-2
TGTGCCAGATTTTCTTCGGGGAGGGGGAACGAGCAGTACTTC	CARFSSGRGNEQYF	TRBV6-1	TRBJ2-7
TGTGCCAGCATCGCAGGGGGCTCCTATAATTCACCCCTCCACTTT	CASIAGGSYNSPLHF	TRBV6-1	TRBJ1-6
TGCAGTGCTAGACTCGCACAGTACGAAAAACTGTTTTTT	CSARLAQYEKLFF	TRBV20-1	TRBJ1-4
TGTGCCAGCAGCTTCCGCGGGACTAGCGGGACCGGGGAGCTGTTTTTT	CASSFRGTSGTGELFF	TRBV7-3	TRBJ2-2
TGTGCCAGCTCACCAAAACCACAGTGGGAAGGCTCCTACGAGCAGTACTTC	CASSPKPQWEGSYEQYF	TRBV18	TRBJ2-7
TGCGCCAGCAGCTTTAGACGGGGAAGGTATGGCTACACCTTC	CASSFRRGRYGYTF	TRBV5-1	TRBJ1-2
TGTGCCAGCAGCTCCCCGGGAGCGGGAGAACGGGCTCGATATGGCTACACCTTC	CASSSPGAGERARYGYTF	TRBV7-7	TRBJ1-2
TGCGCCAGCAAACCACAGGGTAACCAAGAGACCCAGTACTTC	CASKPQGNQETQYF	TRBV10-1	TRBJ2-5
