TGCGCCAGCAGCTGCACTCCGGGACAACTCTACGAGCAGTACTTC	CASSCTPGQLYEQYF	TRBV5-1	TRBJ2-7
TGTGCCAGCAGCCAAGTACCCCGGGATGAACACTCCTACAATGAGCAGTTCTTC	CASSQVPRDEHSYNEQFF	TRBV3-1	TRBJ2-1
TGTGCCAGCAGCCAAGATAGCCCATACAATGAGCAGTTCTTC	CASSQDSPYNEQFF	TRBV3-1	TRBJ2-1
TGTGCCAGCAAGGGGGGGGGTCGGAGCACAGATACGCAGTATTTT	CASKGGGRSTDTQYF	TRBV9	TRBJ2-3
TGCGCCAGCAGCTGTAGCTGGACAGGGGATGGGACCCAGTACTTC	CASSCSWTGDGTQYF	TRBV5-1	TRBJ2-5
TGCGCCAGCAGCTTGGAAGACAGGGAGCTCGACTCTGGAAACACCATATATTTT	CASSLEDRELDSGNTIYF	TRBV5-1	TRBJ1-3
TGTGCTAGTGGGCCCAGGGGGGGGAGCTATGGCTACACCTTC	CASGPRGGSYGYTF	TRBV12-5	TRBJ1-2
TGTGCCAGCAGCGCCGAACGACAGGGGGACCTCGAGCAGTACTTC	CASSAERQGDLEQYF	TRBV7-4	TRBJ2-7
TGCGCCATCCCCGGACCGAATGGGGCCAACGTCCTGACTTTC	CAIPGPNGANVLTF	TRBV10-1	TRBJ2-6
TGCGCCAGCAGTGAGGGGGGCCAGTCTGGAAACACCATATATTTT	CASSEGGQSGNTIYF	TRBV10-2	TRBJ1-3
TGTGCCAGCAGTTACTTTGGGGGCCCCGACTATGGCTACACCTTC	CASSYFGGPDYGYTF	TRBV6-5	TRBJ1-2
TGTGCCAGCAGTTTACGTAATGCCGGGGGTTCCCAGCATTTT	CASSLRNAGGSQHF	TRBV28	TRBJ1-5
TGTGCCAGCAGCCATTATGATTACAGGGCCTATGGCTACACCTTC	CASSHYDYRAYGYTF	TRBV3-1	TRBJ1-2
TGTGCCTGGAGGTGGGACAGGGGGCGGGCCAGAAATCAGCCCCAGCATTTT	CAWRWDRGRARNQPQHF	TRBV30	TRBJ1-5
TGTGCCAGCAGCCGTAAAGCACTAGCGGGAGCGCTGGGCTACACCTTC	CASSRKALAGALGYTF	TRBV13	TRBJ1-2
TGCAGTGCGGCACTCAGGGGCTACGAGCAGTACTTC	CSAALRGYEQYF	TRBV20-1	TRBJ2-7
TGCAGTGCTATATGCCCCGGCGGAAGGACAGCCCGGGGCGAGCAGTACTTC	CSAICPGGRTARGEQYF	TRBV20-1	TRBJ2-7
TGTGCCAGCAGCTTGGGATGCCGGCAAAACTTCCTGAACTATGGCTACACCTTC	CASSLGCRQNFLNYGYTF	TRBV11-3	TRBJ1-2
TGCGCCAGCAGCATTCCAAGGGGAAGGCCAACTAATGAAAAACTGTTTTTT	CASSIPRGRPTNEKLFF	TRBV5-1	TRBJ1-4
TGTGCCAGCAGCAGCCCCCCCAGGTCCAGAGTAAAACTGTTTTTT	CASSSPPRSRVKLFF	TRBV7-3	TRBJ1-4
TGTGCCACCCGAGAGGGACTGACTGAGCAGTTCTTC	CATREGLTEQFF	TRBV6-4	TRBJ2-1
TGTGCCAGCAGAGAGCGGCCAGGCACAGATACGCAGTATTTT	CASRERPGTDTQYF	TRBV7-2	TRBJ2-3
TGTGCCAGCAGCCAGGTCCGGACGGGATGCCGGTATGAGCAGTTCTTC	CASSQVRTGCRYEQFF	TRBV3-1	TRBJ2-1
TGTGCCAGCAGTGCCCCCAGTTGCTCCTACGAGCAGTACTTC	CASSAPSCSYEQYF	TRBV2	TRBJ2-7
TGTGCCAGCAAGAGGGACGGGAATGAAAAACTGTTTTTT	CASKRDGNEKLFF	TRBV27	TRBJ1-4
TGCGCCAGCAGCTCAGGAGTTGACAGGGTAACTGGCTATGGCTACACCTTC	CASSSGVDRVTGYGYTF	TRBV5-1	TRBJ1-2
TGTGCCAGCCCAAGGGCCTCCACAGATACGCAGTATTTT	CASPRASTDTQYF	TRBV5-6	TRBJ2-3
TGTGCCAGCACCGAAGGGATACTTCTCCGCAATCAGCCCCAGCATTTT	CASTEGILLRNQPQHF	TRBV25-1	TRBJ1-5
TGTGCCAGCAGTTACTCGGCGGGACAGGTGGTTAACGAGCAGTACTTC	CASSYSAGQVVNEQYF	TRBV6-5	TRBJ2-7
TGCGCCAGCAGTGAAAAGCACCGTCCCTACGAGCAGTACTTC	CASSEKHRPYEQYF	TRBV10-2	TRBJ2-7
TGTGCCACCTCACTTATCTACGAGCAGTACTTC	CATSLIYEQYF	TRBV24-1	TRBJ2-7
TGCGCCAGCAGTGAGGGTGACAGGCTGTGTCACTGGTCCGCTTTCTTT	CASSEGDRLCHWSAFF	TRBV10-1	TRBJ1-1
TGTGCCAGCAGTCCCCAAAAAGAGGCGCCGGGACAGGGTCCACCTTGTATGGATACGCAGTATTTT	CASSPQKEAPGQGPPCMDTQYF	TRBV12-4	TRBJ2-3
TGCAGTGCTAGAGACCCGGTGAACAGGCAGTACTTC	CSARDPVNRQYF	TRBV20-1	TRBJ2-7
TGTGCCAGCAGCCTTTTCGAGCGGGACGCAGATACGCAGTATTTT	CASSLFERDADTQYF	TRBV11-2	TRBJ2-3
TGTGCCAGCATTCCCCGGGGGGCAACCTACGAGCAGTACTTC	CASIPRGATYEQYF	TRBV11-3	TRBJ2-7
TGTGCCAGCAGCCAGACTAGCGCGAATTGGGGGCCTAGCACAGATACGCAGTATTTT	CASSQTSANWGPSTDTQYF	TRBV13	TRBJ2-3
TGTGCCAGCAGTGACCAAAGATTAGGGAGGGGTTACGAGCAGTACTTC	CASSDQRLGRGYEQYF	TRBV6-4	TRBJ2-7
TGTGCCAGCCAGGGGGGGGGAACGGGACAAGAGACCCAGTACTTC	CASQGGGTGQETQYF	TRBV2	TRBJ2-5
TGTGCCAGCAGTTTAGGAATTCGTACCCATGAGCAGTTCTTC	CASSLGIRTHEQFF	TRBV27	TRBJ2-1
TGTGCCAACGCGGGAGACAATGAGCAGTTCTTC	CANAGDNEQFF	TRBV28	TRBJ2-1
TGTGCCACCAGTGATTCCTTCAGGGCCAGGTCGCTGGGGCAAGAGACCCAGTACTTC	CATSDSFRARSLGQETQYF	TRBV24-1	TRBJ2-5
TGTGCCAGCAGCTTAGGCCGGTCTAGGGGCCCAGTTGAAAAACTGTTTTTT	CASSLGRSRGPVEKLFF	TRBV7-2	TRBJ1-4
TGCGCCAGCAGTGACAGAAGTCCCGGGACGGGTCACACTGAAGCTTTCTTT	CASSDRSPGTGHTEAFF	TRBV10-1	TRBJ1-1
TGTGCCAGCAGCTTAGCTTTTTCCGGGACAGGGGTCTATAATTCACCCCTCCACTTT	CASSLAFSGTGVYNSPLHF	TRBV7-2	TRBJ1-6
TGTGCCAGCGCCGGTCAGGGAGACGAGCAGTACTTC	CASAGQGDEQYF	TRBV6-4	TRBJ2-7
TGCGCCAGCACCCTAGCGGTGGGAAAGTACACCGGGGAGCTGTTTTTT	CASTLAVGKYTGELFF	TRBV10-2	TRBJ2-2
TGTGCCAGCAGTGGGGCAGGTTTTGAAGCTTTCTTT	CASSGAGFEAFF	TRBV5-6	TRBJ1-1
TGTGCCAGTCGCATGAAAAGCGGGAGGAACACTGAAGCTTTCTTT	CASRMKSGRNTEAFF	TRBV19	TRBJ1-1
TGTGCCAGCAGCGAGAGGAGCACAGATACGCAGTATTTT	CASSERSTDTQYF	TRBV13	TRBJ2-3
TGCGCCAGCAGCTGGCAGACCAGCTCCTACGAGCAGTACTTC	CASSWQTSSYEQYF	TRBV5-1	TRBJ2-7
TGTGCCATCAGTGCCCTTTGGACAGGGTTCGATCAGCCCCAGCATTTT	CAISALWTGFDQPQHF	TRBV10-3	TRBJ1-5
TGTGCCAGCAGCGTCCCGAATCCCGGGACAGTCGGCCATCGAGCACTGTGTAATGAAAAACTGTTTTTT	CASSVPNPGTVGHRALCNEKLFF	TRBV13	TRBJ1-4
TGCGCCAGTCCCATAAACGCCCCCCCAAAATCCGCAAAGACAGGTGACACCGGGGAGCTGTTTTTT	CASPINAPPKSAKTGDTGELFF	TRBV5-1	TRBJ2-2
TGTGCCAGCAGTTACAGGAGGTATGAGCAGTTCTTC	CASSYRRYEQFF	TRBV6-5	TRBJ2-1
TGTGCCAAAGGACGGGAAAGCAATCAGCCCCAGCATTTT	CAKGRESNQPQHF	TRBV25-1	TRBJ1-5
TGTGCCAGCAGCTTGGAGGATTCCGGGGGTGCCTTCTTT	CASSLEDSGGAFF	TRBV5-4	TRBJ1-1
TGTGCCAGCAGCACCCGGGACAGGGGGCACGAGCAGTACTTC	CASSTRDRGHEQYF	TRBV7-9	TRBJ2-7
TGTGCCAGCAGTGCACTCCCACTCCATGGGCCCGATTACTATTATGGCTACACCTTC	CASSALPLHGPDYYYGYTF	TRBV6-5	TRBJ1-2
TGCGCCAGCAGCTTGGGGCTCCAAGCTTGGGGACAGCAGGGGGACACCATATATTTT	CASSLGLQAWGQQGDTIYF	TRBV5-1	TRBJ1-3
TGTGCCAGCAGTTACAACGGGAAAGCCCCGAACTATGGCTACACCTTC	CASSYNGKAPNYGYTF	TRBV6-6	TRBJ1-2
TGTGCCAGCAGCTTACCGGTTCGAGCGGTTTCAGATACGCAGTATTTT	CASSLPVRAVSDTQYF	TRBV7-2	TRBJ2-3
TGTGCCAGCAGCGTTACGGGACCCGACGAGCAGTACTTC	CASSVTGPDEQYF	TRBV7-4	TRBJ2-7
TGTGCCAGCAGCTACCCAGCGGGAGACTATGGCTACACCTTC	CASSYPAGDYGYTF	TRBV28	TRBJ1-2
TGTGCCAGCAGCAATCCCTACAGGGGGCGCCTCGAAAAACTGTTTTTT	CASSNPYRGRLEKLFF	TRBV11-3	TRBJ1-4
TGTGCCTGGGAAAGGAGTATTGTACGCAATCAGCCCCAGCATTTT	CAWERSIVRNQPQHF	TRBV30	TRBJ1-5
TGTGCCAGCTCACCAGGGGCAGGGACTAGGTATTTT	CASSPGAGTRYF	TRBV18	TRBJ2-3
TGCAGTGCTGATACCACCTCAGGGGCAAACTATGGCTACACCTTC	CSADTTSGANYGYTF	TRBV20-1	TRBJ1-2
TGCAGTGCTAGAGATCTGTGCCCGCGGGGGTATGAAGGCGAGCAGTACTTC	CSARDLCPRGYEGEQYF	TRBV20-1	TRBJ2-7
TGTGCCAGCAGAACAGATACAGGGGCTTTCTTT	CASRTDTGAFF	TRBV13	TRBJ1-1
TGCAGTGCTAGAGCTTGCAGGGGAACCGGCTACACCTTC	CSARACRGTGYTF	TRBV20-1	TRBJ1-2
TGTGCCAGCACCCCCCTGCGGGCCGGGACCCAGTACTTC	CASTPLRAGTQYF	TRBV6-1	TRBJ2-5
TGTGCCAGCAGTTACCCCGGGACAGGGGACGGGGTCGCACCCCTCCACTTT	CASSYPGTGDGVAPLHF	TRBV6-5	TRBJ1-6
TGTGCCAGCAGCGTGGGACTTGCTTACCCAGCCAACACAGATACGCAGTATTTT	CASSVGLAYPANTDTQYF	TRBV13	TRBJ2-3
TGTGCCAGCAGTTGTACGTCCGGGACAGGGGGTAGCTCCTACGAGCAGTACTTC	CASSCTSGTGGSSYEQYF	TRBV25-1	TRBJ2-7
TGTGCCAGCGGGAGGCTTTCACCCCTCCACTTT	CASGRLSPLHF	TRBV6-5	TRBJ1-6
TGCAGTGCTTCGCGGGAGGTCGCCGGGGACACCGGGGAGCTGTTTTTT	CSASREVAGDTGELFF	TRBV20-1	TRBJ2-2
TGTGCCAGCTCACCCAGGGTCAGCTCCTATAATTCACCCCTCCACTTT	CASSPRVSSYNSPLHF	TRBV18	TRBJ1-6
TGTGCCAGCAGCTTGGCGCCCCAAACAGGGCCGGATGAAAAACTGTTTTTT	CASSLAPQTGPDEKLFF	TRBV5-8	TRBJ1-4
TGCGCCAGCAGCCGAGTTGGAAACACCATATATTTT	CASSRVGNTIYF	TRBV5-1	TRBJ1-3
TGCAGGCTCGTGAATGAGCAGTTCTTC	CRLVNEQFF	TRBV20-1	TRBJ2-1
TGCGCCAGCAGCCAAGATGATTGCCTTGACGGGACTACCGGACATGAGCAGTTCTTC	CASSQDDCLDGTTGHEQFF	TRBV4-3	TRBJ2-1
TGTGCCATCAGATCGGGAGCTATCCATGAGCAGTTCTTC	CAIRSGAIHEQFF	TRBV10-3	TRBJ2-1
TGTGCCAGCAGATCTACGGGGACAGGGGCTCCATATCAGCCCCAGCATTTT	CASRSTGTGAPYQPQHF	TRBV12-4	TRBJ1-5
TGTGCCAGCAGCGTAATATGGGACAGGGGTTCCTATGGCTACACCTTC	CASSVIWDRGSYGYTF	TRBV9	TRBJ1-2
TGTGCCAGCAGCTTAGGGACTAGCGGGGGAGATGATACGCAGTATTTT	CASSLGTSGGDDTQYF	TRBV11-2	TRBJ2-3
TGTGCCAGCAGGGCAATGGAGCCTGAAGCTTTCTTT	CASRAMEPEAFF	TRBV7-3	TRBJ1-1
TGTGCCAGCAGTTACGGGCGTCCCCGGGGGGGTTTAAGACCGCAGTATTTT	CASSYGRPRGGLRPQYF	TRBV6-5	TRBJ2-3
TGTGCCAGCGTATTCTTGGGACAGGGCGGCTCCTACAATGAGCAGTTCTTC	CASVFLGQGGSYNEQFF	TRBV2	TRBJ2-1
TGTGCCACCCCACCGTTCAGCTACGAGCAGTACTTC	CATPPFSYEQYF	TRBV15	TRBJ2-7
TGTGCCAGCAGTACTCTTAGAATTGTTTCACCCCTCCACTTT	CASSTLRIVSPLHF	TRBV6-2	TRBJ1-6
TGTGCCAGCAGTAGTTGGCTAGTATACTACGAGCAGTACTTC	CASSSWLVYYEQYF	TRBV27	TRBJ2-7
TGCAGCGACAGCCGAGGTGTCCATGGCTACACCTTC	CSDSRGVHGYTF	TRBV29-1	TRBJ1-2
TGTGCCAGCAGCTTAACAGGGCTAGGCTCCTACGAGCAGTACTTC	CASSLTGLGSYEQYF	TRBV5-4	TRBJ2-7
TGTGCCAGTAGTTTAATACGGGGGCTAGAGACCCAGTACTTC	CASSLIRGLETQYF	TRBV19	TRBJ2-5
TGTGCCAGCAGTTTGAAGATTTGGGCCCGAAGTAATGAAAAACTGTTTTTT	CASSLKIWARSNEKLFF	TRBV12-3	TRBJ1-4
TGTGCCAGCAGTTTATATTCTCCACGGGTCGGGATCCCAGCTTACGAGCAGTACTTC	CASSLYSPRVGIPAYEQYF	TRBV27	TRBJ2-7
TGTGCCAGCAGCCCTCGGGGTCATTACCAAGAGACCCAGTACTTC	CASSPRGHYQETQYF	TRBV7-2	TRBJ2-5
TGTGCCAGCTCACCACACGCATCAATACACTGTCGATACAATGAGCAGTTCTTC	CASSPHASIHCRYNEQFF	TRBV18	TRBJ2-1
TGTGCCAGCCGACTAGCGGGAGCTGGAAACACCATATATTTT	CASRLAGAGNTIYF	TRBV12-3	TRBJ1-3
