TGTGCCAGCAGTGAATCTAATACCAGGGACAGGCAAGGTGGCTACACCTTC	CASSESNTRDRQGGYTF	TRBV25-1	TRBJ1-2
TGTGCCATCAGTGAGTCAGACCCAGAACGAGAGCGGGACAACACCTATGGCTACACCTTC	CAISESDPERERDNTYGYTF	TRBV10-3	TRBJ1-2
TGCGCCACGGGACATGAATACGAGCAGTACTTC	CATGHEYEQYF	TRBV4-1	TRBJ2-7
TGTGCCAGTAGTATCCTGGACCCCAAGTATGGCTACACCTTC	CASSILDPKYGYTF	TRBV19	TRBJ1-2
TGTGCCACCACTAGCGTGACGATTGATAACGGGGAGCTGTTTTTT	CATTSVTIDNGELFF	TRBV19	TRBJ2-2
TGTGCCAGCAGCTTAGCTTTGGGTCACGGACAGGGGGCCAGCTCCTACGAGCAGTACTTC	CASSLALGHGQGASSYEQYF	TRBV7-2	TRBJ2-7
TGTGCCAGCAGCCGTTCCAGCCAAAAGGGAAGGAGGACCTACGAGCAGTACTTC	CASSRSSQKGRRTYEQYF	TRBV7-3	TRBJ2-7
TGTGCCAGCAGCTTAGGAGGGAGGTACGAGCAGTACTTC	CASSLGGRYEQYF	TRBV11-3	TRBJ2-7
TGTGCCAGCAGCTTGAATCCGACAGGGCATCAAGAGACCCAGTACTTC	CASSLNPTGHQETQYF	TRBV5-4	TRBJ2-5
TGTGCCAGCAGTTTAACACTAGCGGGAGGGGGGCGGAGTCGCGAGCAGTACTTC	CASSLTLAGGGRSREQYF	TRBV28	TRBJ2-7
TGTGCCAGCAGTGATCCGGGGACAGGGACTGAAGCTTTCTTT	CASSDPGTGTEAFF	TRBV25-1	TRBJ1-1
TGTGCCAGCAGAGTTTACACCACTAGCGGGAGCAAGCTGTTTTTT	CASRVYTTSGSKLFF	TRBV7-9	TRBJ1-4
TGTGCCACCAGCCTATCTGGGGAAGCTTTCTTT	CATSLSGEAFF	TRBV24-1	TRBJ1-1
TGTGCCAGCAGCCTTGGAGGACACGACACTGAAGCTTTCTTT	CASSLGGHDTEAFF	TRBV12-3	TRBJ1-1
TGTGCCACCAGTGATTTGCCCTGCAGGCCTAGCTCCTACGAGCAGTACTTC	CATSDLPCRPSSYEQYF	TRBV24-1	TRBJ2-7
TGTGCCAGTAGTTTGGGGGGCGTGAACACTGAAGCTTTCTTT	CASSLGGVNTEAFF	TRBV19	TRBJ1-1
TGTGCCAGCAGCTTTGACAGCAAAATTAACACCGGGGAGCTGTTTTTT	CASSFDSKINTGELFF	TRBV5-6	TRBJ2-2
TGTGCCAGCAGCTTGGGTACTCCTCCTCGGGTAAGAAAGGACAGGGGCAATTCACCCCTCCACTTT	CASSLGTPPRVRKDRGNSPLHF	TRBV5-6	TRBJ1-6
TGCAGCGTGGCTAGGACAAACTATGGCTACACCTTC	CSVARTNYGYTF	TRBV29-1	TRBJ1-2
TGTGCCAGCAGGATCGAAGGACGCTCCAAGCACACTGAAGCTTTCTTT	CASRIEGRSKHTEAFF	TRBV12-4	TRBJ1-1
TGCGCCAGCACAAAACCAGACAGGAAAGAGACCCAGTACTTC	CASTKPDRKETQYF	TRBV5-1	TRBJ2-5
TGTGCCAGCAGGAGTCATTCCAGCGAACTCCATGGCTACACCTTC	CASRSHSSELHGYTF	TRBV6-1	TRBJ1-2
TGTGCCAGCAGCGGCACCCAGACCCATCAGCCCCAGCATTTT	CASSGTQTHQPQHF	TRBV13	TRBJ1-5
TGTGCCAGCAGAGGGTTCCGGGACAGGGTAAACACTGAAGCTTTCTTT	CASRGFRDRVNTEAFF	TRBV7-2	TRBJ1-1
TGTGCCAGCAGTGAGCAGCCCTGGACAGGGGAGGGGGACACTGAAGCTTTCTTT	CASSEQPWTGEGDTEAFF	TRBV2	TRBJ1-1
TGCGCCAGCGGTATCGGGCAGGGCGACGAAGCTTTCTTT	CASGIGQGDEAFF	TRBV5-1	TRBJ1-1
TGTGCCAGCAGCTCGGGGACCGAGACAGTCGAGCAGTACTTC	CASSSGTETVEQYF	TRBV11-2	TRBJ2-7
TGCGCCAGCAGCGGGACTAGCGGGGGGCCCACAGATACGCAGTATTTT	CASSGTSGGPTDTQYF	TRBV5-1	TRBJ2-3
TGCCTGTTTAGGGAAGATCAGCCCCAGCATTTT	CLFREDQPQHF	TRBV20-1	TRBJ1-5
TGCGCCAGCAGTGAGAGGAGTCCCCAGGGGGATTATAGCAATCAGCCCCAGCATTTT	CASSERSPQGDYSNQPQHF	TRBV10-1	TRBJ1-5
TGTGCCAGCAGCAACCGGGGAAGGGTGAACACCGGGGAGCTGTTTTTT	CASSNRGRVNTGELFF	TRBV13	TRBJ2-2
TGTGCCAGCAGCTTGGACCGGGTGTCTGGAAACACCATATATTTT	CASSLDRVSGNTIYF	TRBV11-2	TRBJ1-3
TGTGCTAGTGGTTTGGAACCACGGGTTATCACCGGGGAGCTGTTTTTT	CASGLEPRVITGELFF	TRBV12-5	TRBJ2-2
TGTGCCAGCAGTTTCAACAGCGGGGGCTACACCTTC	CASSFNSGGYTF	TRBV12-4	TRBJ1-2
TGTGCCAGCAGTTTACCCCCGGGACCCCAGAATCAGCCCCAGCATTTT	CASSLPPGPQNQPQHF	TRBV12-4	TRBJ1-5
TGTGCCAGCAGCTCAGGCAACCGGGGGGGCCCGTTGACCACAGATACGCAGTATTTT	CASSSGNRGGPLTTDTQYF	TRBV13	TRBJ2-3
TGTGCCAGCAGTGAATGTCCTAGCGTGGGAACCTACGAGCAGTACTTC	CASSECPSVGTYEQYF	TRBV7-9	TRBJ2-7
TGTGCCAGCAGGGCCCGGGACAGCGAGGACACCGGGGAGCTGTTTTTT	CASRARDSEDTGELFF	TRBV12-3	TRBJ2-2
TGTGCCAGCAGTCCCCCAGCTACAGGGACATTCTCTGGAAACACCATATATTTT	CASSPPATGTFSGNTIYF	TRBV27	TRBJ1-3
TGTGCCAGCAGTGACCGGACCAACTATGGCTACACCTTC	CASSDRTNYGYTF	TRBV6-1	TRBJ1-2
TGCGCCAGCAGCAGAGACAGGGGGGACGGTCCCACTGAAGCTTTCTTT	CASSRDRGDGPTEAFF	TRBV4-1	TRBJ1-1
TGTGCCAGCAGTTTACGTGGGGGCAACAGGGACACTGAAGCTTTCTTT	CASSLRGGNRDTEAFF	TRBV27	TRBJ1-1
TGTGCTAGTGGTGGCAGCATTCAGTACTTC	CASGGSIQYF	TRBV12-5	TRBJ2-4
TGTGGGGGGGGGTGGCTCTACGAGCAGTACTTC	CGGGWLYEQYF	TRBV6-2	TRBJ2-7
TGTGCCAGCTCACAAGGAATTTCTAGCGGCGGCTACGAGCAGTACTTC	CASSQGISSGGYEQYF	TRBV18	TRBJ2-7
TGCGCCAGCAGCCAAGATGGACTTCTTAATGAAAAACTGTTTTTT	CASSQDGLLNEKLFF	TRBV4-3	TRBJ1-4
TGCGCCAGCAGCCAGCGGGGGACTAGCGGGAGATACGAGCAGTACTTC	CASSQRGTSGRYEQYF	TRBV4-1	TRBJ2-7
TGTGCCACCAGAATCCTTAGGGATCAGCCCCAGCATTTT	CATRILRDQPQHF	TRBV24-1	TRBJ1-5
TGTGCCAGCAGTACTAGTACGCAGTATTTT	CASSTSTQYF	TRBV7-2	TRBJ2-3
TGTGCCAGCAGCCACGCTGTACATAAAATCGCCTCCTATAATTCACCCCTCCACTTT	CASSHAVHKIASYNSPLHF	TRBV14	TRBJ1-6
TGTGCTAGTGGTTTGGTACCCTCCCCGAAACCGGGACAGGTAGTCTCTGGGGCCAACGTCCTGACTTTC	CASGLVPSPKPGQVVSGANVLTF	TRBV12-5	TRBJ2-6
TGTGCCAGCAGCGCCCGGTTATTCGGGTACAGCTCCTACAATGAGCAGTTCTTC	CASSARLFGYSSYNEQFF	TRBV3-1	TRBJ2-1
TGTGCCAGCAAGGTAAGGGGGACTAGCGGGAGGGTAGCCTACGAGCAGTACTTC	CASKVRGTSGRVAYEQYF	TRBV13	TRBJ2-7
TGCAGTGCCGGGACAGGGACTAATTACACTGAAGCTTTCTTT	CSAGTGTNYTEAFF	TRBV20-1	TRBJ1-1
TGTGCCAGCAGGTTCCGGGGGCACGAGACCCAGTACTTC	CASRFRGHETQYF	TRBV27	TRBJ2-5
TGCGCCAGCAGTGAGTTCTGGGACAACTATGGCTACACCTTC	CASSEFWDNYGYTF	TRBV10-1	TRBJ1-2
TGCAGTGCCCCAGGGGGGGTGGAATACTATGGCTACACCTTC	CSAPGGVEYYGYTF	TRBV20-1	TRBJ1-2
TGTGCCAGTAACCCCAGAAGGCAGTACACTGAAGCTTTCTTT	CASNPRRQYTEAFF	TRBV19	TRBJ1-1
TGTGCCAGTAGTAGGACAGGGGAAGCGACTGGCTACACCTTC	CASSRTGEATGYTF	TRBV19	TRBJ1-2
TGTGCCAGCAGTTACTCGATAGGAGACAGGGGGCACACTGAAGCTTTCTTT	CASSYSIGDRGHTEAFF	TRBV6-5	TRBJ1-1
TGTGCCTGGTTGCGGGAGTATCGGGCCTACGAGCAGTACTTC	CAWLREYRAYEQYF	TRBV24-1	TRBJ2-7
TGCGCCAGCAGCAATATCCGCGGGGGCCACTCCTACGAGCAGTACTTC	CASSNIRGGHSYEQYF	TRBV4-1	TRBJ2-7
TGTGCCAGCAGCTTATCGAACGGGGGCAATGAGCAGTTCTTC	CASSLSNGGNEQFF	TRBV7-9	TRBJ2-1
TGTGCCAGCAGCTTCTCCCGGGACAGGAGCTCTGGAAACACCATATATTTT	CASSFSRDRSSGNTIYF	TRBV11-2	TRBJ1-3
TGTGCCAGCAGCAGGAGGGCCCGTAGCTCTGGGGCCAACGTCCTGACTTTC	CASSRRARSSGANVLTF	TRBV11-2	TRBJ2-6
TGTGCCAGCAGCCAAGCTCAGAATGAGCAGTTCTTC	CASSQAQNEQFF	TRBV3-1	TRBJ2-1
TGTGCCAGCAGTACCTGGAACTCTGGAAACACCATATATTTT	CASSTWNSGNTIYF	TRBV6-5	TRBJ1-3
TGCAGTGCTAGAGATCTGGCCCCCGGGGTACTGAACACTGAAGCTTTCTTT	CSARDLAPGVLNTEAFF	TRBV20-1	TRBJ1-1
TGTGCCAGCAGTTCTAGGACAGGGCGGACCTATCAGCCCCAGCATTTT	CASSSRTGRTYQPQHF	TRBV12-3	TRBJ1-5
TGTGCCAGCAGCAGGGGACACGGGTCCTCCTACGAGCAGTACTTC	CASSRGHGSSYEQYF	TRBV13	TRBJ2-7
TGCGCCAGCAGCCAAGACGTACAGGGAGTTCAGGGCCGGGATACGCAGTATTTT	CASSQDVQGVQGRDTQYF	TRBV4-1	TRBJ2-3
TGTGCCACCAGCAGCTTGGGGGGTAGCACAGATACGCAGTATTTT	CATSSLGGSTDTQYF	TRBV15	TRBJ2-3
TGTGCCACCAGCAGTATAGGTATAGGGGGTACGCAGTATTTT	CATSSIGIGGTQYF	TRBV15	TRBJ2-3
TGTGCCAGCAGCTTTCCAGGGGTCGGGAAGCAGTACTTC	CASSFPGVGKQYF	TRBV5-5	TRBJ2-7
TGTGCCAGCAGCACGGGCGTAAGCAACGGCTATCAGCCCCAGCATTTT	CASSTGVSNGYQPQHF	TRBV6-2	TRBJ1-5
TGTGCCAGCAGTTACCGAACCGTCCGGGACAGTAATGAAAAACTGTTTTTT	CASSYRTVRDSNEKLFF	TRBV6-5	TRBJ1-4
TGTGCCAGCAGCTTAGATAGGCCATTTGGACTTGGACTAGGACTGTTAAGGGCGCAAGAGACCCAGTACTTC	CASSLDRPFGLGLGLLRAQETQYF	TRBV11-3	TRBJ2-5
TGTGCCAGAGGGACTAGCGGGGTCTACGAGCAGTACTTC	CARGTSGVYEQYF	TRBV6-5	TRBJ2-7
TGCGCCAGCGGGGACAGGGGATTCTACGAGCAGTACTTC	CASGDRGFYEQYF	TRBV10-1	TRBJ2-7
TGTGCCACCGCTCGGGCTGAAGCTTTCTTT	CATARAEAFF	TRBV3-1	TRBJ1-1
TGTGCCAGCAGCTCTATATGTGAGCGGGACGGTTATGGCTACACCTTC	CASSSICERDGYGYTF	TRBV11-2	TRBJ1-2
TGCAGTGCTAGAGTTTCTACTAGCGGGAGGCCTAACACTGAAGCTTTCTTT	CSARVSTSGRPNTEAFF	TRBV20-1	TRBJ1-1
TGTGCCACCAGAACAGTTTGCCAGGTTAGCGGGGATCACAATGAGCAGTTCTTC	CATRTVCQVSGDHNEQFF	TRBV15	TRBJ2-1
TGTGCCAGGACAAGCGGCTCCTACGAGCAGTACTTC	CARTSGSYEQYF	TRBV7-9	TRBJ2-7
TGCGCCAGCAGCTTGGCCCTAGATCAGCCCCAGCATTTT	CASSLALDQPQHF	TRBV5-1	TRBJ1-5
TGTGCCAGCAGTGACGACTGCGGTCAGCCCCAGCATTTT	CASSDDCGQPQHF	TRBV6-4	TRBJ1-5
TGCAGCGTTCGTACCAGGGACTCTGGAAACACCATATATTTT	CSVRTRDSGNTIYF	TRBV29-1	TRBJ1-3
TGCGCCAGCAGCCAAAACCGCGGGGGGCGGGTGGTGAACACTGAAGCTTTCTTT	CASSQNRGGRVVNTEAFF	TRBV4-3	TRBJ1-1
TGTGCCAGCAGTTTATGTGATAGGGGGCACCAGAGCTATGGCTACACCTTC	CASSLCDRGHQSYGYTF	TRBV12-3	TRBJ1-2
TGTGCCAGCAGCTTTTTCGGCCGTGAAGCTTTCTTT	CASSFFGREAFF	TRBV5-4	TRBJ1-1
TGTGCCAGCAGGAGGTCCCTAGCGGGACAGTCCGGGGAGCTGTTTTTT	CASRRSLAGQSGELFF	TRBV7-3	TRBJ2-2
TGCAGTGCTCAGAGTCCGACCGGGGTAGGCAATCAGCCCCAGCATTTT	CSAQSPTGVGNQPQHF	TRBV20-1	TRBJ1-5
TGTGCCAGCAGCTTAGACAGGGGCGAGCAGTACTTC	CASSLDRGEQYF	TRBV7-2	TRBJ2-7
TGTGCCAGCAAGGGCAGGGCCGGGGAGCTGTTTTTT	CASKGRAGELFF	TRBV6-5	TRBJ2-2
TGTGCCAGCAGCCAAGATGTTGGTTACATTCAGTACTTC	CASSQDVGYIQYF	TRBV4-2	TRBJ2-4
TGTGCCAGCATCCAGACAGGAGAGACCCAGTACTTC	CASIQTGETQYF	TRBV27	TRBJ2-5
TGCGCCAGCAGCCAAACCGTTCGGGGTTTTTTTACCTATGGCTACACCTTC	CASSQTVRGFFTYGYTF	TRBV4-1	TRBJ1-2
TGCGCCAGCAGCCCGTATGACAGCGGGACTGTGGGCAATCAGCCCCAGCATTTT	CASSPYDSGTVGNQPQHF	TRBV5-1	TRBJ1-5
TGTGCCACCAATAAACCTATTGACGATACGCAGTATTTT	CATNKPIDDTQYF	TRBV24-1	TRBJ2-3
TGCAGTGCTAGAGATCCCGGGTGGGCCGATGAGCAGTTCTTC	CSARDPGWADEQFF	TRBV20-1	TRBJ2-1
