TGTGCCAGTAGTATGTTAATCCGCGCTAGCGGGAGTTCCTACGAGCAGTACTTC	CASSMLIRASGSSYEQYF	TRBV19	TRBJ2-7
TGCAGTGCGCGCGCAAATAGGAACACTGAAGCTTTCTTT	CSARANRNTEAFF	TRBV20-1	TRBJ1-1
TGTGCCACCGTCCACTCCTTGGGACAGGGCCCCGGGGAGCTGTTTTTT	CATVHSLGQGPGELFF	TRBV15	TRBJ2-2
TGTGCCAGCATAACGACTAGCGGGTCATACAATGAGCAGTTCTTC	CASITTSGSYNEQFF	TRBV7-9	TRBJ2-1
TGTGCCAGCAGGGGGGAGGGAGTTTACAATGAGCAGTTCTTC	CASRGEGVYNEQFF	TRBV5-8	TRBJ2-1
TGTGCCAGCATGGCTACCGAAGGTAATAGGAGAAATAGGTCCTATAATTCACCCCTCCACTTT	CASMATEGNRRNRSYNSPLHF	TRBV6-6	TRBJ1-6
TGTGCTAGTGCCCAACAGGGGGGAGGAACTGAAGCTTTCTTT	CASAQQGGGTEAFF	TRBV12-5	TRBJ1-1
TGTGCCAGCAGCGCCGCTACGGAGACCTACGAGCAGTACTTC	CASSAATETYEQYF	TRBV7-9	TRBJ2-7
TGTGCCAGCAGACAGTATGGCTACACCTTC	CASRQYGYTF	TRBV7-4	TRBJ1-2
TGCGCCAGCAGTGAGTCGGCCGAACAAACTGAGCAGTACTTC	CASSESAEQTEQYF	TRBV10-1	TRBJ2-7
TGTGCCAGCAGCTTCACAGGGACTAGCGGCTACGAGCAGTACTTC	CASSFTGTSGYEQYF	TRBV7-6	TRBJ2-7
TGTGCCAGCAGCTTAGCGATGACCGAACCGGCCCTAGGTGAGTACAATGAGCAGTTCTTC	CASSLAMTEPALGEYNEQFF	TRBV7-9	TRBJ2-1
TGCGCCAGCAGGGGGCCGGGACATCGGGGCAATCAGCCCCAGCATTTT	CASRGPGHRGNQPQHF	TRBV10-1	TRBJ1-5
TGTGCCACCCCGGGGCGTTATGAGCAGTTCTTC	CATPGRYEQFF	TRBV2	TRBJ2-1
TGCAGTGCTAGAGCCAGGGGCAATTACGAGCAGTACTTC	CSARARGNYEQYF	TRBV20-1	TRBJ2-7
TGTGCCAGCTCACAGGACACACACAATGAGCAGTTCTTC	CASSQDTHNEQFF	TRBV18	TRBJ2-1
TGTGCCAGCAGAAGGGACCACCCAGGGGCGGGGGGCTACGAGCAGTACTTC	CASRRDHPGAGGYEQYF	TRBV5-6	TRBJ2-7
TGTGCCAGCATCAGAGGCTACGAGCAGTACTTC	CASIRGYEQYF	TRBV7-6	TRBJ2-7
TGTGCCAGCAGCCCGGGACAGGGGCTCCTCTATGGCTACACCTTC	CASSPGQGLLYGYTF	TRBV5-6	TRBJ1-2
TGTGCCAGCGATAACAGAAGCTCCTACGAGCAGTACTTC	CASDNRSSYEQYF	TRBV9	TRBJ2-7
TGTGCCAGCAGCACGGGATCCCCCGAGTTTTGTGTAACCCCCACAGATACGCAGTATTTT	CASSTGSPEFCVTPTDTQYF	TRBV7-3	TRBJ2-3
TGTGCCAGCAGCTTACGGACAGGGGCCCAAGAGACCCAGTACTTC	CASSLRTGAQETQYF	TRBV7-7	TRBJ2-5
TGCGCCAGCAGCTCCCACCTTAGCAGGAACACTGAAGCTTTCTTT	CASSSHLSRNTEAFF	TRBV5-1	TRBJ1-1
TGCGCCAGCAGCCTTCCAAAATGTTCAGGGGACTATGGCTACACCTTC	CASSLPKCSGDYGYTF	TRBV5-1	TRBJ1-2
TGTGCCAGCAGGGCACAGGCGGACGGGAGCTCCTACGAGCAGTACTTC	CASRAQADGSSYEQYF	TRBV5-4	TRBJ2-7
TGTGCCAGCAGCGCTTACCAGAATGAGCAGTTCTTC	CASSAYQNEQFF	TRBV6-5	TRBJ2-1
TGTGCCAGCAGCCTCGTTGGACAGACAGGAAACACCATATATTTT	CASSLVGQTGNTIYF	TRBV14	TRBJ1-3
TGCAGTGCTAGAGAGCGGGGAGAGACCCAGTACTTC	CSARERGETQYF	TRBV20-1	TRBJ2-5
TGTGCCAGTAAAGCACAGTCATCAGGGGCAGGTGTGCAGCCCCAGCATTTT	CASKAQSSGAGVQPQHF	TRBV19	TRBJ1-5
TGTGCCAGCAGCCAATCGGTGCGGGAGACGAATGAGCAGTTCTTC	CASSQSVRETNEQFF	TRBV16	TRBJ2-1
TGTGCCAGCAGCTTCCGCCGGGACAGGGGTTCAGCTTTCTTT	CASSFRRDRGSAFF	TRBV5-6	TRBJ1-1
TGTGCCAGCAGTCTGGACGGAGCGAGTAGCGGGGCCAGGCTGAGCTCCTACAATGAGCAGTTCTTC	CASSLDGASSGARLSSYNEQFF	TRBV12-3	TRBJ2-1
TGCGCCAGCGTTCAGGGGGCGCTAGGAAACACCATATATTTT	CASVQGALGNTIYF	TRBV10-1	TRBJ1-3
TGCAGTGCTAGGTACCCGGGACAGGGGTCGGCTATTGACGAGCAGTACTTC	CSARYPGQGSAIDEQYF	TRBV20-1	TRBJ2-7
TGCGCCAGCAGCCAAGAGACAGGGCTGGGTCAGCCCCAGCATTTT	CASSQETGLGQPQHF	TRBV4-1	TRBJ1-5
TGTGCCACCAGTGATTTAAATGGACAGGCTTATGGCTACACCTTC	CATSDLNGQAYGYTF	TRBV24-1	TRBJ1-2
TGCAAAAGGGGGCTAGGATCTGGGGCCAACGTCCTGACTTTC	CKRGLGSGANVLTF	TRBV29-1	TRBJ2-6
TGTGCCAGCAGCTTCACAGCCCCTGTACAGGGAGACTCTGGAAACACCATATATTTT	CASSFTAPVQGDSGNTIYF	TRBV5-6	TRBJ1-3
TGTGCCAGCAGCTATGGGGGAGCATTTGGCGAGCAGTACTTC	CASSYGGAFGEQYF	TRBV5-4	TRBJ2-7
TGCAGTGCTAGAGCGCTACGATCCTACAATGAGCAGTTCTTC	CSARALRSYNEQFF	TRBV20-1	TRBJ2-1
TGTGCCAGCAGCTTGGCCCAAGGGACAGGGGAGAACACTGAAGCTTTCTTT	CASSLAQGTGENTEAFF	TRBV5-5	TRBJ1-1
TGCGCCAGCTGCGGACCAGGTCATGAAAAACTGTTTTTT	CASCGPGHEKLFF	TRBV10-1	TRBJ1-4
TGTGCCAGCAGCTTCCTCTACGCCGGGACCACAGATACGCAGTATTTT	CASSFLYAGTTDTQYF	TRBV7-6	TRBJ2-3
TGTGCCAGCAGCTCGCCCGGAGGTCCCGTTAAAACCAACACTGAAGCTTTCTTT	CASSSPGGPVKTNTEAFF	TRBV7-3	TRBJ1-1
TGTGCCAGCAGCAGCGGGAAATTGGAGCAGTACTTC	CASSSGKLEQYF	TRBV7-3	TRBJ2-7
TGTGCCAGCAGCTGCTGCCCACCGGGACAGGGCCCTCCATACAATGAGCAGTTCTTC	CASSCCPPGQGPPYNEQFF	TRBV7-7	TRBJ2-1
TGTGCCAGAACAATAACAGGACAGGGCGGAGCTCCAAATGGCTACACCTTC	CARTITGQGGAPNGYTF	TRBV6-4	TRBJ1-2
TGTGCCAGCAGCGTACTCTGCACAGATACGCAGTATTTT	CASSVLCTDTQYF	TRBV9	TRBJ2-3
TGTGCCTGGAGTGTAGGACCTAGCCCTTACAATGAGCAGTTCTTC	CAWSVGPSPYNEQFF	TRBV30	TRBJ2-1
TGTGCCAGCAGTATTGGGGAGAGTAGCAATCAGCCCCAGCATTTT	CASSIGESSNQPQHF	TRBV5-4	TRBJ1-5
TGCGCCAGCAGCTTGCGCTGGCGACTATACGGGAATGAGCAGTTCTTC	CASSLRWRLYGNEQFF	TRBV5-1	TRBJ2-1
TGTGCCACCAGTGATTTGCCATACATTCCCAGGGGGGGAGTCTACAATGAGCAGTTCTTC	CATSDLPYIPRGGVYNEQFF	TRBV24-1	TRBJ2-1
TGTGCCAGCAGCCGTCGACAGGTACTATCTAGCACAGATACGCAGTATTTT	CASSRRQVLSSTDTQYF	TRBV14	TRBJ2-3
TGTGCCAGCAGCCAAGAACGATTCCCGTTCGGGACAGGCTACACCTTC	CASSQERFPFGTGYTF	TRBV14	TRBJ1-2
TGTGCCAGCCCTTCGTGGGCTCCCTACGAGCAGTACTTC	CASPSWAPYEQYF	TRBV25-1	TRBJ2-7
TGTGCCAGCAGTGGTCCGTACAGGGCTCGCCATGGCTACACCTTC	CASSGPYRARHGYTF	TRBV2	TRBJ1-2
TGCGCCAGCAGTAGACAGGGGGCCTTC	CASSRQGAF	TRBV10-1	TRBJ2-7
TGTGCCATTTCCGGGTTTGTGGGGTTAAGGCTAATTTACTACGAGCAGTACTTC	CAISGFVGLRLIYYEQYF	TRBV6-6	TRBJ2-7
TGTGCCAGCAGCACCTTTCCCACCAAAGGCCGGTATGGCTACACCTTC	CASSTFPTKGRYGYTF	TRBV11-2	TRBJ1-2
TGTGCCAGCAGTTACACCTATAGCCAGTCCTACGAGCAGTACTTC	CASSYTYSQSYEQYF	TRBV6-2	TRBJ2-7
TGCAGCGTTGAAGAACAGGGACAGGGGACCTCCTACGAGCAGTACTTC	CSVEEQGQGTSYEQYF	TRBV29-1	TRBJ2-7
TGTGCCAGCAGTTACTCGATGGACCCTGAAGCTTTCTTT	CASSYSMDPEAFF	TRBV6-5	TRBJ1-1
TGTGCCAGCAGAGTGAAGAGGGAAACTAATGAAAAACTGTTTTTT	CASRVKRETNEKLFF	TRBV28	TRBJ1-4
TGTGCCAGCAGTGAGTTTGCCAACCTCGAACCGGGACTAGCCTTCGAGCAGTACTTC	CASSEFANLEPGLAFEQYF	TRBV6-4	TRBJ2-7
TGTGCTAGTGGTCCTCCAAGGGGCGATGGGTGCAATCAGCCCCAGCATTTT	CASGPPRGDGCNQPQHF	TRBV12-5	TRBJ1-5
TGTGCCAGCAGAACTCCAGGTGAGGATAATTCACCCCTCCACTTT	CASRTPGEDNSPLHF	TRBV6-5	TRBJ1-6
TGTGCCAGTCCGGACGAAACCTACGAGCAGTACTTC	CASPDETYEQYF	TRBV27	TRBJ2-7
TGCGCCAGCAGCAACTGCGATCATGAGCAGTTCTTC	CASSNCDHEQFF	TRBV5-1	TRBJ2-1
TGTGCCAGCTCACCATGGGGGCGCCAAGAGACCCAGTACTTC	CASSPWGRQETQYF	TRBV18	TRBJ2-5
TGTGCCAGCAGTTTGGGACAGGGCTGCTCCTATAGCAATCAGCCCCAGCATTTT	CASSLGQGCSYSNQPQHF	TRBV12-3	TRBJ1-5
TGTGCCAGCAGCGTAGCCCCGAGAGGGCGCTTT	CASSVAPRGRF	TRBV9	TRBJ1-1
TGTGCCAGCATCGTTCCGAGGGTCAAATACCAAGAGACCCAGTACTTC	CASIVPRVKYQETQYF	TRBV6-4	TRBJ2-5
TGCAGTGCTCAATCCCACGGTCGGGGTGGCTACACCTTC	CSAQSHGRGGYTF	TRBV20-1	TRBJ1-2
TGCAGTGCTAGCCGGGACACATGGGATTCACCCCTCCACTTT	CSASRDTWDSPLHF	TRBV20-1	TRBJ1-6
TGTGCCAGCAGCGACAGGGGATGCCACTATGGCTACACCTTC	CASSDRGCHYGYTF	TRBV9	TRBJ1-2
TGTGCCAGCAGTGGAAGTCCCGGGACAGGGGGCATTACCGGGGAGCTGTTTTTT	CASSGSPGTGGITGELFF	TRBV12-4	TRBJ2-2
TGTGCCAGCCTACTTGAGGGGTCTGAAAAACTGTTTTTT	CASLLEGSEKLFF	TRBV27	TRBJ1-4
TGTGCCAGCAGTTTCCCCCGACCTAGCGGGTTGTCAGATACGCAGTATTTT	CASSFPRPSGLSDTQYF	TRBV28	TRBJ2-3
TGTGCCTGCGGAACAGGGTCTACATATGGCTACACCTTC	CACGTGSTYGYTF	TRBV30	TRBJ1-2
TGCGCCAGCAGCTGCCGGAGGGGCTACGAGCAGTACTTC	CASSCRRGYEQYF	TRBV5-1	TRBJ2-7
TGTGCCACCCGTACAGGGGGTTATAACCATCGCACCGGGGAGCTGTTTTTT	CATRTGGYNHRTGELFF	TRBV3-1	TRBJ2-2
TGTGCCAGCAGCAGTGACAGAACGGGGGAACGAGAGACCCAGTACTTC	CASSSDRTGERETQYF	TRBV11-1	TRBJ2-5
TGTCCCAAACATAACCATGGGGAGACCCAGTACTTC	CPKHNHGETQYF	TRBV7-9	TRBJ2-5
TGCGCCAGCAGCCAAGATCAGGGGGCTGAAAAACTGTTTTTT	CASSQDQGAEKLFF	TRBV4-1	TRBJ1-4
TGTGCCACCAGTGATTTGGAAGTGGCCTCCCGGGAGGTGGGAAACACCATATATTTT	CATSDLEVASREVGNTIYF	TRBV24-1	TRBJ1-3
TGCGCCAGCAGTGGGGACAGGGCGGTACCCTGCGTTTATGGCTACACCTTC	CASSGDRAVPCVYGYTF	TRBV10-1	TRBJ1-2
TGTGCCCCTCCGTACCATAGCCAGCCCGGTGAAAAACTGTTTTTT	CAPPYHSQPGEKLFF	TRBV11-2	TRBJ1-4
TGTGCCAGCAGTTTATGGGCAGGGGGGGACCAGCCCCAGCATTTT	CASSLWAGGDQPQHF	TRBV28	TRBJ1-5
TGTGCCAGCAGCCGGGACAGGGGGGTGAGCAATCAGCCCCAGCATTTT	CASSRDRGVSNQPQHF	TRBV7-8	TRBJ1-5
TGCATATCGCCAGCGGGACAGGGGGGGGGAAATGAGCAGTTCTTC	CISPAGQGGGNEQFF	TRBV10-1	TRBJ2-1
TGTGCCAGCAGTTACTCCCCGGGGGGGGAGCAGTACTTC	CASSYSPGGEQYF	TRBV6-5	TRBJ2-7
TGTGCCAGCAGTTCCGGCGAGGGCGGGGGATACAATGAGCAGTTCTTC	CASSSGEGGGYNEQFF	TRBV6-9	TRBJ2-1
TGTGCCAGCAGTGACATTAGACTAGCGACCGACACCGGGGAGCTGTTTTTT	CASSDIRLATDTGELFF	TRBV6-4	TRBJ2-2
TGCGCCAGCAGCCATCCAGACAGGGTAGCCAAAAACATTCAGTACTTC	CASSHPDRVAKNIQYF	TRBV5-1	TRBJ2-4
TGTGCCAGCAGCTTAGCGCTTCGGGAGGGGCCCTACGAGCAGTACTTC	CASSLALREGPYEQYF	TRBV11-2	TRBJ2-7
TGCAGTGCTAGACAGGCAGCGGGAGGGGTGGCAGGCACTGAAGCTTTCTTT	CSARQAAGGVAGTEAFF	TRBV20-1	TRBJ1-1
TGTGCCAGCAGCTTAGATATAAGCGGGGGGAACGAGCAGTACTTC	CASSLDISGGNEQYF	TRBV11-1	TRBJ2-7
TGTGCCAGCACCCGACTAGGTACGGGGTCTAGCACAGATACGCAGTATTTT	CASTRLGTGSSTDTQYF	TRBV2	TRBJ2-3
TGTGCCAGCAGTGGGGGCGTAGCGGGATCGAACACTGAAGCTTTCTTT	CASSGGVAGSNTEAFF	TRBV6-5	TRBJ1-1
TGTGCCAGCAGCTGTCTGGGGGCCCGCACAGATACGCAGTATTTT	CASSCLGARTDTQYF	TRBV5-6	TRBJ2-3
