TGTGCCAGCAGCCAACGTGTTGGACAAGCGTTAAAGTCTGGAAACACCATATATTTT	CASSQRVGQALKSGNTIYF	TRBV5-4	TRBJ1-3
TGTGCCAGCAGTAGGCACTACGAGCAGTACTTC	CASSRHYEQYF	TRBV7-9	TRBJ2-7
TGTGCCAGCTCCCGATACGAGGGTGAGACCCAGTACTTC	CASSRYEGETQYF	TRBV18	TRBJ2-5
TGTGCCAGCAGTTGGGGGGGCCGACGCGGTGACTACGAGCAGTACTTC	CASSWGGRRGDYEQYF	TRBV6-2	TRBJ2-7
TGTGCCAGCAGTTGGGGTAGCGGGTCCTACAATGAGCAGTTCTTC	CASSWGSGSYNEQFF	TRBV6-5	TRBJ2-1
TGCAGCGTTGAAGCTAGAGCCTACAATGAGCAGTTCTTC	CSVEARAYNEQFF	TRBV29-1	TRBJ2-1
TGTGCCAGCGTACCCTTGGGGGGGCTTTTCAGAGCCAAAAACATTCAGTACTTC	CASVPLGGLFRAKNIQYF	TRBV5-6	TRBJ2-4
TGCGCCAGCAGCACTACAGGGGAAGGAAACTATGGCTACACCTTC	CASSTTGEGNYGYTF	TRBV5-1	TRBJ1-2
TGTGCCAGCAGTTTAATCCGTTTTCGGGGACAGGGGGGGCGGCAGTACTTC	CASSLIRFRGQGGRQYF	TRBV28	TRBJ2-7
TGTGCCATCAGTTCCCCGGGAGTCTCTGGAAACACCATATATTTT	CAISSPGVSGNTIYF	TRBV10-3	TRBJ1-3
TGCAGTGCTAGCCCGACGGGCCCTGAAAACATTCAGTACTTC	CSASPTGPENIQYF	TRBV20-1	TRBJ2-4
TGTGCCAGCAGCGGACTAGCGGGGAGAGAGACCCAGTACTTC	CASSGLAGRETQYF	TRBV11-2	TRBJ2-5
TGTGCCAGCAGTGAAGGGGGTATCCAGGGGCTATACGAGCAGTACTTC	CASSEGGIQGLYEQYF	TRBV2	TRBJ2-7
TGTGCCAGCAGTTACTCGAGGGGTAGACTAGGTCTAGAGACCCAGTACTTC	CASSYSRGRLGLETQYF	TRBV6-6	TRBJ2-5
TGTGCCCCTCCGATGACTAGCGCAGATACGCAGTATTTT	CAPPMTSADTQYF	TRBV30	TRBJ2-3
TGTGCCGTTAAAACGGGACTAGCGGGTGCCTACAATGAGCAGTTCTTC	CAVKTGLAGAYNEQFF	TRBV7-7	TRBJ2-1
TGCGCCAGCAGCCAAGATGTCCCCACAGACACTGAAGCTTTCTTT	CASSQDVPTDTEAFF	TRBV4-1	TRBJ1-1
TGTGCCAGCAGTCCCGGGCGGGATCGCACAGATACGCAGTATTTT	CASSPGRDRTDTQYF	TRBV6-3	TRBJ2-3
TGTGCCAGCAGTTACGGGGCACAGACCCAGTACTTC	CASSYGAQTQYF	TRBV27	TRBJ2-5
TGTGCCAGCAGCTTAGTCAACGCTGGGACCCAGTACTTC	CASSLVNAGTQYF	TRBV7-3	TRBJ2-5
TGTGCCAGCAGCGGACAGGGTAATTTGACTGAAGCTTTCTTT	CASSGQGNLTEAFF	TRBV5-6	TRBJ1-1
TGTGCCAGCAGTTCAGGGGGCAGCGAGCAGTACTTC	CASSSGGSEQYF	TRBV6-5	TRBJ2-7
TGCAGTGCTTACGGCGGGAGACAATGGGGGCCAACTAATGAAAAACTGTTTTTT	CSAYGGRQWGPTNEKLFF	TRBV20-1	TRBJ1-4
TGTGCCAGCAGCGTTAGTCCCAATCAGGGCGCTGGAAACACCATATATTTT	CASSVSPNQGAGNTIYF	TRBV13	TRBJ1-3
TGTGCCAGCAGCTTAGAAAGGGGTATGAACACTGAAGCTTTCTTT	CASSLERGMNTEAFF	TRBV7-9	TRBJ1-1
TGCGCCAGCAGCTTGATGAAGGGGGCACAAACCTACGAGCAGTACTTC	CASSLMKGAQTYEQYF	TRBV5-1	TRBJ2-7
TGTGCCAGCAGTTTGGTCCCGGGACAGGGGACCATGAACACTGAAGCTTTCTTT	CASSLVPGQGTMNTEAFF	TRBV27	TRBJ1-1
TGCAGTGCTGACCCCCGGGACATTGACCACGTGAGCGCGAACACCGGGGAGCTGTTTTTT	CSADPRDIDHVSANTGELFF	TRBV20-1	TRBJ2-2
TGTGCCAGCAGGGCGGCCTCGCCGCAGCCCCAGCATTTT	CASRAASPQPQHF	TRBV6-4	TRBJ1-5
TGTGCCAGCAGCACTACGGGACAATCTTGTGCAGATACGCAGTATTTT	CASSTTGQSCADTQYF	TRBV11-3	TRBJ2-3
TGTGCCAGCAGTTTTGGGAATCATGAATATGAGCAGTTCTTC	CASSFGNHEYEQFF	TRBV12-4	TRBJ2-1
TGTGCCAGCCTGGACAGAGCTAACTATGGCTACACCTTC	CASLDRANYGYTF	TRBV7-8	TRBJ1-2
TGTGCCAGCAGTGACGGGGTTGACACAGATACGCAGTATTTT	CASSDGVDTDTQYF	TRBV2	TRBJ2-3
TGTGCCAGTAGTATACCACAGGGGGTTGGTTATTCACCCCTCCACTTT	CASSIPQGVGYSPLHF	TRBV19	TRBJ1-6
TGTGCCAGCAGGGCGCAGCGGAAAGGGCAGTACTTC	CASRAQRKGQYF	TRBV6-4	TRBJ2-7
TGTGCCAGCAGCTTGCAGACCGGGGAGCTGTTTTTT	CASSLQTGELFF	TRBV9	TRBJ2-2
TGTGCCATCACTGGGACTAGCGGGGATACGCAGTATTTT	CAITGTSGDTQYF	TRBV10-3	TRBJ2-3
TGCGCCAGCAAACCGAGGCACAGGCGCCGGAACACTGAAGCTTTCTTT	CASKPRHRRRNTEAFF	TRBV10-2	TRBJ1-1
TGTGCCAGCCACTTGCCCAGGGGGCGCCGTCGGATCACTGAAGCTTTCTTT	CASHLPRGRRRITEAFF	TRBV6-5	TRBJ1-1
TGTGCCAGCAGCTTGAATCCCGGGGGGGGCTACAATGAGCAGTTCTTC	CASSLNPGGGYNEQFF	TRBV5-5	TRBJ2-1
TGTGCCAGCAGCCACGGACAGGGGGCTAGGCACACTGAAGCTTTCTTT	CASSHGQGARHTEAFF	TRBV14	TRBJ1-1
TGTGCCAGCAGTTCGGACAGGGGTGCCTATGGCTACACCTTC	CASSSDRGAYGYTF	TRBV3-1	TRBJ1-2
TGCAGCCCCGACAGGGGGCAGGATAGCTCTGGAAACACCATATATTTT	CSPDRGQDSSGNTIYF	TRBV29-1	TRBJ1-3
TGTGCCAGCAGCAGACCTCCACCTCACACTGAAGCTTTCTTT	CASSRPPPHTEAFF	TRBV13	TRBJ1-1
TGTGCCAGCAGTAAAGGGACTAGACTAACCGGGGAGCTGTTTTTT	CASSKGTRLTGELFF	TRBV12-4	TRBJ2-2
TGTGCCAGCAGCAGTCCAAACCAGGGCCATGCTGGACGGAATGAGCAGTTCTTC	CASSSPNQGHAGRNEQFF	TRBV7-4	TRBJ2-1
TGCAGTGCTAGCCAGCGATCGTACGAGCAGTACTTC	CSASQRSYEQYF	TRBV20-1	TRBJ2-7
TGTGCCACCGGCCTGGACAGTGAATGGTCCTACGAGCAGTACTTC	CATGLDSEWSYEQYF	TRBV24-1	TRBJ2-7
TGTGCCAGCAGCGTAGGCAAAGAGGGGGGAAAGAAGTGTGGCACAGATACGCAGTATTTT	CASSVGKEGGKKCGTDTQYF	TRBV9	TRBJ2-3
TGCGCCAGGTACATTGGGGGGGGGTACACTGAAGCTTTCTTT	CARYIGGGYTEAFF	TRBV5-1	TRBJ1-1
TGTGCCAGCAGCCAGGGACAGGGTAGGGCCTACGAGCAGTACTTC	CASSQGQGRAYEQYF	TRBV28	TRBJ2-7
TGCAGTGCTATTGATTCCGGAAAGGGCCCCTACGAGCAGTACTTC	CSAIDSGKGPYEQYF	TRBV20-1	TRBJ2-7
TGCAGTGCTCCTTGGGAGGAAAAACTGTTTTTT	CSAPWEEKLFF	TRBV20-1	TRBJ1-4
TGCAGTGCCCGGGACAACTTGAACACTGAAGCTTTCTTT	CSARDNLNTEAFF	TRBV20-1	TRBJ1-1
TGTGCCAGCAGCGCCCGGGACCCTCCTCACAGCAATCAGCCCCAGCATTTT	CASSARDPPHSNQPQHF	TRBV9	TRBJ1-5
TGTGCCAGTAGTAGAAAAGGGGGGGCCCCCACAGATACGCAGTATTTT	CASSRKGGAPTDTQYF	TRBV19	TRBJ2-3
TGTGCCAGCGACTCCGCGTACCGGGACGTCTCCTACGAGCAGTACTTC	CASDSAYRDVSYEQYF	TRBV9	TRBJ2-7
TGCAGTGCTAGAGATCGGCCCCGTGACAGGTTTCTTAACACCGGGGAGCTGTTTTTT	CSARDRPRDRFLNTGELFF	TRBV20-1	TRBJ2-2
TGTGCCAGCAGTTTATTCCTTTGGAGCACAGATACGCAGTATTTT	CASSLFLWSTDTQYF	TRBV27	TRBJ2-3
TGTGCCAGCAAACGCGGGAGGAGGTCCTACGAGCAGTACTTC	CASKRGRRSYEQYF	TRBV6-1	TRBJ2-7
TGTGCCAGCAGCTTAATCCTACAGCGGGATCTCGAGAGCGGAGAGACCCAGTACTTC	CASSLILQRDLESGETQYF	TRBV7-4	TRBJ2-5
TGTGCCATACGGGGGTGTGAGCAGTTCTTC	CAIRGCEQFF	TRBV10-3	TRBJ2-1
TGCGCCAGCAGCCCTCTGGGGACAGGGGGGCATCACTATGGCTACACCTTC	CASSPLGTGGHHYGYTF	TRBV4-1	TRBJ1-2
TGCAGCCCGGGAGAGCAGTACTTC	CSPGEQYF	TRBV29-1	TRBJ2-7
TGTGCCAGCAGCCCCGATTACACCCAACGAGTTGCCACTGAAGCTTTCTTT	CASSPDYTQRVATEAFF	TRBV27	TRBJ1-1
TGTGCCAGCAGCTTAGGAAGGACTAGCGGGGGGGGGAATACCGTCCAAGAGACCCAGTACTTC	CASSLGRTSGGGNTVQETQYF	TRBV11-3	TRBJ2-5
TGTGCCAGCAGCCCAAGGGCGCGTATCAAATACGAGCAGTACTTC	CASSPRARIKYEQYF	TRBV7-9	TRBJ2-7
TGCAGTGCGGATGGTGGGGACAGTGAGCAGTTCTTC	CSADGGDSEQFF	TRBV20-1	TRBJ2-1
TGCAGCGTTGACTCGGGGGTCGTCCGCAATCAGCCCCAGCATTTT	CSVDSGVVRNQPQHF	TRBV29-1	TRBJ1-5
TGTGCCAAAACGCCGGGACAGTTGAAACAGATCTTGAGCTCCTACGAGCAGTACTTC	CAKTPGQLKQILSSYEQYF	TRBV6-3	TRBJ2-7
TGTGCCAGCAGCTCACAGGTAAAATACGAGCAGTACTTC	CASSSQVKYEQYF	TRBV7-9	TRBJ2-7
TGTGCCAGCAGCTTAGAGCGGTCACCGGGACTAGCGGGAGTAAGGCGAACTTGTGCCGGGGAGCTGTTTTTT	CASSLERSPGLAGVRRTCAGELFF	TRBV5-4	TRBJ2-2
TGTGCTACTGTCTTAGTCTTGTCGTGGGGAGTCAACACAGATACGCAGTATTTT	CATVLVLSWGVNTDTQYF	TRBV12-5	TRBJ2-3
TGTGCCAGCAGCGCCCAAGACAGGGGTTCCTTGAGCTCCTACAATGAGCAGTTCTTC	CASSAQDRGSLSSYNEQFF	TRBV13	TRBJ2-1
TGTGCCAGCAGCATTGACAAGGGGCTAGATACGCAGTATTTT	CASSIDKGLDTQYF	TRBV13	TRBJ2-3
TGTGCCAGCGTTTTTGGGACAGGGATCCCCTACGAGCAGTACTTC	CASVFGTGIPYEQYF	TRBV14	TRBJ2-7
TGTGCCAGCAGCTTGGCTCACCCCGGGGGGGTTTTTAACACTGAAGCTTTCTTT	CASSLAHPGGVFNTEAFF	TRBV5-6	TRBJ1-1
TGTGCCAGTAGTGTCGTCTCCTACAATGAGCAGTTCTTC	CASSVVSYNEQFF	TRBV19	TRBJ2-1
TGTGCCAGCAGCTACACAAGGGAAGTGGCGAAAGATACGCAGTATTTT	CASSYTREVAKDTQYF	TRBV7-2	TRBJ2-3
TGTGCCAGCAGAGCGGGGCGAGAAGAGACCCAGTACTTC	CASRAGREETQYF	TRBV6-4	TRBJ2-5
TGTGCCAGCAGTTACTCAGAGGAGGACGAATCTGGAAACACCATATATTTT	CASSYSEEDESGNTIYF	TRBV6-6	TRBJ1-3
TGCGCCAGCAGCCAAGCTCCCCCCGACAGGGCGGGAGGGTATGGCTACACCTTC	CASSQAPPDRAGGYGYTF	TRBV4-1	TRBJ1-2
TGTGCTAGCAGCTTAGCGGACAGCGGGCAGCCCCAGCATTTT	CASSLADSGQPQHF	TRBV7-7	TRBJ1-5
TGTGCCAGCCACCGGAGGAACACTGAAGCTTTCTTT	CASHRRNTEAFF	TRBV7-3	TRBJ1-1
TGCGCCAGCAGCTTGAAGGGGTTCACAGATACGCAGTATTTT	CASSLKGFTDTQYF	TRBV5-1	TRBJ2-3
TGCGCCAGCAGCCAAGAAGTCCCCCCATGGACTAGCGGTCATTGGCTGTTTTTT	CASSQEVPPWTSGHWLFF	TRBV4-3	TRBJ2-2
TGTGCCAGCAGCTGGGAGGCGGAGAACCAAGAGACCCAGTACTTC	CASSWEAENQETQYF	TRBV7-3	TRBJ2-5
TGTGCCAGCAGTGATGACAGAAGAAATGAGCAGTTCTTC	CASSDDRRNEQFF	TRBV25-1	TRBJ2-1
TGTGCCAGCAGCTTGGAAATAGAACCCGAGGGGTCATTATACAATGAGCAGTTCTTC	CASSLEIEPEGSLYNEQFF	TRBV5-8	TRBJ2-1
TGTGCCAGCAGCCGGGGGGACCGGGGCCCAGATACGCAGTATTTT	CASSRGDRGPDTQYF	TRBV2	TRBJ2-3
TGTGCCAGCATGTCAGGGGTTCGCTACGAGCAGTACTTC	CASMSGVRYEQYF	TRBV6-4	TRBJ2-7
TGTGCCAGCAGCTTGCATCTCCGGATGAAGCCCGGGACTTCGACCGGGGAGCTGTTTTTT	CASSLHLRMKPGTSTGELFF	TRBV5-5	TRBJ2-2
TGCGCCAGCAGCCTAAAGGGGACGGTCTCTGGGGCCAACGTCCTGACTTTC	CASSLKGTVSGANVLTF	TRBV5-1	TRBJ2-6
TGCGCCAGTTTCCTGCGGGAGTTTCGCGAGCAGTACTTC	CASFLREFREQYF	TRBV4-1	TRBJ2-7
TGTGCCAGCAGTGTGCTCATAGGGGGACAGGGGGGCGGGGTAGACAATCAGCCCCAGCATTTT	CASSVLIGGQGGGVDNQPQHF	TRBV6-1	TRBJ1-5
TGTGCCAGCAGCTTATTGACAGGGGCCTACGAGCAGTACTTC	CASSLLTGAYEQYF	TRBV7-2	TRBJ2-7
TGTGCCAGCAGTTACTCTCTCAGGAACCCTCCCCCCCAGCATTTT	CASSYSLRNPPPQHF	TRBV6-3	TRBJ1-5
TGTGCCAGCAGCTTCCTTCATCTGCAGCCCCAGCATTTT	CASSFLHLQPQHF	TRBV7-6	TRBJ1-5
TGTGCTAGTGGTTTTAAGGACAGGGAAGAGACCCAGTACTTC	CASGFKDREETQYF	TRBV12-5	TRBJ2-5
TGTGCCAGCAGCTTGCCCGGCGGGACAGGCCAAGAGACCCAGTACTTC	CASSLPGGTGQETQYF	TRBV7-9	TRBJ2-5
