TGTGCCAGCAGTTACCTAAAACTGTTTTTT	CASSYLKLFF	TRBV6-5	TRBJ1-4
TGTGCCAGCAGCGTAGACGAGGACAGGCGGAACACCGGGGAGCTGTTTTTT	CASSVDEDRRNTGELFF	TRBV9	TRBJ2-2
TGTGCCAGCAGTGGGACAGCCATAAATCAGCCCCAGCATTTT	CASSGTAINQPQHF	TRBV27	TRBJ1-5
TGTGCCAGCAGCACGGCCTGTGAAGCTTTCTTT	CASSTACEAFF	TRBV2	TRBJ1-1
TGCAGTGCGCGGGAGGAAGTTAATGGCTACACCTTC	CSAREEVNGYTF	TRBV20-1	TRBJ1-2
TGTGCCAGCAGCTCGGGACTAGCGGCAGATACGCAGTATTTT	CASSSGLAADTQYF	TRBV11-2	TRBJ2-3
TGTGCCAGCACCTGGGGAGGGTGCTACACCTTC	CASTWGGCYTF	TRBV3-1	TRBJ1-2
TGCAGTGCTAGAGCTGAGAGGCGACAATTTACGGGGACCGAGCAGTACTTC	CSARAERRQFTGTEQYF	TRBV20-1	TRBJ2-7
TGTGCCAGTAGTCACAGGGGAGGGGACTACGAGCAGTACTTC	CASSHRGGDYEQYF	TRBV19	TRBJ2-7
TGTGCCAGCAGCTCCTGGATTAGTGAGTACGAGCAGTACTTC	CASSSWISEYEQYF	TRBV13	TRBJ2-7
TGTGCCACCAGTGATGCCCGGGGAGGGGCCTACGAGCAGTACTTC	CATSDARGGAYEQYF	TRBV24-1	TRBJ2-7
TGTGCCAGCAGTAAAGACGCCGGGACCCTTTCTGAAGCTTTCTTT	CASSKDAGTLSEAFF	TRBV6-5	TRBJ1-1
TGTGCCACCAGTGACTCAGGGCCCACGGTGGAAGATACGCAGTATTTT	CATSDSGPTVEDTQYF	TRBV24-1	TRBJ2-3
TGTGCCAGCAGCCAAGATGGTCTCCCGGGACTAGCGGGAGGGGATCATGAGCAGTTCTTC	CASSQDGLPGLAGGDHEQFF	TRBV3-1	TRBJ2-1
TGTGCCAGCCTGGCGAAAATCACTAGCGGGAGGCGTGACGAAGCTTTCTTT	CASLAKITSGRRDEAFF	TRBV6-1	TRBJ1-1
TGTGCCAGCATAGGAAGGCGGGAGGAGGGAAACACCATATATTTT	CASIGRREEGNTIYF	TRBV7-6	TRBJ1-3
TGCACCGGTGGGCAAGAGACCCAGTACTTC	CTGGQETQYF	TRBV20-1	TRBJ2-5
TGTGCCAGCAAACGTCGGACGAATGAGCAGTTCTTC	CASKRRTNEQFF	TRBV6-6	TRBJ2-1
TGTGCCAGCAGCTCTGGGGGACTAGAAGTCATCAATGAGCAGTTCTTC	CASSSGGLEVINEQFF	TRBV5-8	TRBJ2-1
TGCAGTGACTTAGTAGTCCCCGGGGGCACAGATACGCAGTATTTT	CSDLVVPGGTDTQYF	TRBV20-1	TRBJ2-3
TGTGCCAGCAGCCCTAATCGGGCAATTCGGGATGAAAAACTGTTTTTT	CASSPNRAIRDEKLFF	TRBV5-4	TRBJ1-4
TGTGCCACCAGTGACCTTACTAGCGGGAGACGCAATGAGCAGTTCTTC	CATSDLTSGRRNEQFF	TRBV24-1	TRBJ2-1
TGCGCCAGCAGCCAAGATTCCAGGGGGAAATCCCCCTACGAGCAGTACTTC	CASSQDSRGKSPYEQYF	TRBV4-1	TRBJ2-7
TGTGCCAGCAGCCATCCTGACAGGGGGAGATATAGCAATCAGCCCCAGCATTTT	CASSHPDRGRYSNQPQHF	TRBV3-1	TRBJ1-5
TGTGCCAGCAGCCAAGAAGGAGGGCCGGGACTAGCGGGAGAATCCTACGAGCAGTACTTC	CASSQEGGPGLAGESYEQYF	TRBV14	TRBJ2-7
TGCGCCAGCAGCGTTAAATGCGGCTTGAAGGTTTTCTACGAGCAGTACTTC	CASSVKCGLKVFYEQYF	TRBV5-1	TRBJ2-7
TGTGCCAGCAGGACCTTAGGACAGTATTTACGGACGAATACGGGTACCAATCAGCCCCAGCATTTT	CASRTLGQYLRTNTGTNQPQHF	TRBV7-9	TRBJ1-5
TGCAATCGGAGCCTCTCTGGAAACACCATATATTTT	CNRSLSGNTIYF	TRBV29-1	TRBJ1-3
TGTGCCAGCAGCTTATCACTAGCGGGCCCAGATACGCAGTATTTT	CASSLSLAGPDTQYF	TRBV7-6	TRBJ2-3
TGTGCCAGCACTAAGTGGGGGGGCAATCAGCCCCAGCATTTT	CASTKWGGNQPQHF	TRBV2	TRBJ1-5
TGCAGCGTAAATGGGGAAAGCCCTGAAGCTTTCTTT	CSVNGESPEAFF	TRBV29-1	TRBJ1-1
TGTGCCAGCGGCGCGGGCCGCGAGCAGTACTTC	CASGAGREQYF	TRBV2	TRBJ2-7
TGTGCCAGCAGTGAAGTAGGCTTCGGGTCCTACAATGAGCAGTTCTTC	CASSEVGFGSYNEQFF	TRBV6-1	TRBJ2-1
TGTGCCAGCAGCTTAGATACGTCGGGGGTAAAGAATGAAAAACTGTTTTTT	CASSLDTSGVKNEKLFF	TRBV11-3	TRBJ1-4
TGTGCCAGTACAGCTCCGGGTAACCAGGGGGGGCGGGGAGTGAACACTGAAGCTTTCTTT	CASTAPGNQGGRGVNTEAFF	TRBV19	TRBJ1-1
TGTGCCAGCAGCGTAGGAGGACTAGGAACGGAGCCAGTAGGTAGCTCCTACGAGCAGTACTTC	CASSVGGLGTEPVGSSYEQYF	TRBV9	TRBJ2-7
TGTGCCAGCAGCTACAACAGGGATCGGCTCGGCCACGGAGAGACCCAGTACTTC	CASSYNRDRLGHGETQYF	TRBV14	TRBJ2-5
TGTGCCAGCAGCTTCCCGCCCAACGGACAGGGCAATTCACCCCTCCACTTT	CASSFPPNGQGNSPLHF	TRBV6-4	TRBJ1-6
TGCGCCAGCAGCTTGTTTGGACTAGCGGGTGTTCCGAACACCGGGGAGCTGTTTTTT	CASSLFGLAGVPNTGELFF	TRBV5-1	TRBJ2-2
TGCGCCAGCAGCCTACAGGGCAGGGCGAGTTTGGGCCTCGAGCAGTACTTC	CASSLQGRASLGLEQYF	TRBV5-1	TRBJ2-7
TGTGCCTGGAAGGGCATGGCAAGGGGCCAAACTGAAGCTTTCTTT	CAWKGMARGQTEAFF	TRBV30	TRBJ1-1
TGCGCCAGCAGCCAAGCACCCCGGGACAGGGACACAGAAGCTTTCTTT	CASSQAPRDRDTEAFF	TRBV4-3	TRBJ1-1
TGCGCCAGAAACGAACAAGAGACCCAGTACTTC	CARNEQETQYF	TRBV10-1	TRBJ2-5
TGTGCCGCGTTCAGGGAGCGATGGCCGTCACCCCTCCACTTT	CAAFRERWPSPLHF	TRBV27	TRBJ1-6
TGTGCCAGCAGCCTTCTGGGGGCGGTCTTC	CASSLLGAVF	TRBV13	TRBJ2-1
TGTGCCAGCAGCCCCGCCTACTTTAGCTTTACCATGGAGCTGTTTTTT	CASSPAYFSFTMELFF	TRBV4-2	TRBJ2-2
TGTGCCAGCAGCAATCGGGCAGCCGGGGAGCTGTTTTTT	CASSNRAAGELFF	TRBV9	TRBJ2-2
TGTGCCAGCAGGGCCGGGACCTACGAGCAGTACTTC	CASRAGTYEQYF	TRBV27	TRBJ2-7
TGTGCCAGCAGCATAAAGTTAAAATCAGATACGCAGTATTTT	CASSIKLKSDTQYF	TRBV12-4	TRBJ2-3
TGCAGCGTTGGAACGGGAGCCAAAAACATTCAGTACTTC	CSVGTGAKNIQYF	TRBV29-1	TRBJ2-4
TGTGCCAGCAGTGAAGCGGGTTTCGGGACTGCTCAGCCCCAGCATTTT	CASSEAGFGTAQPQHF	TRBV6-1	TRBJ1-5
TGCAGTGCTAGCCGCGGGGCGAGCTGTGGGTGCTCCTACGAGCAGTACTTC	CSASRGASCGCSYEQYF	TRBV20-1	TRBJ2-7
TGTGCCAGCAGGCCGGGACACGTAGAAGCCAAAAACATTCAGTACTTC	CASRPGHVEAKNIQYF	TRBV12-3	TRBJ2-4
TGTGCCATCATGGACAGGGTCGGGTGTGATACTGGAAACACCATATATTTT	CAIMDRVGCDTGNTIYF	TRBV10-3	TRBJ1-3
TGTGCCAGTAGTTACCAGGCCCGCCAGGTTAACACCATATATTTT	CASSYQARQVNTIYF	TRBV19	TRBJ1-3
TGTGCCAGCAGCCCCGGGACAGGGGCCTGCTATGGCTACACCTTC	CASSPGTGACYGYTF	TRBV7-3	TRBJ1-2
TGTGCCACCAGCAGAGTTGGCCTCGACGGGACGAGGTTGAATAGCAATCAGCCCCAGCATTTT	CATSRVGLDGTRLNSNQPQHF	TRBV15	TRBJ1-5
TGTGCCAGCAGCTCGCCCGGGTCGCCGGACAGGGAGAGCTCCTACGAGCAGTACTTC	CASSSPGSPDRESSYEQYF	TRBV7-9	TRBJ2-7
TGTGCCAGTAGGACAGGGTTCACTGAAGCTTTCTTT	CASRTGFTEAFF	TRBV19	TRBJ1-1
TGTGCCAGCAGCTCGGGGGTTATGGGTCAAGAGACCCAGTACTTC	CASSSGVMGQETQYF	TRBV13	TRBJ2-5
TGTGCCAGCAGCTTAACCCGGTTGGTCTACGAGCAGTACTTC	CASSLTRLVYEQYF	TRBV7-3	TRBJ2-7
TGTGCCAGCAGCGTCCGTCTGGAAGTCTCAACAGGGTCTTTCAACTATGGCTACACCTTC	CASSVRLEVSTGSFNYGYTF	TRBV7-3	TRBJ1-2
TGTGCCAGCCCAGGGGGCGAGTCTACTAATGAAAAACTGTTTTTT	CASPGGESTNEKLFF	TRBV9	TRBJ1-4
TGTGCCAGCAGCCGTAACTCGGGAGGAGCCAAAAACATTCAGTACTTC	CASSRNSGGAKNIQYF	TRBV7-3	TRBJ2-4
TGTGCTAGTGGTTTAGGGCCGCCTATCTCCTACGAGCAGTACTTC	CASGLGPPISYEQYF	TRBV12-5	TRBJ2-7
TGTGCCAGCAGTGACGGGAGGGACTACGAGCAGTACTTC	CASSDGRDYEQYF	TRBV2	TRBJ2-7
TGCAGTGCTACTTCCCGGGCCAAAAACATTCAGTACTTC	CSATSRAKNIQYF	TRBV20-1	TRBJ2-4
TGTGCCAGCAGCGTTTACCTAGGTACCCCCCCGACAGGGTGTTACCAAGAGACCCAGTACTTC	CASSVYLGTPPTGCYQETQYF	TRBV13	TRBJ2-5
TGTGCCAGCAGCGGAGGGCATATTGGTAAAGAGAACACTGAAGCTTTCTTT	CASSGGHIGKENTEAFF	TRBV7-3	TRBJ1-1
TGTGCCTGTGGGGGGGTGTACAATGAGCAGTTCTTC	CACGGVYNEQFF	TRBV24-1	TRBJ2-1
TGTGCCAGCAGCTTGTCTTCCGGGACAGGAGTCGAAAAACTGTTTTTT	CASSLSSGTGVEKLFF	TRBV5-5	TRBJ1-4
TGCAGTGCTAGACGGAGGATGGACGGGGGCACCTTC	CSARRRMDGGTF	TRBV20-1	TRBJ1-2
TGTGCCAGCAGCCAAGAGCTAGCGGGACGATGCTACGAGCAGTACTTC	CASSQELAGRCYEQYF	TRBV4-2	TRBJ2-7
TGTGCCAGCAGCTTCAGACAGGGGTACGTTAACCACACTGAAGCTTTCTTT	CASSFRQGYVNHTEAFF	TRBV7-6	TRBJ1-1
TGTGCCAGCAGTTACTCCCCTGTAGGGGGCGGGGTCAACAACGAGCAGTACTTC	CASSYSPVGGGVNNEQYF	TRBV6-5	TRBJ2-7
TGTGCCAGCAAAACGACAGGTATCAATTCACCCCTCCACTTT	CASKTTGINSPLHF	TRBV7-9	TRBJ1-6
TGCGCCAGCAGCTACGGACACCCGTATGGCTACACCTTC	CASSYGHPYGYTF	TRBV5-1	TRBJ1-2
TGTGCCAGCAGCGAAACCAGCAGAGCTTTCTTT	CASSETSRAFF	TRBV7-9	TRBJ1-1
TGCGCCAGCAGCAACCGGGGCCGGCAGAGCTCCTACGAGCAGTACTTC	CASSNRGRQSSYEQYF	TRBV5-1	TRBJ2-7
TGCAGTGCTGGGGGGCCACGCCACTACAATGAGCAGTTCTTC	CSAGGPRHYNEQFF	TRBV20-1	TRBJ2-1
TGTGCCTGGAGTCCCCCTAGCGGTATAGAGACCCAGTACTTC	CAWSPPSGIETQYF	TRBV30	TRBJ2-5
TGTGCCAGCATAAACGTCATCGGGGTAATGCATGAGCAGTTCTTC	CASINVIGVMHEQFF	TRBV2	TRBJ2-1
TGCGCCAGCAGCCAAGACGGACAGGAGCCTCCTAATGAAAAACTGTTTTTT	CASSQDGQEPPNEKLFF	TRBV4-3	TRBJ1-4
TGTGCCAGCAGTCGACTCCTCTTGGTTGATTCACCCCTCCACTTT	CASSRLLLVDSPLHF	TRBV12-4	TRBJ1-6
TGTGCCACCAGCAGATATAACCGGGTCCAAGGCAATCAGCCCCAGCATTTT	CATSRYNRVQGNQPQHF	TRBV15	TRBJ1-5
TGTGCCAGCAGCCATAATCGTAAAACCAGAAAGGCCGAGCAGTACTTC	CASSHNRKTRKAEQYF	TRBV4-2	TRBJ2-7
TGTGCCAGCAGTTTCAGGTGCCACAGGGACAATAACTATGGCTACACCTTC	CASSFRCHRDNNYGYTF	TRBV12-4	TRBJ1-2
TGTGCCAGCAGTTACTCCCGCAGGGATTACACTGAAGCTTTCTTT	CASSYSRRDYTEAFF	TRBV6-2	TRBJ1-1
TGTGCCAGCCTCCTACAAAGCGTGACTAGCGGGGGGACCTACGAGCAGTACTTC	CASLLQSVTSGGTYEQYF	TRBV27	TRBJ2-7
TGTGCCAGCAGCTTTCGTCCAGGGGACGAAAAACTGTTTTTT	CASSFRPGDEKLFF	TRBV13	TRBJ1-4
TGCGCCAGCAGCTCAACCGGGACAGGGGCGGGCACAGATACGCAGTATTTT	CASSSTGTGAGTDTQYF	TRBV5-1	TRBJ2-3
TGTGCCAGCAGTTTAGACCGAAGACTAGCGGGCCCGGCCTACGAGCAGTACTTC	CASSLDRRLAGPAYEQYF	TRBV27	TRBJ2-7
TGTGCCAGCTCACCACATTCAGGGGGTCAGCCCCAGCATTTT	CASSPHSGGQPQHF	TRBV18	TRBJ1-5
TGTGCCAGCAGCCAAGCGACCTCCAAAACCTACGAGCAGTACTTC	CASSQATSKTYEQYF	TRBV4-2	TRBJ2-7
TGTGCCAGCAGAGGGGGACTAGCGTACGAGACCCAGTACTTC	CASRGGLAYETQYF	TRBV6-5	TRBJ2-5
TGTGCCAGCAGTTACTCGATGCATCCCCTGGACAGTTGCGGCTACACCTTC	CASSYSMHPLDSCGYTF	TRBV6-5	TRBJ1-2
TGTGCCAGCAGCCACCCGGGACAGGTTGGGAAATCTGGAAACACCATATATTTT	CASSHPGQVGKSGNTIYF	TRBV7-9	TRBJ1-3
TGCAGCGAGGACAGGGCTGAAGCTTTCTTT	CSEDRAEAFF	TRBV29-1	TRBJ1-1
TGTGCCAGCAGCGCATCCATTGATACGCAGTATTTT	CASSASIDTQYF	TRBV9	TRBJ2-3
TGCGCCAGCAGCCATGGAGGACTAGAGCGGAGGTCCTACAATGAGCAGTTCTTC	CASSHGGLERRSYNEQFF	TRBV4-3	TRBJ2-1
