TGTGCCAGCAGCTTAGAGGCCGGCAACACTGAAGCTTTCTTT	CASSLEAGNTEAFF	TRBV11-2	TRBJ1-1
TGTGCCAGCAGCCAAAGGGATGGCGTCTCCTACGAGCAGTACTTC	CASSQRDGVSYEQYF	TRBV3-1	TRBJ2-7
TGTGCCAGCAGCTTGGGCGGGGGACTAGCGGGCGAGAATGAGCAGTTCTTC	CASSLGGGLAGENEQFF	TRBV5-6	TRBJ2-1
TGTGCCATCAGGGAGCGACTTGAATATGAGCAGTTCTTC	CAIRERLEYEQFF	TRBV10-3	TRBJ2-1
TGTGCCAGTAGTTGGGGGACTATGATGTACTTC	CASSWGTMMYF	TRBV19	TRBJ2-7
TGTGCCAGCAGCAGTTCCCGGTACGAGACCCAGTACTTC	CASSSSRYETQYF	TRBV12-4	TRBJ2-5
TGTGCCAGCAGCTTGGCTTTCCAGGCGGGAGTAGGCTATGGCTACACCTTC	CASSLAFQAGVGYGYTF	TRBV7-2	TRBJ1-2
TGTGCCAGTAGTATGGGGTCTACATACAATCAGCCCCAGCATTTT	CASSMGSTYNQPQHF	TRBV19	TRBJ1-5
TGTGCCAGCAGTGGCCGGGGGGGGAAGCAGTTCTTC	CASSGRGGKQFF	TRBV6-4	TRBJ2-1
TGTGCCAGCCTAGCGGGGTACACAGATACGCAGTATTTT	CASLAGYTDTQYF	TRBV19	TRBJ2-3
TGTGCCAGCCCGCGCCTCTACGAGCAGTACTTC	CASPRLYEQYF	TRBV6-1	TRBJ2-7
TGCAGTGCCCCCGACAGGGGCACGGGGGGGGAGACCCAGTACTTC	CSAPDRGTGGETQYF	TRBV20-1	TRBJ2-5
TGTGCCACCGAAACACTTCAGGACCAAGAGACCCAGTACTTC	CATETLQDQETQYF	TRBV24-1	TRBJ2-5
TGTGCCTGGAGTAACGGGCCTGTCGCTGAGCAGTTCTTC	CAWSNGPVAEQFF	TRBV30	TRBJ2-1
TGTGCCAGCAAGGGACAGAACGGTCAGCCCCAGCATTTT	CASKGQNGQPQHF	TRBV6-2	TRBJ1-5
TGTGCCAGCAGCAGAGCCCAGATGATCTATGGCTACACCTTC	CASSRAQMIYGYTF	TRBV7-3	TRBJ1-2
TGTGCCAGCAGCGGGGGGGCAGAGGTTGGGGGAGATACGCAGTATTTT	CASSGGAEVGGDTQYF	TRBV7-9	TRBJ2-3
TGTGCCAGCAGTTATACTGGACAGGATGGAAACACCATATATTTT	CASSYTGQDGNTIYF	TRBV6-5	TRBJ1-3
TGTGCCAGCAGCTTAGTTGTTTTGCAGGGGCGTGAAGCTTTCTTT	CASSLVVLQGREAFF	TRBV7-9	TRBJ1-1
TGTGCCAGCAGCTCCTGGGGTGATCCTTCCCAGCATTTT	CASSSWGDPSQHF	TRBV13	TRBJ1-5
TGTGCCAGCAAGGGAACGTTACAATTCTCTAATGAAAAACTGTTTTTT	CASKGTLQFSNEKLFF	TRBV14	TRBJ1-4
TGTGCCAGCAGGAATGGGGACCGTAGCAATCAGCCCCAGCATTTT	CASRNGDRSNQPQHF	TRBV12-3	TRBJ1-5
TGTGCCAGCAGTACAGGGAAAACTTCCGGGTACGAGCAGTACTTC	CASSTGKTSGYEQYF	TRBV28	TRBJ2-7
TGTGCCAGCAGCTCGTCCCGAGGGTGTATGCCCTCCTACGAGCAGTACTTC	CASSSSRGCMPSYEQYF	TRBV11-3	TRBJ2-7
TGTGCCAGCAGCCCTGTGGGGGGATTAGCGGATGAGCAGTTCTTC	CASSPVGGLADEQFF	TRBV11-2	TRBJ2-1
TGTGCCAGCAGCACGTTGACAGGGTTAAATAGCACAGATACGCAGTATTTT	CASSTLTGLNSTDTQYF	TRBV13	TRBJ2-3
TGTGCCAGCAGTTTAGTGTTTACTAGCGGGAGGGCGAACACAGATACGCAGTATTTT	CASSLVFTSGRANTDTQYF	TRBV12-4	TRBJ2-3
TGTGCCAGGTTAACGCGGAACACCGGGGAGCTGTTTTTT	CARLTRNTGELFF	TRBV2	TRBJ2-2
TGTGCCACCTACCCCACCCAGTTCAGCCCCAGGGGGGAGCAGTTCTTC	CATYPTQFSPRGEQFF	TRBV24-1	TRBJ2-1
TGCAGTGCTGGACTGAAGCCCACTGAAGCTTTCTTT	CSAGLKPTEAFF	TRBV20-1	TRBJ1-1
TGTGCCAGCAGCTTGGGGCCCCGGGACAGGGCGGAAGCTTTCTTT	CASSLGPRDRAEAFF	TRBV5-8	TRBJ1-1
TGTGCCAGCAGTTTTCCCGGGACAGAAAGCACAGATACGCAGTATTTT	CASSFPGTESTDTQYF	TRBV12-3	TRBJ2-3
TGTGCCAGCAGCCAAACTAAATATTACAATGAGCAGTTCTTC	CASSQTKYYNEQFF	TRBV14	TRBJ2-1
TGTGCCTGGAGTGTACTAATAGTGACCGAGTACTTC	CAWSVLIVTEYF	TRBV30	TRBJ2-7
TGTGCCAGCAGCTTAGCGGAGACGGGTGCAAATAGTCATGGCTACACCTTC	CASSLAETGANSHGYTF	TRBV7-8	TRBJ1-2
TGTGCCAGCAGCTTGATACAGGGGTACGAGCAGTACTTC	CASSLIQGYEQYF	TRBV5-4	TRBJ2-7
TGTGCCAGCAGTTTCGGCAGGGAGAATGGCTACACCTTC	CASSFGRENGYTF	TRBV27	TRBJ1-2
TGTGCCAGCAGGCTTTCGAGGAGCTCCTACAATGAGCAGTTCTTC	CASRLSRSSYNEQFF	TRBV6-4	TRBJ2-1
TGTGCCAGCAGTGAACCAGGGGGTGAGAACACCTTC	CASSEPGGENTF	TRBV6-1	TRBJ1-2
TGTGCCAGCAGCCCTCTGCTGGTAGGCATGAACACTGAAGCTTTCTTT	CASSPLLVGMNTEAFF	TRBV5-4	TRBJ1-1
TGTGCCAGCAGCTTAAAACCCAAGCTTGCGATATTCCGGACCGGGGAGCTGTTTTTT	CASSLKPKLAIFRTGELFF	TRBV7-3	TRBJ2-2
TGTGCCAGCTCACCAGCCGGGACAGGGGGCGGAGAAGAGACTGAAGCTTTCTTT	CASSPAGTGGGEETEAFF	TRBV18	TRBJ1-1
TGTGCCAGCACAGGGGCGGGTAGGAGCAATCAGCCCCAGCATTTT	CASTGAGRSNQPQHF	TRBV11-3	TRBJ1-5
TGTGCCGACCTAGCGGAAGGGAAGACGAGCACAGATACGCAGTATTTT	CADLAEGKTSTDTQYF	TRBV12-5	TRBJ2-3
TGCGCCAGCAGCTCTAAAGAGGGGCCATTAGACGAGCAGTACTTC	CASSSKEGPLDEQYF	TRBV5-1	TRBJ2-7
TGTGCCAGCAGTCTGCTCACCGGGGGGAGCAATGAGCAGTTCTTC	CASSLLTGGSNEQFF	TRBV12-3	TRBJ2-1
TGCAGTGCTAGGATCACCCGGGGGCACGAGCAGTACTTC	CSARITRGHEQYF	TRBV20-1	TRBJ2-7
TGTGCCAGCAGCCAAGACCAAATCAGATTCCACACCGGGGAGCTGTTTTTT	CASSQDQIRFHTGELFF	TRBV3-1	TRBJ2-2
TGCGCCAGCAGTGAGGGTCCCCAACACAATGAGCAGTTCTTC	CASSEGPQHNEQFF	TRBV10-2	TRBJ2-1
TGTGCCAGCAGTGGTCCTCCGGGACAGGGGGCCGAGCAGTACTTC	CASSGPPGQGAEQYF	TRBV28	TRBJ2-7
TGCGCCAGCAGTGGCCGGGACAGGTCGATTTCCTACGAGCAGTACTTC	CASSGRDRSISYEQYF	TRBV10-2	TRBJ2-7
TGCAGTGCTCTCATACAGGGGCCAACCACTGAAGCTTTCTTT	CSALIQGPTTEAFF	TRBV20-1	TRBJ1-1
TGTGCCAGCAACGCAGGGGAGATCTTC	CASNAGEIF	TRBV6-5	TRBJ2-1
TGCAGTACTGGGACAGTCACTGAAGCTTTCTTT	CSTGTVTEAFF	TRBV20-1	TRBJ1-1
TGTGCCACCAGTGATATAGGAGGAAACATTCAGTACTTC	CATSDIGGNIQYF	TRBV24-1	TRBJ2-4
TGTGCCAGCAATCCGGGCAGGTATCAGCCCCAGCATTTT	CASNPGRYQPQHF	TRBV6-4	TRBJ1-5
TGTGCCATACCTGAACGGAGGACAGGGAATCAGCCCCAGCATTTT	CAIPERRTGNQPQHF	TRBV7-2	TRBJ1-5
TGTGCCAGCAGTGCCGGGACAGGCTACGAGCAGTACTTC	CASSAGTGYEQYF	TRBV6-2	TRBJ2-7
TGTGCCAGCAGCCGTTACGAGCAGTACTTC	CASSRYEQYF	TRBV7-3	TRBJ2-7
TGTGCCAGCAGGTTTGACAGGGGTGGCTACACCTTC	CASRFDRGGYTF	TRBV28	TRBJ1-2
TGCAGTGCTACCCTGGGGCCTAGAGTCCCCCAGCATTTT	CSATLGPRVPQHF	TRBV20-1	TRBJ1-5
TGTGCCAGCAGCGGGACTAGCGGGGTCTACAATGAGCAGTTCTTC	CASSGTSGVYNEQFF	TRBV9	TRBJ2-1
TGTGCCAGCAGCCAAGATGTAGACAGAGAGTCATTTCGTTTCTTC	CASSQDVDRESFRFF	TRBV4-2	TRBJ2-1
TGTGCCAGCAGCCAAGGAAGCTCCTACGAGCAGTACTTC	CASSQGSSYEQYF	TRBV3-1	TRBJ2-7
TGCGCCAGCAGCTCTAGGGACAGGAAGACTTGCTACGAGCAGTACTTC	CASSSRDRKTCYEQYF	TRBV5-1	TRBJ2-7
TGTGCCAGCAGCTGCACGACAGGGTGGAATCAGCCCCAGCATTTT	CASSCTTGWNQPQHF	TRBV7-2	TRBJ1-5
TGTGCCATCAGTTTCCTGGCCGGACCAAGGGGGGGCTATAGCAATCAGCCCCAGCATTTT	CAISFLAGPRGGYSNQPQHF	TRBV10-3	TRBJ1-5
TGTGCCAGCAGCTTGGTCCCCGATCACCGCCGGGACAGAGGCCTTTACGAGCAGTACTTC	CASSLVPDHRRDRGLYEQYF	TRBV5-6	TRBJ2-7
TGTGCCAGCAGTTACGTTGAGGAGGGGGGGAGGGAAGATACCGGGGAGCTGTTTTTT	CASSYVEEGGREDTGELFF	TRBV6-2	TRBJ2-2
TGTGCCACCGGTGGAGGGCCGGGACAGGGGAGAAAACTGTTTTTT	CATGGGPGQGRKLFF	TRBV24-1	TRBJ1-4
TGTGCCAGAAGGGAGGGGAAGAACTATGGCTACACCTTC	CARREGKNYGYTF	TRBV7-9	TRBJ1-2
TGTGCCAGCAGTTACTACGGACCTAGCAATCAGCCCCAGCATTTT	CASSYYGPSNQPQHF	TRBV6-5	TRBJ1-5
TGTGCCAGCAGTTACAACCTTTGCAGGGGGCTTGCAACTAATGAAAAACTGTTTTTT	CASSYNLCRGLATNEKLFF	TRBV6-5	TRBJ1-4
TGTGCCAGCAGCTTAACGCGGACAGCCTACGAGCAGTACTTC	CASSLTRTAYEQYF	TRBV7-3	TRBJ2-7
TGTGCCAGTAGTGTAAACCATGGCCAGGTCGACGAGCAGTACTTC	CASSVNHGQVDEQYF	TRBV19	TRBJ2-7
TGTGCCAGCAGCCATCCAGCGGTTTGTGAGCAGTTCTTC	CASSHPAVCEQFF	TRBV4-2	TRBJ2-1
TGTGCCAGTAGTATAGATCAAGTCCCTCGAAGGGACAGGGTCCTAACAGGGTACAATGAGCAGTTCTTC	CASSIDQVPRRDRVLTGYNEQFF	TRBV19	TRBJ2-1
TGTGCCAGCAGCAGGGGGGCACTCCACTTT	CASSRGALHF	TRBV6-5	TRBJ1-6
TGTGCCAGTAGTGGGAGCCGGCAAGAGACCCAGTACTTC	CASSGSRQETQYF	TRBV19	TRBJ2-5
TGTGCCAGCAGTTACTCGTTGACGATGGTCCCTAAACAAGAGACCCAGTACTTC	CASSYSLTMVPKQETQYF	TRBV6-3	TRBJ2-5
TGTGCCAGCAGCCTAGGACTAGCGGGGTCTCAAGAGACCCAGTACTTC	CASSLGLAGSQETQYF	TRBV7-3	TRBJ2-5
TGTGCCAGCAGTTTATCTGGGACTAGCGTCTTGCGCGAGCAGTACTTC	CASSLSGTSVLREQYF	TRBV27	TRBJ2-7
TGCAGTGCTAGAGATAACGGGGCCAAAAACATTCAGTACTTC	CSARDNGAKNIQYF	TRBV20-1	TRBJ2-4
TGTGCCAGCAGCTTACCGGATCCGGGACAGAACGATACGCAGTATTTT	CASSLPDPGQNDTQYF	TRBV7-2	TRBJ2-3
TGTGCCAGCAGTTTGGCCGCGGGAGGGGGCTATGGCTACACCTTC	CASSLAAGGGYGYTF	TRBV12-4	TRBJ1-2
TGTAGCGGGAGGTGGAATATTGTTAGCGAGCAGTTCTTC	CSGRWNIVSEQFF	TRBV30	TRBJ2-1
TGTGCCAGCAGCTTGGAAGGACAGGGATTGAACACTGAAGCTTTCTTT	CASSLEGQGLNTEAFF	TRBV5-6	TRBJ1-1
TGTGCCACCAGCAGCGTATACGAGTGTGGCTACACCTTC	CATSSVYECGYTF	TRBV15	TRBJ1-2
TGTGCCAGCAGCGAAGACGAGGAAGAGACCCAGTACTTC	CASSEDEEETQYF	TRBV3-1	TRBJ2-5
TGTGCCACCAGTGATTCCTCAGTGGACCAGGCGAGGTGTCTCCGAAGCAATCAGCCCCAGCATTTT	CATSDSSVDQARCLRSNQPQHF	TRBV24-1	TRBJ1-5
TGTGCCAGTAGAAGACTAGGCAATGAGCAGTTCTTC	CASRRLGNEQFF	TRBV19	TRBJ2-1
TGCGCCAGCAGCCAAGATGCCGGGGGGGGGCGAGATACGCAGTATTTT	CASSQDAGGGRDTQYF	TRBV4-3	TRBJ2-3
TGTGCCAGCAGTTACTTGCTCTCACCCCTCCACTTT	CASSYLLSPLHF	TRBV6-6	TRBJ1-6
TGCAGTGCTACGACCGCCTACGAGCAGTACTTC	CSATTAYEQYF	TRBV20-1	TRBJ2-7
TGTGCCAGCGGACCCTACTCCGACCTAGCGGGAGCCTCTAGCTCCTACGAGCAGTACTTC	CASGPYSDLAGASSSYEQYF	TRBV6-2	TRBJ2-7
TGTGCCACCAGCAGGAGGGGCCGGGACTCAGATGGCTACACCTTC	CATSRRGRDSDGYTF	TRBV15	TRBJ1-2
TGTGCCAGCAGTGACCGAATCCGCTCCTACGAGCAGTACTTC	CASSDRIRSYEQYF	TRBV6-1	TRBJ2-7
TGTGCCAGGACCGCCCGGGACAGAAATCAGCCCCAGCATTTT	CARTARDRNQPQHF	TRBV19	TRBJ1-5
TGCAGTGCTAGGACCCCAAAGCGAAGCTCCTATAATTCACCCCTCCACTTT	CSARTPKRSSYNSPLHF	TRBV20-1	TRBJ1-6
TGCGCCAGCACGCTATGGGGCGGCTACACCTTC	CASTLWGGYTF	TRBV5-1	TRBJ1-2
