TGCGCCAGCAAGACCCAGGAGACCCAGTACTTC	CASKTQETQYF	TRBV10-1	TRBJ2-5
TGTGCCAGCACACGGCCTGGGACTAGTTCCGAACTAACCCAGTACTTC	CASTRPGTSSELTQYF	TRBV12-3	TRBJ2-5
TGTGCCAGCAGCACAGGGTCAGGGGGAGGCTATGGCTACACCTTC	CASSTGSGGGYGYTF	TRBV7-9	TRBJ1-2
TGTGCCTTTACAGCCGGGGAGAACACTGAAGCTTTCTTT	CAFTAGENTEAFF	TRBV30	TRBJ1-1
TGTGCCAGCAGCTCGGGGGCCCGAGAGACCCAGTACTTC	CASSSGARETQYF	TRBV5-4	TRBJ2-5
TGTGCCAGCAGCCTCGGGGGGGTGGGAGATACGCAGTATTTT	CASSLGGVGDTQYF	TRBV5-4	TRBJ2-3
TGCGCCACCTTCACAGGGACTAGCGTAATATCGCCCTACAATGAGCAGTTCTTC	CATFTGTSVISPYNEQFF	TRBV10-1	TRBJ2-1
TGCAGTGCTCACTACCGGGGCAATGAGCAGTTCTTC	CSAHYRGNEQFF	TRBV20-1	TRBJ2-1
TGTGCCAGCCCGGGGACAGGGGGCTACTCTGGAAACACCATATATTTT	CASPGTGGYSGNTIYF	TRBV12-3	TRBJ1-3
TGTGCCAGTTTCAACCGTGGGACCGGATATAGCAATCAGCCCCAGCATTTT	CASFNRGTGYSNQPQHF	TRBV19	TRBJ1-5
TGTGCCAGCAACCGGAGGGGAAGGGAGGGAAAGGATGAGCAGTTCTTC	CASNRRGREGKDEQFF	TRBV27	TRBJ2-1
TGTGCCAGCAGTTACTCGATGTTGGCCACTAGCGGGAGAGTCTATCAGCCCCAGCATTTT	CASSYSMLATSGRVYQPQHF	TRBV6-5	TRBJ1-5
TGTGCCAGCATGGACTCCAGGGAGGTGTCGCACACTGAAGCTTTCTTT	CASMDSREVSHTEAFF	TRBV12-3	TRBJ1-1
TGCGCCAGCAGCTTGCAACCCGGAGGGGCCGGCCTTGCAACTAATGAAAAACTGTTTTTT	CASSLQPGGAGLATNEKLFF	TRBV5-1	TRBJ1-4
TGCGCCATGAGCGGTGGGTGCGTACACACAGATACGCAGTATTTT	CAMSGGCVHTDTQYF	TRBV10-2	TRBJ2-3
TGCGCCAGCAGCCGGCACATTTTGGACAGTTCAAGCAATCAGCCCCAGCATTTT	CASSRHILDSSSNQPQHF	TRBV4-1	TRBJ1-5
TGTGCCAGCAGCCGCCCGGGGGGGTTTTTATCTGAGCAGTTCTTC	CASSRPGGFLSEQFF	TRBV9	TRBJ2-1
TGTGCCAGCAGCTTATCCCTTGCAATCCATGAAAAACTGTTTTTT	CASSLSLAIHEKLFF	TRBV11-3	TRBJ1-4
TGTGCCAGCAGTTACTGGGGGAGGGTCTACTCCTATAATTCACCCCTCCACTTT	CASSYWGRVYSYNSPLHF	TRBV6-2	TRBJ1-6
TGTGCCTGGACAGTCACAGGGATGAACACTGAAGCTTTCTTT	CAWTVTGMNTEAFF	TRBV30	TRBJ1-1
TGTGCCTGGCCGAGGGCTAACATTCAGTACTTC	CAWPRANIQYF	TRBV30	TRBJ2-4
TGTGCCACCAGTGACTGCGGGGGGGGGGACGCTTCGAACACCGGGGAGCTGTTTTTT	CATSDCGGGDASNTGELFF	TRBV24-1	TRBJ2-2
TGTGCCAGCAGCTTAGCCGCTCAACTCAGGGAGGGCCTCGGGGGTAAGCCCTACGAGCAGTACTTC	CASSLAAQLREGLGGKPYEQYF	TRBV7-6	TRBJ2-7
TGTGCCAGCAGCGTAGGGGGACTGGGTTACGAGCAGTACTTC	CASSVGGLGYEQYF	TRBV9	TRBJ2-7
TGTGCCAGCAGCTTACCGCGGGAGGTCCGAACTTCGTATAGCAATCAGCCCCAGCATTTT	CASSLPREVRTSYSNQPQHF	TRBV7-9	TRBJ1-5
TGTGCCAGCAGCCAGGTACCGGGACTAGGTTATTTCTGGAGCACAGATACGCAGTATTTT	CASSQVPGLGYFWSTDTQYF	TRBV5-6	TRBJ2-3
TGCGCCAGCAGCCAACCATCAGTACCCAGAGTGAACACTGAAGCTTTCTTT	CASSQPSVPRVNTEAFF	TRBV4-3	TRBJ1-1
TGTGCCAGCAGGACCATTAGGGCCCGCTTCTCTGGAAACACCATATATTTT	CASRTIRARFSGNTIYF	TRBV11-2	TRBJ1-3
TGTGCCAGCAGCTATGGGGGCGAGCAGTACTTC	CASSYGGEQYF	TRBV5-6	TRBJ2-7
TGTGCCAGCAGTTACAGGCAACCCGAGCAGTACTTC	CASSYRQPEQYF	TRBV25-1	TRBJ2-7
TGTGCCAGCAGTTTATCGGGGGACAGGGGGGGTTCTAACTATGGCTACACCTTC	CASSLSGDRGGSNYGYTF	TRBV27	TRBJ1-2
TGTGCCAGCAGCTTGACAGGGGGCTACACCTTC	CASSLTGGYTF	TRBV5-6	TRBJ1-2
TGTGCCAGCAGTGACGCTGGGGCCCGGGCTGAAGCTTTCTTT	CASSDAGARAEAFF	TRBV6-1	TRBJ1-1
TGTGCCAGCAGAGGGCTACAGGGCTTAATGGGGTACGAGCAGTACTTC	CASRGLQGLMGYEQYF	TRBV9	TRBJ2-7
TGTGCCAGAAAGGGGAGTGTCTATAGCAATCAGCCCCAGCATTTT	CARKGSVYSNQPQHF	TRBV27	TRBJ1-5
TGTGCCAGCAGTGCCGGGGGGCCTCCAGATACGCAGTATTTT	CASSAGGPPDTQYF	TRBV27	TRBJ2-3
TGTGCCAGCAGCTTAGCCGTGCCTCCTAGGGGCGGTTCCGGAAACAGGGGGGGGGCTGAAGCTTTCTTT	CASSLAVPPRGGSGNRGGAEAFF	TRBV7-2	TRBJ1-1
TGCAGTGCGTGGGGGGAGGAGCCAGTGTCGGGCACAGATACGCAGTATTTT	CSAWGEEPVSGTDTQYF	TRBV20-1	TRBJ2-3
TGTGCCAGCAGCTTAGTTACTGGGAGGGAAAAACTGTTTTTT	CASSLVTGREKLFF	TRBV7-2	TRBJ1-4
TGTGCCAGCAGCGTAGGAATCTTACAGAACACTGAAGCTTTCTTT	CASSVGILQNTEAFF	TRBV9	TRBJ1-1
TGTGCCACCAGGACTACAGGCAGGGTGTACAATGAGCAGTTCTTC	CATRTTGRVYNEQFF	TRBV24-1	TRBJ2-1
TGTGCCAGCAGTGAATCGGCCAGCGGCGGATACGAGCAGTACTTC	CASSESASGGYEQYF	TRBV2	TRBJ2-7
TGTGCCAGCAGCATCCTGGGGCACAATGAGCAGTTCTTC	CASSILGHNEQFF	TRBV7-3	TRBJ2-1
TGTGCCAGCATAGCCCCCCGACAGGGTTACTATGGCTACACCTTC	CASIAPRQGYYGYTF	TRBV6-2	TRBJ1-2
TGTGCCAGCACTAAGACGGGCCTGAACACTGAAGCTTTCTTT	CASTKTGLNTEAFF	TRBV6-2	TRBJ1-1
TGTGCCAGCAGCTTCAATGGGGAGCATCAGCCCCAGCATTTT	CASSFNGEHQPQHF	TRBV7-7	TRBJ1-5
TGTGCCAGCAGCTTAGAAATACAGGGGCTCCGTCACACTGAAGCTTTCTTT	CASSLEIQGLRHTEAFF	TRBV11-2	TRBJ1-1
TGCGCCAGCAGCTTGGCCTTCTTTAGAGGTTGGTCCCTTGAGCAGTTCTTC	CASSLAFFRGWSLEQFF	TRBV5-1	TRBJ2-1
TGTGCCAGCCCGGGGGGGCTGAGATATCAGCCCCAGCATTTT	CASPGGLRYQPQHF	TRBV9	TRBJ1-5
TGTGCCACCAGTGATTCCCGGACAGGCTCTGGGGCCAACGTCCTGACTTTC	CATSDSRTGSGANVLTF	TRBV24-1	TRBJ2-6
TGTGCCACCAGTGAACCCCGGGACCTCCGTCAGCCCCAGCATTTT	CATSEPRDLRQPQHF	TRBV24-1	TRBJ1-5
TGTGCCAGCAGCAATCACAGGGATGGCTACACCTTC	CASSNHRDGYTF	TRBV9	TRBJ1-2
TGCAGTGCTAGAGTTCTAGCGGGGGATAGTCTAGATTACGAGCAGTACTTC	CSARVLAGDSLDYEQYF	TRBV20-1	TRBJ2-7
TGTGCCAGCAGCCAAGAGAACCACCAAGAGACCCAGTACTTC	CASSQENHQETQYF	TRBV3-1	TRBJ2-5
TGCGCCAGCAGCTTTATGGACAGGCTGAACACTGAAGCTTTCTTT	CASSFMDRLNTEAFF	TRBV5-1	TRBJ1-1
TGTGCCACCAGCAGGACTAGCACAGATACGCAGTATTTT	CATSRTSTDTQYF	TRBV15	TRBJ2-3
TGTGCCACCAGCCTGACTAGCGGGAGTTACAATGAGCAGTTCTTC	CATSLTSGSYNEQFF	TRBV24-1	TRBJ2-1
TGTGCCAGCAGTGATCCATTCGAAGATCGAGGATCCTACGAGCAGTACTTC	CASSDPFEDRGSYEQYF	TRBV6-1	TRBJ2-7
TGCGCCAGCGACAGGGGGAGATTCATGGGGGCAGATGGCTACACCTTC	CASDRGRFMGADGYTF	TRBV10-2	TRBJ1-2
TGTGCCAGCAGTTACCTAGAAAGAGAGACCCAGTACTTC	CASSYLERETQYF	TRBV6-5	TRBJ2-5
TGTGCCAGCAGTTTCATCGGGGGTCGAATCAATCAGCCCCAGCATTTT	CASSFIGGRINQPQHF	TRBV12-3	TRBJ1-5
TGTGCCACCAGTCTCCAGGGAGCCGAGTACCAAGAGACCCAGTACTTC	CATSLQGAEYQETQYF	TRBV24-1	TRBJ2-5
TGTGCCAGCACAGGGGGCATGAACACTGAAGCTTTCTTT	CASTGGMNTEAFF	TRBV19	TRBJ1-1
TGTGCCAGCAGCCCAGGCGGGAGGGAGGCTAGCTCCTATAATTCACCCCTCCACTTT	CASSPGGREASSYNSPLHF	TRBV14	TRBJ1-6
TGCAGTGCCGAAGCCGGGGGATCTGGGGCCAACGTCCTGACTTTC	CSAEAGGSGANVLTF	TRBV20-1	TRBJ2-6
TGTGCCTATACAGGGAACCGCCACGAGCAGTACTTC	CAYTGNRHEQYF	TRBV30	TRBJ2-7
TGTGCCAGCAGCAACCATCAGCCCCAGCATTTT	CASSNHQPQHF	TRBV7-3	TRBJ1-5
TGTGCCAACGGCAACGTGTTTGAAAAACTGTTTTTT	CANGNVFEKLFF	TRBV7-9	TRBJ1-4
TGTGCCAGCAGTTTAAGTGGGAGGGGGGGCACAGATACGCAGTATTTT	CASSLSGRGGTDTQYF	TRBV27	TRBJ2-3
TGTGCCAGCAGCTTTAAATGCCGGGACAGGGGAGGTCGCCGGGGCTACACCTTC	CASSFKCRDRGGRRGYTF	TRBV7-2	TRBJ1-2
TGTGCCACGAGTTGGGGATTGAACACTGAAGCTTTCTTT	CATSWGLNTEAFF	TRBV27	TRBJ1-1
TGTGCCTGGCGGCCAGGGGGCCGGGGTTGCTATGGCTACACCTTC	CAWRPGGRGCYGYTF	TRBV30	TRBJ1-2
TGTGCCAGCAGCCAAGAACTGGGGGACGAGCAGTACTTC	CASSQELGDEQYF	TRBV5-5	TRBJ2-7
TGTGCCAGCAGTTTCTCAGGGGCGTCAGGGGGCATTCAGTACTTC	CASSFSGASGGIQYF	TRBV12-3	TRBJ2-4
TGTGCCAGCAGTGTCCGGGGGCAAAACTATGGCTACACCTTC	CASSVRGQNYGYTF	TRBV28	TRBJ1-2
TGCAGCGTTGACGGGGACAGAAGGACCCAGTACTTC	CSVDGDRRTQYF	TRBV29-1	TRBJ2-5
TGTGCCAGCTCACCAATCTACTTAGGGAACAATGAGCAGTTCTTC	CASSPIYLGNNEQFF	TRBV18	TRBJ2-1
TGTGCCAGCAGCTTATTCGGAAGGGGCTATGGCTACACCTTC	CASSLFGRGYGYTF	TRBV11-1	TRBJ1-2
TGTGCCAGCAGCTTAGGCAGCAGCCCCGAAAAACTGTTTTTT	CASSLGSSPEKLFF	TRBV11-3	TRBJ1-4
TGTGCCAGTAGTATAGCCAAACGAAAAGAACTCAGGGCACACCTATACGAGCAGTACTTC	CASSIAKRKELRAHLYEQYF	TRBV19	TRBJ2-7
TGTGCCAGCAGCACTGTTCTCAGAGGGACCCAGTACTTC	CASSTVLRGTQYF	TRBV7-2	TRBJ2-5
TGTGCCAGTAGGGTTCGGAGCTACGAGCAGTACTTC	CASRVRSYEQYF	TRBV19	TRBJ2-7
TGTGCCAGCAGCTTTATAGTAACCATTCAGTACTTC	CASSFIVTIQYF	TRBV5-6	TRBJ2-4
TGTGCCAGTAGTCGGGTAGAGACCCAGTACTTC	CASSRVETQYF	TRBV19	TRBJ2-5
TGTGCTAGTGGTTTGGTCCGAGTCCCGAACACCGGGGAGCTGTTTTTT	CASGLVRVPNTGELFF	TRBV12-5	TRBJ2-2
TGCAGCGTAGAGCTCTACCCCGGGCAGTTAAACTATGGCTACACCTTC	CSVELYPGQLNYGYTF	TRBV29-1	TRBJ1-2
TGTGCCAGCAGCTGGGGGAGATACACCATATATTTT	CASSWGRYTIYF	TRBV13	TRBJ1-3
TGTGCCAGCAGCTTAACTAGCGGGCACCAAGAGACCCAGTACTTC	CASSLTSGHQETQYF	TRBV7-9	TRBJ2-5
TGTGCCAGCAGCCAAGAGGCCTCCGGGCCCGGGGGCTACACCTTC	CASSQEASGPGGYTF	TRBV3-1	TRBJ1-2
TGCGCCAGCAGCCGAGTGGGGGATGGCTACACCTTC	CASSRVGDGYTF	TRBV5-1	TRBJ1-2
TGTGCCAGCAGTGAACCTCCTAGGGTCTACGAGCAGTACTTC	CASSEPPRVYEQYF	TRBV25-1	TRBJ2-7
TGTGCCAGCAGCCAAGATTACAGGAACACCGGGGCTGGAAACACCATATATTTT	CASSQDYRNTGAGNTIYF	TRBV3-1	TRBJ1-3
TGTGCCAGCAGCTCGGGGAAGGGATCCTACGAGCAGTACTTC	CASSSGKGSYEQYF	TRBV7-6	TRBJ2-7
TGTGCCAGCAGCTTAGAGGACAGGGGGCATCAGCCCCAGCATTTT	CASSLEDRGHQPQHF	TRBV7-4	TRBJ1-5
TGCAGTGCTAGCGAACCGGGGAGGTGCTATGGCTACACCTTC	CSASEPGRCYGYTF	TRBV20-1	TRBJ1-2
TGTGCCAGCAGCCTCGCGGACACGAGCTCTGGAAACACCATATATTTT	CASSLADTSSGNTIYF	TRBV13	TRBJ1-3
TGTGCCAGTAGTAGGGACAGTTTTGACACCATATATTTT	CASSRDSFDTIYF	TRBV19	TRBJ1-3
TGCGCCAGCAGGGACAGGGTTTGGTCTGGCTACACCTTC	CASRDRVWSGYTF	TRBV10-1	TRBJ1-2
TGTGCCACCAGTGATTTATTTGCGGGACAGGGGGCTTCACCCCTCCACTTT	CATSDLFAGQGASPLHF	TRBV24-1	TRBJ1-6
TGTGCCAGCAGCAAACGAGAGAAACAGGGTAGGACCCAGTACTTC	CASSKREKQGRTQYF	TRBV7-6	TRBJ2-5
