TGTGCCAGCAGGTCCAGAATGAAAAACATTCAGTACTTC	CASRSRMKNIQYF	TRBV7-3	TRBJ2-4
TGTGCCAGCGGAGAGGCCCCTGGGGCCAACGTCCTGACTTTC	CASGEAPGANVLTF	TRBV6-3	TRBJ2-6
TGTGCCAGCGACTACTACGAGCAGTACTTC	CASDYYEQYF	TRBV3-1	TRBJ2-7
TGTGCCAGCAGCTTGCGGAACAGTAGCTACGAGCAGTACTTC	CASSLRNSSYEQYF	TRBV7-9	TRBJ2-7
TGTGCCAGCAGCGTAGAGCGCAGGGGAATCAATCAGCCCCAGCATTTT	CASSVERRGINQPQHF	TRBV9	TRBJ1-5
TGTGCCACCAGTGACCGGGGCAGTTCTGGGGCCAACGTCCTGACTTTC	CATSDRGSSGANVLTF	TRBV24-1	TRBJ2-6
TGTGCCAGCGTAGCAGTTCTGCCGGGACGGGATGGCTACACCTTC	CASVAVLPGRDGYTF	TRBV7-6	TRBJ1-2
TGTGCCAGCAGCCGTGGTACCTTGAACACTGAAGCTTTCTTT	CASSRGTLNTEAFF	TRBV12-4	TRBJ1-1
TGCGCCAGCAGTGAGTACGAGCCGTGCGACGGGATCACTGAAGCTTTCTTT	CASSEYEPCDGITEAFF	TRBV10-1	TRBJ1-1
TGTGCCAGCAGCCAATCTGACAGTAAGAGTGAGCAGTACTTC	CASSQSDSKSEQYF	TRBV3-1	TRBJ2-7
TGTGCCAGCAGCCTCTGGGAGGGACTCAATGAGCAGTTCTTC	CASSLWEGLNEQFF	TRBV13	TRBJ2-1
TGTGCCAGCAGTTACTCGCCGGGTGAAAAGGACAGGGGGGGACGGAATCAGCCCCAGCATTTT	CASSYSPGEKDRGGRNQPQHF	TRBV6-5	TRBJ1-5
TGTGCTAGTGGAGATTGGGGGGGCTACGAGCAGTACTTC	CASGDWGGYEQYF	TRBV12-5	TRBJ2-7
TGCAGTGCTAAATGGACAGGGCGGGACTATGGCTACACCTTC	CSAKWTGRDYGYTF	TRBV20-1	TRBJ1-2
TGTGCCAGTAGTATTAGCGGGGGGAATGAGCAGTTCTTC	CASSISGGNEQFF	TRBV19	TRBJ2-1
TGTGCCAGCTCACCACTTACTGAAGAGACCCAGTACTTC	CASSPLTEETQYF	TRBV18	TRBJ2-5
TGCGCCAGCAGCAGGGTGCAGGGAGGAGGCACTGAAAAACTGTTTTTT	CASSRVQGGGTEKLFF	TRBV5-1	TRBJ1-4
TGCAGCGTTATTTATAGCCTCGAAGAGACCCAGTACTTC	CSVIYSLEETQYF	TRBV29-1	TRBJ2-5
TGTGCCAGCAGTGGGGGCCTGAGGGGGGACTACAATGAGCAGTTCTTC	CASSGGLRGDYNEQFF	TRBV6-4	TRBJ2-1
TGTGCCACCGGAGGGCTCCCCTACGAGCAGTACTTC	CATGGLPYEQYF	TRBV24-1	TRBJ2-7
TGTGCCAGCAGTAGGGTGAATACGCAGTATTTT	CASSRVNTQYF	TRBV27	TRBJ2-3
TGTGCCAGCAGTGGGGGTACGCAGCCCCAGCATTTT	CASSGGTQPQHF	TRBV6-1	TRBJ1-5
TGCAGTGGAAACGGGCGGGATTTCCTCTCCTACAATGAGCAGTTCTTC	CSGNGRDFLSYNEQFF	TRBV20-1	TRBJ2-1
TGTGCCAGCAGTTACTGTCTAGCGGGCCGCTACAATGAGCAGTTCTTC	CASSYCLAGRYNEQFF	TRBV6-5	TRBJ2-1
TGTGCCAGCAGCTCTAGCGGGACCTCCTACAATGAGCAGTTCTTC	CASSSSGTSYNEQFF	TRBV11-2	TRBJ2-1
TGTGCCAGCAGTGACACGGGGGCGTGGCCGACCCAGTACTTC	CASSDTGAWPTQYF	TRBV6-4	TRBJ2-5
TGCGCCAGCAGTGTCCCTGACGCAAGCTACGAGCAGTACTTC	CASSVPDASYEQYF	TRBV10-1	TRBJ2-7
TGTGCCAGCAGCTTAGAACCTAGCGGCGTTAGGGATGAGCAGTTCTTC	CASSLEPSGVRDEQFF	TRBV7-9	TRBJ2-1
TGTGCCAGCAGAGGGAACTACGAGCAGTACTTC	CASRGNYEQYF	TRBV27	TRBJ2-7
TGTGCCAGCAGCAGTTCCCGGTTGTGGACAGGAATCGGCTACACCTTC	CASSSSRLWTGIGYTF	TRBV9	TRBJ1-2
TGTGCCAGCGGGACCCGACGCTCCTACAATGAGCAGTTCTTC	CASGTRRSYNEQFF	TRBV27	TRBJ2-1
TGTGCCAGTAGTATCAGACACACTGAAGCTTTCTTT	CASSIRHTEAFF	TRBV19	TRBJ1-1
TGTGCCAGCAGCACGGGGGGGCCCAATGAGCAGTTCTTC	CASSTGGPNEQFF	TRBV7-8	TRBJ2-1
TGCGCCAGCAGCTTGGGGCCCCCGGACACCGGGGAGCTGTTTTTT	CASSLGPPDTGELFF	TRBV5-1	TRBJ2-2
TGTGCCAGCAGTGCCGTAGGGGGCCTTGCGCAGTACTCCTACGAGCAGTACTTC	CASSAVGGLAQYSYEQYF	TRBV6-4	TRBJ2-7
TGTGCCAGCTCACCACAGCAGGAACGCTATGGCTACACCTTC	CASSPQQERYGYTF	TRBV18	TRBJ1-2
TGTGCCACCAGCAGAGGGGGGCACTGGACCGGGGAGCTGTTTTTT	CATSRGGHWTGELFF	TRBV15	TRBJ2-2
TGTGCCAGCAGTTCCCCCCGCTGGAGTCCTCTGGAGCTGTTTTTT	CASSSPRWSPLELFF	TRBV2	TRBJ2-2
TGTGCCAGCAGCTTAGGGACAGACCGCAATCAGCCCCAGCATTTT	CASSLGTDRNQPQHF	TRBV7-9	TRBJ1-5
TGTGCCAGCAGCAATAGAGGGGGGCTCGCGGCTTTCTTT	CASSNRGGLAAFF	TRBV9	TRBJ1-1
TGTGCCACCAGCAGCTCTGGGGCCAACGTCCTGACTTTC	CATSSSGANVLTF	TRBV24-1	TRBJ2-6
TGTGCCAGCAGCCTCTACACGGAGCAGTTCTTC	CASSLYTEQFF	TRBV7-3	TRBJ2-1
TGTGCCAGCAGTTACGGGAGGGACCTTTTAGCCAAAAACATTCAGTACTTC	CASSYGRDLLAKNIQYF	TRBV6-2	TRBJ2-4
TGCGCCAGCAGCCAAGATGGACAGGGCAACGGGTGGTGGCCGTTGAAATACGAGCAGTACTTC	CASSQDGQGNGWWPLKYEQYF	TRBV4-1	TRBJ2-7
TGTGCCAGCAGTTATTTTCCTGGACTAGCGGCGGGGGAAGAGACCCAGTACTTC	CASSYFPGLAAGEETQYF	TRBV6-6	TRBJ2-5
TGTGCTAGTGGTTCCAGGGCCCTAGGCTACACCTTC	CASGSRALGYTF	TRBV12-5	TRBJ1-2
TGTGCCAGCAGCTCGACAGGGTCTTGTACCTACAATGAGCAGTTCTTC	CASSSTGSCTYNEQFF	TRBV5-4	TRBJ2-1
TGTGCCAGCAGTTGGCATAGAGAGGGCCGACTCTTC	CASSWHREGRLF	TRBV27	TRBJ2-1
TGTGCCAGCAGCCCCCGGGGGCGGGGATCACCCCTCCACTTT	CASSPRGRGSPLHF	TRBV7-9	TRBJ1-6
TGTGCCAGCAGCGAGGGCTATAATTCACCCCTCCACTTT	CASSEGYNSPLHF	TRBV9	TRBJ1-6
TGTGCCAGCAGCCGGGTGCCCCCGCAGGGGAACCGGAAGCCGTACGAGCAGTACTTC	CASSRVPPQGNRKPYEQYF	TRBV13	TRBJ2-7
TGTGCCAGCAGCGACGAGGGCCCCTACGAGCAGTACTTC	CASSDEGPYEQYF	TRBV13	TRBJ2-7
TGTGCCACCGACTACGAGCAGTACTTC	CATDYEQYF	TRBV11-2	TRBJ2-7
TGTGCTAGTGGTTCGCCCGACCTTCATTCACCCCTCCACTTT	CASGSPDLHSPLHF	TRBV12-5	TRBJ1-6
TGTGCACCAATCTCGATCCACGGGAATCAGCCCCAGCATTTT	CAPISIHGNQPQHF	TRBV6-5	TRBJ1-5
TGCGCCAGCAGCCAAGCCTTTGTCGTAGTGCGGAGTGGCTACACCTTC	CASSQAFVVVRSGYTF	TRBV4-3	TRBJ1-2
TGTGCCAGCAGACGGGGTGGGGGGCACCAGAGGAAACCTGAAAAACTGTTTTTT	CASRRGGGHQRKPEKLFF	TRBV6-5	TRBJ1-4
TGTGCCAGCAGCACAGGGGACTTCCTTGGCTACACCTTC	CASSTGDFLGYTF	TRBV9	TRBJ1-2
TGTGCCAGCAGCGATGATTTCTCTCGTTCCTGCCCCGGGGGTTACAATGAGCAGTTCTTC	CASSDDFSRSCPGGYNEQFF	TRBV7-8	TRBJ2-1
TGTGCCAGCAGCCAACGGGCGCCCTACGAGCAGTACTTC	CASSQRAPYEQYF	TRBV9	TRBJ2-7
TGTGCCAGCAGTGACCCAGCGGGAGATGGCGAGACCCAGTACTTC	CASSDPAGDGETQYF	TRBV2	TRBJ2-5
TGTGCCGATACGTGGGGGGAAGACAATGAGCAGTTCTTC	CADTWGEDNEQFF	TRBV27	TRBJ2-1
TGTGCCTGGACTTGCTTCCACAGAGCTAAAGATACGCAGTATTTT	CAWTCFHRAKDTQYF	TRBV30	TRBJ2-3
TGCAGTGCTTTTGCGTGCGTAGAGACCCAGTACTTC	CSAFACVETQYF	TRBV20-1	TRBJ2-5
TGTGCCAGCAGCCACGAGACAGGGCGGAACACTGAAGCTTTCTTT	CASSHETGRNTEAFF	TRBV14	TRBJ1-1
TGCAGTGCTAGGGGTCGCACGACAGCACGTTCACCCCTCCACTTT	CSARGRTTARSPLHF	TRBV20-1	TRBJ1-6
TGTGCCAGCAGCAACCACACAGGGGTATGTGGGAACACTGAAGCTTTCTTT	CASSNHTGVCGNTEAFF	TRBV13	TRBJ1-1
TGTGCCAGCAGCCCGAAATGGGACTACGAGCAGTACTTC	CASSPKWDYEQYF	TRBV7-8	TRBJ2-7
TGCAGTGCTAGTCCGGTAGCATATGGCTACACCTTC	CSASPVAYGYTF	TRBV20-1	TRBJ1-2
TGTGCCAGTAGGTCTTGGGACAGGGGGTATAGGACCTACGAGCAGTACTTC	CASRSWDRGYRTYEQYF	TRBV19	TRBJ2-7
TGTGCCAGCAGTGGGAGGGGAGCAAACACCGGGGAGCTGTTTTTT	CASSGRGANTGELFF	TRBV6-4	TRBJ2-2
TGTGCCAGCAAAAAGACTAGCGGGAGATACACTGAAGCTTTCTTT	CASKKTSGRYTEAFF	TRBV6-4	TRBJ1-1
TGCGCCAGCAGCTTGGGGGGGCACTACGAGCAGTACTTC	CASSLGGHYEQYF	TRBV5-1	TRBJ2-7
TGTGCCAGCAGCTTGGGCCAGGCCACGATCAGGGCAGGCTCTTCACCCCTCCACTTT	CASSLGQATIRAGSSPLHF	TRBV5-8	TRBJ1-6
TGTGCCAGTAGTATAGCAGTTTTCCCGACAGGTGGGAATGGCTACACCTTC	CASSIAVFPTGGNGYTF	TRBV19	TRBJ1-2
TGTGCCAGAAGGGACCACTATGGCTACACCTTC	CARRDHYGYTF	TRBV9	TRBJ1-2
TGTGCCAATCGGTCTATTGGGGATTCCTACGAGCAGTACTTC	CANRSIGDSYEQYF	TRBV7-8	TRBJ2-7
TGCAGTGCTAGAGACCAGGAGGACCGACCAGAGACCCAGTACTTC	CSARDQEDRPETQYF	TRBV20-1	TRBJ2-5
TGTGCCAGCAGACTCGGACTAGCCTACGAGCAGTACTTC	CASRLGLAYEQYF	TRBV27	TRBJ2-7
TGTGCCAGCAGCTTAGCCATAAGGCCGGGACAGGGCGACGGAAACACCATATATTTT	CASSLAIRPGQGDGNTIYF	TRBV11-2	TRBJ1-3
TGTGCCAGCAGCGCCGCGAGGACTAGCGGCTACGAGCAGTACTTC	CASSAARTSGYEQYF	TRBV11-2	TRBJ2-7
TGTGCCACCAACAGGGGAGGCAATCAGCCCCAGCATTTT	CATNRGGNQPQHF	TRBV24-1	TRBJ1-5
TGTGCCAGCAGCGCCACCCCCGGACCCTGTCAGCCCCAGCATTTT	CASSATPGPCQPQHF	TRBV7-8	TRBJ1-5
TGTGCCAGCAGTTCCTACTCACCCGGGGCCTCCCCACACGAGCAGTACTTC	CASSSYSPGASPHEQYF	TRBV12-3	TRBJ2-7
TGTGCCAGCAGCCAAGTACCTCCCGGGACTAGCGGGAGCTGCGGTTTTGATACGCAGTATTTT	CASSQVPPGTSGSCGFDTQYF	TRBV13	TRBJ2-3
TGTGCCAGCAGCATTGTAGCGGGCTCCTACGAGCAGTACTTC	CASSIVAGSYEQYF	TRBV7-3	TRBJ2-7
TGCAGTGCTAGAGATTCTAGCAATCAGCCCCAGCATTTT	CSARDSSNQPQHF	TRBV20-1	TRBJ1-5
TGCGCCAGCAGCCAAGCCGTCAGGGAATCTGGGGCCAACGTCCTGACTTTC	CASSQAVRESGANVLTF	TRBV4-1	TRBJ2-6
TGTGGCTTGAGGGTCGGCAAGGGCAATCAGCCCCAGCATTTT	CGLRVGKGNQPQHF	TRBV25-1	TRBJ1-5
TGTGCCAGCAGCGACCTGGACAGGGGCTTGGTATACGAGCAGTACTTC	CASSDLDRGLVYEQYF	TRBV13	TRBJ2-7
TGTGCCAGCAGCTTAAGGGGGCTCGAGCAGTACTTC	CASSLRGLEQYF	TRBV5-5	TRBJ2-7
TGTGCCAGCAGCCAAGATAGCGGGGGCACCACAGATACGCAGTATTTT	CASSQDSGGTTDTQYF	TRBV14	TRBJ2-3
TGCGCCAGCAGTCTAGCGGGCGAGCAGTACTTC	CASSLAGEQYF	TRBV10-1	TRBJ2-7
TGTGCCAGCAGCTTAGTCCCAGCAAAGTTTCGGGGGTCAGTCCGTACAGATACGCAGTATTTT	CASSLVPAKFRGSVRTDTQYF	TRBV7-9	TRBJ2-3
TGTGCCAGCAGCTTGATATTCAAGAAGGACCGATACGAGCAGTACTTC	CASSLIFKKDRYEQYF	TRBV5-4	TRBJ2-7
TGTGCCAGTAGTTCTACCCGGCTCTCTGGAAACACCATATATTTT	CASSSTRLSGNTIYF	TRBV19	TRBJ1-3
TGTGCCCCCGTCCTAGCGGGACCTAGCACAGATACGCAGTATTTT	CAPVLAGPSTDTQYF	TRBV3-1	TRBJ2-3
TGTGCCAGCAGTTTACAGCCCAGGGGTGGATACGAGCAGTACTTC	CASSLQPRGGYEQYF	TRBV28	TRBJ2-7
TGTGCCAGCAGCTTAACCGAACCGGGACAGCTACAGGTTAGGAACACTGAAGCTTTCTTT	CASSLTEPGQLQVRNTEAFF	TRBV7-3	TRBJ1-1
TGTGCCAGCAGCTTAACGGGTAGCCCATCAAACGGACAGGGGACTATGAACACTGAAGCTTTCTTT	CASSLTGSPSNGQGTMNTEAFF	TRBV7-3	TRBJ1-1
