TGTGCCACCAGTGAGAAACGCCGGGACAGGGTGGAGACCCAGTACTTC	CATSEKRRDRVETQYF	TRBV24-1	TRBJ2-5
TGTGCCAGCAGTTACCCGCGGGGAAAGACGGGGTACGAGCAGTACTTC	CASSYPRGKTGYEQYF	TRBV6-3	TRBJ2-7
TGTGCCAGCAGCTTCGGGGACAGGGCCTACGAGCAGTACTTC	CASSFGDRAYEQYF	TRBV7-9	TRBJ2-7
TGCGCCAGCAGCTTGGCCAGGGGGGCCTATGAGCAGTTCTTC	CASSLARGAYEQFF	TRBV5-1	TRBJ2-1
TGTGCCACTGGTGGAGGGATTCTGAATGGCTACACCTTC	CATGGGILNGYTF	TRBV6-4	TRBJ1-2
TGCGCCAGCAGTGAGGAAGGGCAGACTACTTATTATAGCAATCAGCCCCAGCATTTT	CASSEEGQTTYYSNQPQHF	TRBV10-1	TRBJ1-5
TGCAGCGTCGAATCTAGCGGGAGTTCTGAGCAGTTCTTC	CSVESSGSSEQFF	TRBV29-1	TRBJ2-1
TGTGCCAGCAGCAGCTCAGGGCAGCCCCAGCATTTT	CASSSSGQPQHF	TRBV13	TRBJ1-5
TGTGCCAGCAGCCCGGCCGGGACAGGGGAGCAGTACTTC	CASSPAGTGEQYF	TRBV7-3	TRBJ2-7
TGCAGTGCTGGTACTCCACCTCCAGCAAAGGGAAACCAGTACTTC	CSAGTPPPAKGNQYF	TRBV20-1	TRBJ2-5
TGTGCCATCAGTGAGTCAGGTGGGCGCTCCTACAATGAGCAGTTCTTC	CAISESGGRSYNEQFF	TRBV10-3	TRBJ2-1
TGCAGCGTCCTTAGTAGGGGCTGGATCTATGGCTACACCTTC	CSVLSRGWIYGYTF	TRBV29-1	TRBJ1-2
TGTGCCAGCAGGGACAGGGTATACGAGCAGTACTTC	CASRDRVYEQYF	TRBV12-4	TRBJ2-7
TGCAGTGCACTAACTGAAAGTCCTAAACACAATGAGCAGTTCTTC	CSALTESPKHNEQFF	TRBV20-1	TRBJ2-1
TGTGCCAGCAGCAGACAGGGGGGTGCCCAAGAGACCCAGTACTTC	CASSRQGGAQETQYF	TRBV7-2	TRBJ2-5
TGTGCCAGCAGCGATAACAGACAGGGTAATGAAAAACTGTTTTTT	CASSDNRQGNEKLFF	TRBV6-2	TRBJ1-4
TGTGCCAGCAGCCATATAGACAGGTCCTATAATTCACCCCTCCACTTT	CASSHIDRSYNSPLHF	TRBV5-5	TRBJ1-6
TGCAGTGCTAGTACGTTACCCATTAACACTGAAGCTTTCTTT	CSASTLPINTEAFF	TRBV20-1	TRBJ1-1
TGTGCCAGCAGTTCCTACCTCACGGGTGCTTCCTCCTACGAGCAGTACTTC	CASSSYLTGASSYEQYF	TRBV28	TRBJ2-7
TGCAGTCCGGGGACTAGACCTAGGGAAGGGGATGAGCAGTTCTTC	CSPGTRPREGDEQFF	TRBV20-1	TRBJ2-1
TGTGCCAGCAGCGTAATAGGGACGGGGCTCTTCTCCTCCTACAATGAGCAGTTCTTC	CASSVIGTGLFSSYNEQFF	TRBV9	TRBJ2-1
TGTGCCAGCAGTGGCGTCGATTTGCTGCACCTCCTGGCTTTCTTT	CASSGVDLLHLLAFF	TRBV28	TRBJ1-1
TGTGCCAGCAAACTAGCGGGAGGGGGACAAGGAGCCACTGAAGCTTTCTTT	CASKLAGGGQGATEAFF	TRBV25-1	TRBJ1-1
TGTGCCACCAGTGGAATGTCAGGGGGCTGGTATAGCAATCAGCCCCAGCATTTT	CATSGMSGGWYSNQPQHF	TRBV24-1	TRBJ1-5
TGTGCCAGCAGTGAGACGAGTGACAACATTATAGCCAAAAACATTCAGTACTTC	CASSETSDNIIAKNIQYF	TRBV6-4	TRBJ2-4
TGTGCCAGCAGCTTAGCGACTCTGGGGAGAGAGACCCAGTACTTC	CASSLATLGRETQYF	TRBV7-4	TRBJ2-5
TGTGCCAGCAGCCAAGATAAACCCAAAAAATCCGATTCTTATCAGCCCCAGCATTTT	CASSQDKPKKSDSYQPQHF	TRBV4-2	TRBJ1-5
TGTGCCAGCAGTTTCCCTATCTTCCAAGAGACCCAGTACTTC	CASSFPIFQETQYF	TRBV28	TRBJ2-5
TGTGCCAGCAGAGGGGGAGACCGGGAAAAACTGTTTTTT	CASRGGDREKLFF	TRBV12-4	TRBJ1-4
TGCACACTATTTCAGCGGGATCTGCAAGAGACCCAGTACTTC	CTLFQRDLQETQYF	TRBV20-1	TRBJ2-5
TGTGCCAGCAGCAAGTTGACTAGTACACTGAATGAGCAGTTCTTC	CASSKLTSTLNEQFF	TRBV5-4	TRBJ2-1
TGCGCCAGCAAAGGTCCATGGGACTACAATGAGCAGTTCTTC	CASKGPWDYNEQFF	TRBV10-1	TRBJ2-1
TGTGCCAGCAGTGACGCGGTTCGCGAGACCCAGTACTTC	CASSDAVRETQYF	TRBV6-4	TRBJ2-5
TGTGCCAGGCAGGGGCTGAACACTGAAGCTTTCTTT	CARQGLNTEAFF	TRBV28	TRBJ1-1
TGTGAAGGGGAGGGGCCACGCTCCTACGAGCAGTACTTC	CEGEGPRSYEQYF	TRBV4-2	TRBJ2-7
TGTGCCAGCAGCTTCACAGGGGGCCAAATGAACACTGAAGCTTTCTTT	CASSFTGGQMNTEAFF	TRBV13	TRBJ1-1
TGTGCCAGCAGGGGTCTGAACTATGGCTACACCTTC	CASRGLNYGYTF	TRBV27	TRBJ1-2
TGCGCCAGCAGCCGGTCCAGGGCAAACATTCAGTACTTC	CASSRSRANIQYF	TRBV5-1	TRBJ2-4
TGTGCCATCACCCCGGGACTAGCGGGAGTCTACGAGCAGTACTTC	CAITPGLAGVYEQYF	TRBV19	TRBJ2-7
TGTGCCAGCAGTCACCCCGGTAACGGGACAGGGGACGAGCAGTACTTC	CASSHPGNGTGDEQYF	TRBV12-3	TRBJ2-7
TGTGCCAGCAGTATCAGGGGTGGCTACACCTTC	CASSIRGGYTF	TRBV27	TRBJ1-2
TGTGCCAGCAGCGGGAGAGGGGATGGCTACACCTTC	CASSGRGDGYTF	TRBV28	TRBJ1-2
TGTGCCAGCAGTGACTGGACTAGATACAATGAGCAGTTCTTC	CASSDWTRYNEQFF	TRBV6-4	TRBJ2-1
TGTGCCAGCAGGGCACCCCCTGAAGCTTTCTTT	CASRAPPEAFF	TRBV5-4	TRBJ1-1
TGTGCCACCAGCAGCCCAGGGAATAGCGGGGCAAACATTCAGTACTTC	CATSSPGNSGANIQYF	TRBV15	TRBJ2-4
TGTGCCAGCAGTGAATGGAGGGGGGGTTTCAATGAGCAGTTCTTC	CASSEWRGGFNEQFF	TRBV6-1	TRBJ2-1
TGTGCCAGCAAACTGAGGGTCTACCTTAGCGAGACCCAGTACTTC	CASKLRVYLSETQYF	TRBV9	TRBJ2-5
TGCGCCAGCAGCTTGACTAGCGGGATGGAGACCCAGTACTTC	CASSLTSGMETQYF	TRBV5-1	TRBJ2-5
TGTGCCAGCAGTAACGGGACACCCGGCGGTGAGCAGTTCTTC	CASSNGTPGGEQFF	TRBV27	TRBJ2-1
TGTGCCAGCAGAGGAGGGACAGGGGGCTCTAAGGAAAAACTGTTTTTT	CASRGGTGGSKEKLFF	TRBV28	TRBJ1-4
TGTGCCAGCAGTGCCATACTAGATACGCAGTATTTT	CASSAILDTQYF	TRBV25-1	TRBJ2-3
TGTGCCAGCAGCTTGGGGGAGACAGAATATGAGCAGTTCTTC	CASSLGETEYEQFF	TRBV5-4	TRBJ2-1
TGTGCCAGCAGGACCAGGGGGTACACCATATATTTT	CASRTRGYTIYF	TRBV2	TRBJ1-3
TGTGCCACGGGACAGGGGGAGGGAGCCTATGGCTACACCTTC	CATGQGEGAYGYTF	TRBV6-4	TRBJ1-2
TGTGCCATCAGTGAGTCGACGCCGGACAGGGATGGCTACACCTTC	CAISESTPDRDGYTF	TRBV10-3	TRBJ1-2
TGTGCCAGTGGGGGACGGGACCTGCCTGAAGCTTTCTTT	CASGGRDLPEAFF	TRBV27	TRBJ1-1
TGTGCCAGCAGCTCTCAGGTACGTAAGAACACTGAAGCTTTCTTT	CASSSQVRKNTEAFF	TRBV7-4	TRBJ1-1
TGTGCCAGCAGCTTAGCAATAGGGAATCAGCCCCAGCATTTT	CASSLAIGNQPQHF	TRBV7-9	TRBJ1-5
TGCGCCAGCAGCCCCCCGGGGGGTCGGAGATACAATGAGCAGTTCTTC	CASSPPGGRRYNEQFF	TRBV4-3	TRBJ2-1
TGTGCCAGCAGCGTACCTCCAGTGGAGCCCCAGCATTTT	CASSVPPVEPQHF	TRBV9	TRBJ1-5
TGTGCCAGTAGTATTCAGGGGAAGGGGAGGGGCTATGGCTACACCTTC	CASSIQGKGRGYGYTF	TRBV19	TRBJ1-2
TGTGCCAGCAGTCGTGGGGACCTAGCCAAAAACATTCAGTACTTC	CASSRGDLAKNIQYF	TRBV27	TRBJ2-4
TGTGCCAGCAGCTTAAACGGGAGAAACGGGGAGCTGTTTTTT	CASSLNGRNGELFF	TRBV7-2	TRBJ2-2
TGTGCCAGCAGTTTACGGGGGACTAGCGGTGGGTGGAACATTCAGTACTTC	CASSLRGTSGGWNIQYF	TRBV27	TRBJ2-4
TGTGCCTGGAGCCACGGTGTCAAGGAGCAGTACTTC	CAWSHGVKEQYF	TRBV30	TRBJ2-7
TGCGCCAGCAGCCACCCCAAGGGGGGGGGGGTCTATGGCTACACCTTC	CASSHPKGGGVYGYTF	TRBV4-1	TRBJ1-2
TGTGCCAGCAGCGAAGGGCACCGCTACGAGCAGTACTTC	CASSEGHRYEQYF	TRBV7-9	TRBJ2-7
TGTGCCAGCAGTAGGACTACAACTAGCAATCAGCCCCAGCATTTT	CASSRTTTSNQPQHF	TRBV7-3	TRBJ1-5
TGTGCCACCAGTGATTTCCCTAGTCTAACGGGGGGTCACTCCTACGAGCAGTACTTC	CATSDFPSLTGGHSYEQYF	TRBV24-1	TRBJ2-7
TGCGCCAGCAGCCAAGTCACCGGGACAGGGGGGAATCAGCCCCAGCATTTT	CASSQVTGTGGNQPQHF	TRBV4-3	TRBJ1-5
TGTGCCAGCAGCTTAGCAGGCTCAGGGGTCCCCAATTCACCCCTCCACTTT	CASSLAGSGVPNSPLHF	TRBV7-2	TRBJ1-6
TGTGCCAGCAGGGCAGCCGAACATTACGAGCAGTACTTC	CASRAAEHYEQYF	TRBV12-3	TRBJ2-7
TGTGCCACCAGTGATCCCTCTGGGGGGGGGAACACAGATACGCAGTATTTT	CATSDPSGGGNTDTQYF	TRBV24-1	TRBJ2-3
TGTGCCAGCATTTGGCCGACAGGGTGGGCCAACGTCCTGACTTTC	CASIWPTGWANVLTF	TRBV28	TRBJ2-6
TGTGCACAGGACACTGAAGCTTTCTTT	CAQDTEAFF	TRBV6-2	TRBJ1-1
TGTGCCAGCAGCCAAGACCCGTATCAGGGGCAAGAGCAGTACTTC	CASSQDPYQGQEQYF	TRBV4-2	TRBJ2-7
TGTGCCAACCACCCCGGGTCCCGTAGGGGAGGAGCTTATGGAGGGGAGACCCAGTACTTC	CANHPGSRRGGAYGGETQYF	TRBV19	TRBJ2-5
TGTGCCAGCACCTCCCTGCAGCGGCTGAGGACAGGCCCTGCGGGACACACTGAAGCTTTCTTT	CASTSLQRLRTGPAGHTEAFF	TRBV6-6	TRBJ1-1
TGTGCCAGCAGTTTGGAGCGGGATCTTCGTGAGCAGTTCTTC	CASSLERDLREQFF	TRBV12-3	TRBJ2-1
TGTGCCAGCAGCTCAGCGGGGTACAATGAGCAGTTCTTC	CASSSAGYNEQFF	TRBV13	TRBJ2-1
TGTGCCAGCAGTCAGGGGGTACTCAAGCTCAGCAATCAGCCCCAGCATTTT	CASSQGVLKLSNQPQHF	TRBV6-1	TRBJ1-5
TGTGCCAGCAGCGGCCAGTGGACAAATGAAAAACTGTTTTTT	CASSGQWTNEKLFF	TRBV5-4	TRBJ1-4
TGTGCCAGCGCTGGGACTAGCGGGCGGCTGCAGTTCTTC	CASAGTSGRLQFF	TRBV28	TRBJ2-1
TGTGCCATCAGTGACGGAACCGGGGACGAGCAGTACTTC	CAISDGTGDEQYF	TRBV10-3	TRBJ2-7
TGTGCCAGCAGTTCAGTGACCGGGACAGGGGCAACTGGGGCCAACGTCCTGACTTTC	CASSSVTGTGATGANVLTF	TRBV6-9	TRBJ2-6
TGTGCTAGTGGTTTGGTACATAGGGGAACCGGGACCCCTAACTACGAGCAGTACTTC	CASGLVHRGTGTPNYEQYF	TRBV12-5	TRBJ2-7
TGCGCCAGCAGTCCTAGTCCGCAGGGTCACGGGGGGGTAGATACGCAGTATTTT	CASSPSPQGHGGVDTQYF	TRBV10-1	TRBJ2-3
TGTGCCAGCAGCTTGGCCAAATGGACGGATGAGGTAAACATTCAGTACTTC	CASSLAKWTDEVNIQYF	TRBV5-4	TRBJ2-4
TGTGCCAGTAGTATCAAAGGGGGAAGCTCCTACGAGCAGTACTTC	CASSIKGGSSYEQYF	TRBV19	TRBJ2-7
TGTGCCAGCAGCGGGGATATGAACACTGAAGCTTTCTTT	CASSGDMNTEAFF	TRBV7-2	TRBJ1-1
TGTGCCAGCATACTTGAAAGGACAGTAGGTGGCTACACCTTC	CASILERTVGGYTF	TRBV27	TRBJ1-2
TGTGCCAGCAGCGGACCCGACCCTCCGGGGGCCACAGATACGCAGTATTTT	CASSGPDPPGATDTQYF	TRBV7-9	TRBJ2-3
TGTGCCAGCAGTTTATGCTCGGCCTCGGGCTACCCGGGGGGTTTCCCGCCCGGGGAGCTGTTTTTT	CASSLCSASGYPGGFPPGELFF	TRBV28	TRBJ2-2
TGCGCCAGCAGCTTGGATGGGCCGGCCGATACGCAGTATTTT	CASSLDGPADTQYF	TRBV5-1	TRBJ2-3
TGTGCCAGCAGCTGCCCCCTAAACTGGGGCGAGCAGTACTTC	CASSCPLNWGEQYF	TRBV5-5	TRBJ2-7
TGTGCCAGCAGCGGACCTATCCGGATCATCGCGAACACCGGGGAGCTGTTTTTT	CASSGPIRIIANTGELFF	TRBV7-3	TRBJ2-2
TGTGCCAGCAGAGATTGGGCGACAGATACGCAGTATTTT	CASRDWATDTQYF	TRBV6-6	TRBJ2-3
TGTGCCAGCAGTGGGTACCGACCACCTGAGACCCAGTACTTC	CASSGYRPPETQYF	TRBV27	TRBJ2-5
TGCAGTGCAATACTAGATAGTGGACACGAGCAGTACTTC	CSAILDSGHEQYF	TRBV20-1	TRBJ2-7
TGTGCCACAGGCTCTCCCCCGCGTTGCGAGCAGTACTTC	CATGSPPRCEQYF	TRBV12-3	TRBJ2-7
