TGTGCCAGCAGCGGGGGTATGGGGGAGGGGGAAGCTTTCTTT	CASSGGMGEGEAFF	TRBV7-2	TRBJ1-1
TGTGCCAGCAGTGACTCTCCTTTGGGTCGGGGGAAGCCCCAGCATTTT	CASSDSPLGRGKPQHF	TRBV6-4	TRBJ1-5
TGTGCCAGCAGCATCCCACCGGGGAACACCGGGGAGCTGTTTTTT	CASSIPPGNTGELFF	TRBV11-3	TRBJ2-2
TGCAGTGCGTTCCCTAGATTGAACACTGAAGCTTTCTTT	CSAFPRLNTEAFF	TRBV20-1	TRBJ1-1
TGTGCCCTGTCGTTCTTT	CALSFF	TRBV30	TRBJ1-1
TGTGCCAGCAGCAAAGGACCTGGGGGGGCCTCCTACGAGCAGTACTTC	CASSKGPGGASYEQYF	TRBV9	TRBJ2-7
TGCGCCAGCAGCCATCCACGCAATGAGCAGTTCTTC	CASSHPRNEQFF	TRBV4-3	TRBJ2-1
TGTGCCAGCAGCTTAGTCCCGAGGTTAGAGACCCAGTACTTC	CASSLVPRLETQYF	TRBV7-6	TRBJ2-5
TGTGCCAGCAGTCGGTCAGGGGTACCCTTC	CASSRSGVPF	TRBV28	TRBJ1-2
TGTGCCAGCAGCTTAGGCCTGTGCACAGATACGCAGTATTTT	CASSLGLCTDTQYF	TRBV11-2	TRBJ2-3
TGTGCCAGCAGTTACGGACTTGTCTACGAGCAGTACTTC	CASSYGLVYEQYF	TRBV6-5	TRBJ2-7
TGTGCCAGCAGCGTCCATGGGGGGGGCAATGAGCAGTTCTTC	CASSVHGGGNEQFF	TRBV7-9	TRBJ2-1
TGTGCCAGCAGGTATCAGACTAGCGGGAGGGCCCGGGGAATCAATGAGCAGTTCTTC	CASRYQTSGRARGINEQFF	TRBV5-6	TRBJ2-1
TGTGCCAGCTCACCACATTCACCAAGCCGGGACACACCTGCTAATGAAAAACTGTTTTTT	CASSPHSPSRDTPANEKLFF	TRBV18	TRBJ1-4
TGTGCCAGCAGCCTCCAGGGAAGGAACACTGAAGCTTTCTTT	CASSLQGRNTEAFF	TRBV3-1	TRBJ1-1
TGTGCCAGCAGTTATCTTCCTGGACATGTGTTCTCCTATAATTCACCCCTCCACTTT	CASSYLPGHVFSYNSPLHF	TRBV6-2	TRBJ1-6
TGTGCCACCAGTGCTAAGAGTCGTCAGCCCCAGCATTTT	CATSAKSRQPQHF	TRBV24-1	TRBJ1-5
TGTGCCAGCAGCTTAGGTCAGACAGGGGAAAATAATTCACCCCTCCACTTT	CASSLGQTGENNSPLHF	TRBV7-9	TRBJ1-6
TGTGCCAGCAGCTTAACGCCGGACTGCCGTGGCCAAGAGACCCAGTACTTC	CASSLTPDCRGQETQYF	TRBV7-3	TRBJ2-5
TGTGCCAGCAGCTTGGCGGGGCGCTTGAGCTCCTACGAGCAGTACTTC	CASSLAGRLSSYEQYF	TRBV5-6	TRBJ2-7
TGTGCCAGCAGCAGCAGGGGCGAGCAGTACTTC	CASSSRGEQYF	TRBV7-3	TRBJ2-7
TGCAGTGCTGGGGACAGGGAAGGGAAAGCTTTCTTT	CSAGDREGKAFF	TRBV20-1	TRBJ1-1
TGTGCCAGCAGTCGGACTAGCGGGTACAATGAGCAGTTCTTC	CASSRTSGYNEQFF	TRBV6-5	TRBJ2-1
TGTGCCAGCGGTCGCGTCTGCAAAAAGCGAGGTAGCACAGATACGCAGTATTTT	CASGRVCKKRGSTDTQYF	TRBV7-3	TRBJ2-3
TGTGCCAGCAGCATAGCGAGAAGCAATCAGCCCCAGCATTTT	CASSIARSNQPQHF	TRBV7-8	TRBJ1-5
TGTGCCAGCAGTTTGCCCCCAGCCGGGACTAGGTCAGATACGCAGTATTTT	CASSLPPAGTRSDTQYF	TRBV12-3	TRBJ2-3
TGTGCCAGCAGTGCTAGCGGGAGCACAGATACGCAGTATTTT	CASSASGSTDTQYF	TRBV6-1	TRBJ2-3
TGCAGTGACCCAATCAGGAGGGATCAGCCCCAGCATTTT	CSDPIRRDQPQHF	TRBV20-1	TRBJ1-5
TGTGCCAGCAGTGAAGGAAGGGGACAGGGGTGGGTGTCCGGGGAGCTGTTTTTT	CASSEGRGQGWVSGELFF	TRBV6-1	TRBJ2-2
TGTGCCAGCAGACCTCCCCATGGGTCGTACGAGCAGTACTTC	CASRPPHGSYEQYF	TRBV6-1	TRBJ2-7
TGTGCCAGCAGCTCCCCTATCCGCGGGAGGGAAGAGACCCAGTACTTC	CASSSPIRGREETQYF	TRBV11-3	TRBJ2-5
TGTGCCAGCCCCGGGGGGGGGTACAATGAGCAGTTCTTC	CASPGGGYNEQFF	TRBV6-5	TRBJ2-1
TGCGCCAGCATAGGACCCAGCCTAGACTACGAGCAGTACTTC	CASIGPSLDYEQYF	TRBV10-2	TRBJ2-7
TGTGCCAGCAGCTTGAGGACAGGGCCGCTCCGGGGCGAAGCTTTCTTT	CASSLRTGPLRGEAFF	TRBV5-5	TRBJ1-1
TGTGCCAGCAGCGATTTGGGTAGCAATCAGCCCCAGCATTTT	CASSDLGSNQPQHF	TRBV7-9	TRBJ1-5
TGTGCCAGCAGCCCGAGGACAGGGGGGCCAAATTCACCCCTCCACTTT	CASSPRTGGPNSPLHF	TRBV13	TRBJ1-6
TGTGCCAGCAGACCGGAGGGGGGGACGTACGAGCAGTACTTC	CASRPEGGTYEQYF	TRBV5-6	TRBJ2-7
TGTGCCAGCAGCTGTGCCCTTTGCGGGGAGAGCAATCAGCCCCAGCATTTT	CASSCALCGESNQPQHF	TRBV7-9	TRBJ1-5
TGTGCCAGCAGGCGATCGGGACAGATCACCGGGGAGCTGTTTTTT	CASRRSGQITGELFF	TRBV6-1	TRBJ2-2
TGCAGTGCTAGAGGAATGGCAGACAGCGGGGCTGAAGCTTTCTTT	CSARGMADSGAEAFF	TRBV20-1	TRBJ1-1
TGTGCCAGCAGTGCAGGGGTTGAAATGGCAGCTAACTATGGCTACACCTTC	CASSAGVEMAANYGYTF	TRBV6-5	TRBJ1-2
TGTGCCAGCAGTGAATTGCTAAGGGGGAACACCGGGGAGCTGTTTTTT	CASSELLRGNTGELFF	TRBV25-1	TRBJ2-2
TGCGCCAGCAGCCAAGATGGGGGGGAGGGCACCGGGGAGCTGTTTTTT	CASSQDGGEGTGELFF	TRBV4-3	TRBJ2-2
TGTGCCTGGAGTGTGATTCTTGGGACAGGGCGGAACCGTGAAGCTTTCTTT	CAWSVILGTGRNREAFF	TRBV30	TRBJ1-1
TGTGCCAGTAGTATAGATTTGGGAAGCTATGGCTACACCTTC	CASSIDLGSYGYTF	TRBV19	TRBJ1-2
TGTGCCAGCAGTTACATCCCTCGACAGGGGGGAGCTGGGGCCAACGTCCTGACTTTC	CASSYIPRQGGAGANVLTF	TRBV6-3	TRBJ2-6
TGTGCCAGCAGCTTCTCTAACCGGGAGGGAGTCTGCCTTAATGAGCAGTTCTTC	CASSFSNREGVCLNEQFF	TRBV7-2	TRBJ2-1
TGCGCCAGCAAGGACAGGGGGCGCTACGAGCAGTACTTC	CASKDRGRYEQYF	TRBV5-1	TRBJ2-7
TGTGCCACCTCGGGACAGGGGAGGAGTAACTATGGCTACACCTTC	CATSGQGRSNYGYTF	TRBV2	TRBJ1-2
TGCAGTGCTGGCCCACGGGGCTACACCTTC	CSAGPRGYTF	TRBV20-1	TRBJ1-2
TGTGCCAGCGTTATACGGTCGAACACCGGGGAGCTGTTTTTT	CASVIRSNTGELFF	TRBV7-3	TRBJ2-2
TGCAGTGCTAGACAGGGGATAGACTACGAGCAGTACTTC	CSARQGIDYEQYF	TRBV20-1	TRBJ2-7
TGTGCCAGCAGTAAGAAGACAGGAGGGGACGCCTACGAGCAGTACTTC	CASSKKTGGDAYEQYF	TRBV27	TRBJ2-7
TGTGCCAGCAGGAGGAGGGAGAAGGGGGCGGAGGGTGGCTATGGCTACACCTTC	CASRRREKGAEGGYGYTF	TRBV7-9	TRBJ1-2
TGTGCCAGCAGCTTGTGGCGGGGGGGCGAAGAGACCCAGTACTTC	CASSLWRGGEETQYF	TRBV5-5	TRBJ2-5
TGTGCCAGCAGCAGGACGGACACCTTC	CASSRTDTF	TRBV6-5	TRBJ1-2
TGTGCCAGCAGTTGTTCCACCGGACACAGGGGAGTCTCCTACGAGCAGTACTTC	CASSCSTGHRGVSYEQYF	TRBV6-5	TRBJ2-7
TGTGCCAGCAGCTCCGGGAAGAGGACAGAGACCCAGTACTTC	CASSSGKRTETQYF	TRBV7-4	TRBJ2-5
TGTGCCAGCAGTTCGTGCGAGGACAGGCTCCCGAACACTGAAGCTTTCTTT	CASSSCEDRLPNTEAFF	TRBV12-4	TRBJ1-1
TGTGCCAGCAGTTTAGAAGGTGGTTTTACAGGGCTGATGAACACTGAAGCTTTCTTT	CASSLEGGFTGLMNTEAFF	TRBV12-3	TRBJ1-1
TGTGCCAGCAGCTTCTATGCAGGGGGTAGGAGGACTGGCTACACCTTC	CASSFYAGGRRTGYTF	TRBV7-9	TRBJ1-2
TGTGCCAGCAGTGCCGTTCCAGGGGGCGCAGTAAATCAGCCCCAGCATTTT	CASSAVPGGAVNQPQHF	TRBV2	TRBJ1-5
TGTGCCAGCAGGGTTTTTGGGACAGATGAGAGAGCCTACGAGCAGTACTTC	CASRVFGTDERAYEQYF	TRBV6-5	TRBJ2-7
TGTGCCAGCAGCGAATATGTACAGGAGCAGTACTTC	CASSEYVQEQYF	TRBV13	TRBJ2-7
TGCAGTGCTAGAGGGGGACAGCGTTACACTGAAGCTTTCTTT	CSARGGQRYTEAFF	TRBV20-1	TRBJ1-1
TGTGCCAGCAGCTCTGACGTACCCTCTGAAGCTTTCTTT	CASSSDVPSEAFF	TRBV5-6	TRBJ1-1
TGTGCCAGCAGTGAAGGGGGAACGGGTACTAGCACAGATACGCAGTATTTT	CASSEGGTGTSTDTQYF	TRBV2	TRBJ2-3
TGCAGTGGCAGGCCTAACTATGGCTACACCTTC	CSGRPNYGYTF	TRBV20-1	TRBJ1-2
TGTGCCAGTAAAAAGGTAGGCTACGAGCAGTACTTC	CASKKVGYEQYF	TRBV19	TRBJ2-7
TGTGCCAGGGACCCGGGGGAGAGTTCTAATGAGCAGTACTTC	CARDPGESSNEQYF	TRBV25-1	TRBJ2-7
TGTGCCAGCAGCTATGAGGGCGTCTACAATGAGCAGTTCTTC	CASSYEGVYNEQFF	TRBV7-2	TRBJ2-1
TGCGCCAGCAGCCAAGAGCACCCGGGGGCCGGACCTACTGAAGCTTTCTTT	CASSQEHPGAGPTEAFF	TRBV4-1	TRBJ1-1
TGTGCCAGCAGCTTGAGAGGACAGGGGATCCGATTCGACTACGAGCAGTACTTC	CASSLRGQGIRFDYEQYF	TRBV5-4	TRBJ2-7
TGTGCCAGCAGCTTTGGGGGCACTGGTTATCAGCCCCAGCATTTT	CASSFGGTGYQPQHF	TRBV5-4	TRBJ1-5
TGCGCCAGCAGCCAAGCGCCCACGGTCGCACAGGACTATGGCTACACCTTC	CASSQAPTVAQDYGYTF	TRBV4-1	TRBJ1-2
TGTGCCAGCAGTTACTCTAGCCAGTGGGGCACAGAGACCCAGTACTTC	CASSYSSQWGTETQYF	TRBV6-5	TRBJ2-5
TGTGCCTGGCGGGGTCCAGAGGCCGGGGAGCTGTTTTTT	CAWRGPEAGELFF	TRBV30	TRBJ2-2
TGTGCCAGCAGCTTAGGTCCAGGGAGTAGCAATCAGCCCCAGCATTTT	CASSLGPGSSNQPQHF	TRBV7-6	TRBJ1-5
TGTGCTAGTGGTTTGAGTCCCCACCCGGGAGGGCGGGGGGACACCGGGGAGCTGTTTTTT	CASGLSPHPGGRGDTGELFF	TRBV12-5	TRBJ2-2
TGTGCCAGCAGCATACAGGGATATCCCAATCAGCCCCAGCATTTT	CASSIQGYPNQPQHF	TRBV7-9	TRBJ1-5
TGTGCCAGCAGTTACTCGAGACTGGGGCAGTACTTC	CASSYSRLGQYF	TRBV6-2	TRBJ2-7
TGTGCCTGTCCGATCAACCGCCTTAGCAGGGTGGCGACTGAAGCTTTCTTT	CACPINRLSRVATEAFF	TRBV30	TRBJ1-1
TGTCCCAGGGAGGGCGCCTACGAGCAGTACTTC	CPREGAYEQYF	TRBV30	TRBJ2-7
TGTGCCTGTTTTATGTCCTTCTTC	CACFMSFF	TRBV30	TRBJ2-1
TGTGCCAGCAGTTCAGCGGGAGTAATCTACGAGCAGTACTTC	CASSSAGVIYEQYF	TRBV27	TRBJ2-7
TGCGCCAGCAGCCTCGGACCATTTGCATACAATGAGCAGTTCTTC	CASSLGPFAYNEQFF	TRBV4-1	TRBJ2-1
TGTGCCAGCAGCCGGACAGGGCCGGACTATGGCTACACCTTC	CASSRTGPDYGYTF	TRBV27	TRBJ1-2
TGTGCCTCAGGGGGGAAGAGGAATCAGCCCCAGCATTTT	CASGGKRNQPQHF	TRBV6-5	TRBJ1-5
TGTGCCAGCTCCGGTACCAGGGGGGACACCGGGGAGCTGTTTTTT	CASSGTRGDTGELFF	TRBV27	TRBJ2-2
TGTGCCAGCAGCGTCTTGGGACAGGGACTTGCCTACGAGCAGTACTTC	CASSVLGQGLAYEQYF	TRBV7-4	TRBJ2-7
TGTGCCAGCAGCTTCCGGGGGCCGTCAGCCAAAAACATTCAGTACTTC	CASSFRGPSAKNIQYF	TRBV7-3	TRBJ2-4
TGCGCCAGCAGCCATCTCACCGATAGCTACAATGAGCAGTTCTTC	CASSHLTDSYNEQFF	TRBV4-1	TRBJ2-1
TGTGCCATCACTGGACAGACAAAAGAGACCCAGTACTTC	CAITGQTKETQYF	TRBV10-3	TRBJ2-5
TGCGCCAGCAGTGACCCCGTTAACTATGGCTACACCTTC	CASSDPVNYGYTF	TRBV10-1	TRBJ1-2
TGTGCCAGCAGCCCAGAGGGTGCTTTCTTT	CASSPEGAFF	TRBV9	TRBJ1-1
TGTGCACGGAGCTACGAGCAGTACTTC	CARSYEQYF	TRBV6-2	TRBJ2-7
TGTGCCAGCAGCATGGGCTTCCCAGGCTCCTACAATGAGCAGTTCTTC	CASSMGFPGSYNEQFF	TRBV13	TRBJ2-1
TGTGCCAGCAGCTTAGCTCTCCTTCCCAACGGGGGACGGGGGTCCTATAATTCACCCCTCCACTTT	CASSLALLPNGGRGSYNSPLHF	TRBV7-6	TRBJ1-6
TGTGCCAGCAGTAGAAGGGGGGAGACCCAGTACTTC	CASSRRGETQYF	TRBV28	TRBJ2-5
TGTGCCAGCCAAGTGAGAAGCAGCCCGAACACCGGGGAGCTGTTTTTT	CASQVRSSPNTGELFF	TRBV7-3	TRBJ2-2
