TGTGCCAGCAGCGGAGGGGGATCGTCACCCCTCCACTTT	CASSGGGSSPLHF	TRBV9	TRBJ1-6
TGTGCCAGGGTGGTTGGGACAGAGAGCTCCTATAATTCACCCCTCCACTTT	CARVVGTESSYNSPLHF	TRBV2	TRBJ1-6
TGTGCCAGCTCACCAGAGGGGGGCCCAATGAGTTCCGGAGGCACCGGGGAGCTGTTTTTT	CASSPEGGPMSSGGTGELFF	TRBV18	TRBJ2-2
TGTGCCAGCGCTAAAGGACAGGGGCTTAACACTGAAGCTTTCTTT	CASAKGQGLNTEAFF	TRBV6-1	TRBJ1-1
TGTGCCAGCAGCTTATTCCCAACCGGACAGTGGTGGAACACTGAAGCTTTCTTT	CASSLFPTGQWWNTEAFF	TRBV11-3	TRBJ1-1
TGTGCCAGCAGCTTACAGGGGGCTGGGCTAGCTTTCTTT	CASSLQGAGLAFF	TRBV7-2	TRBJ1-1
TGTGCCACCTCCCATGCCTCAACAAGCCGCACAGATACGCAGTATTTT	CATSHASTSRTDTQYF	TRBV9	TRBJ2-3
TGTGCCAGCAATGGAGCCTACGAGCAGTACTTC	CASNGAYEQYF	TRBV27	TRBJ2-7
TGTGCCAGCAGTTCACTTTTAGGGATGGACTACGAGCAGTACTTC	CASSSLLGMDYEQYF	TRBV6-6	TRBJ2-7
TGTGCCAGCAGTGTTCCTAGGGAACAAGAGACCCAGTACTTC	CASSVPREQETQYF	TRBV2	TRBJ2-5
TGTGCCAGCAGAACCCTAGCGAGCTGTTACGAGCAGTACTTC	CASRTLASCYEQYF	TRBV6-5	TRBJ2-7
TGTGCCAGCAGCCCCCCCCAGGCCCCCAATCAGCCCCAGCATTTT	CASSPPQAPNQPQHF	TRBV13	TRBJ1-5
TGTGCCAGCAGCGCCGTAGGGCAGTACTATGGCTACACCTTC	CASSAVGQYYGYTF	TRBV13	TRBJ1-2
TGTGCCAGCAGCTTGCCGGGACAGGGGGCTCGCCTGCCGAACACTGAAGCTTTCTTT	CASSLPGQGARLPNTEAFF	TRBV5-5	TRBJ1-1
TGCAGTGCGGGGACAGGGAAGAAATTCTTT	CSAGTGKKFF	TRBV20-1	TRBJ1-1
TGTGCCAGCAGCTTAAGGGGGACTCAGCCCCAGCATTTT	CASSLRGTQPQHF	TRBV11-2	TRBJ1-5
TGTGCCACCACCACTCTAGTCAACTACGAGCAGTACTTC	CATTTLVNYEQYF	TRBV24-1	TRBJ2-7
TGTGCCAGCAGCTTAAGAGGGGGTCAGCCCCAGCATTTT	CASSLRGGQPQHF	TRBV7-9	TRBJ1-5
TGCGCCAGCAGTGCGCAGGGACAAGGGCACACTGAAGCTTTCTTT	CASSAQGQGHTEAFF	TRBV10-1	TRBJ1-1
TGTGCCATCAGTGAGCGTAATGGGGGACAGTACAACTATGGCTACACCTTC	CAISERNGGQYNYGYTF	TRBV10-3	TRBJ1-2
TGTGCCAGCAGCGTTCCAGGGGGGGATAATGAGCAGTTCTTC	CASSVPGGDNEQFF	TRBV9	TRBJ2-1
TGTGCCAGCAGCGCAAGGACAGGAGAGGCCACTGAAGCTTTCTTT	CASSARTGEATEAFF	TRBV5-6	TRBJ1-1
TGTGCCAGCAGTGACGAGGGTACCAGAAATCAGCCCCAGCATTTT	CASSDEGTRNQPQHF	TRBV27	TRBJ1-5
TGCGCCAGCAGCTTGACCAGTCAAGACAGCCGGCATTCACCCCTCCACTTT	CASSLTSQDSRHSPLHF	TRBV5-1	TRBJ1-6
TGTGCCAGCAGCTTAAGGCAGGGCTACGAGCAGTACTTC	CASSLRQGYEQYF	TRBV7-4	TRBJ2-7
TGTGCCAGCGCCCAGAGAAGCAGCTCTGGAAACACCATATATTTT	CASAQRSSSGNTIYF	TRBV2	TRBJ1-3
TGTGCCAGCTGCAGAACGGGAGGGGGGGGTTCGGGCCAGTACTTC	CASCRTGGGGSGQYF	TRBV7-3	TRBJ2-5
TGTGCCAGCAGTTACTCGACTCGCCCAGGGGGGCATTTT	CASSYSTRPGGHF	TRBV6-6	TRBJ1-5
TGTGCCAGCAGTGAAGGAAACCGGGACAGGGCGGGGTCTGGAAACACCATATATTTT	CASSEGNRDRAGSGNTIYF	TRBV6-1	TRBJ1-3
TGCGCCAGCAGCTTGAATCACAGGCACTATGGCTACACCTTC	CASSLNHRHYGYTF	TRBV5-1	TRBJ1-2
TGTGCCAGCTCTGCACATAACTATGGCTACACCTTC	CASSAHNYGYTF	TRBV18	TRBJ1-2
TGTGCCAGCAGCTGCCGCAATTCACCCCTCCACTTT	CASSCRNSPLHF	TRBV11-2	TRBJ1-6
TGTGCCAGCAGCTTATTTCTGAGTTTCAGAGAAAGCTACGAGCAGTACTTC	CASSLFLSFRESYEQYF	TRBV11-3	TRBJ2-7
TGTGCCAGCAGCTCCGTCACTGCTCTGGATCGGGCCAAAAACATTCAGTACTTC	CASSSVTALDRAKNIQYF	TRBV11-2	TRBJ2-4
TGCGCCAGCAGCTTCCTCAGCGGGAGCGGGAAAAACATTCAGTACTTC	CASSFLSGSGKNIQYF	TRBV5-1	TRBJ2-4
TGCGCCAGCAGCCAAGATCTATGGGGGGGACCCAGCACAGATACGCAGTATTTT	CASSQDLWGGPSTDTQYF	TRBV4-1	TRBJ2-3
TGTGCCAGCAGCTTGTTCGACAGGGCAAACACTGAAGCTTTCTTT	CASSLFDRANTEAFF	TRBV5-4	TRBJ1-1
TGTGCCAGCAGTGAATGGGGAGGAGAAAAGTACTCGACTCGAGCAGATACGCAGTATTTT	CASSEWGGEKYSTRADTQYF	TRBV25-1	TRBJ2-3
TGTGCCAGCAGCACGGGGGGCCAGGCCAACGTCCTGACTTTC	CASSTGGQANVLTF	TRBV7-3	TRBJ2-6
TGTGCCAGCAGCCCAGGGGTTTGGAACACTGAAGCTTTCTTT	CASSPGVWNTEAFF	TRBV9	TRBJ1-1
TGTGCTCGTCCCGGGAACAGGGGGCTCTCCGATAATTCACCCCTCCACTTT	CARPGNRGLSDNSPLHF	TRBV25-1	TRBJ1-6
TGTGCCAGCAGCCCAAAATTTGACAAAGTCATGAACACTGAAGCTTTCTTT	CASSPKFDKVMNTEAFF	TRBV7-3	TRBJ1-1
TGTGCCAGCAGTTTTTGCCTGACAGGGGGGGTACAGCCCCAGCATTTT	CASSFCLTGGVQPQHF	TRBV6-9	TRBJ1-5
TGCGCCACCTTGAGGGCCGCCCGTGGATGTGGGAAAGTGAACACTGAAGCTTTCTTT	CATLRAARGCGKVNTEAFF	TRBV10-2	TRBJ1-1
TGTGCTTTGCCTGTGTATTCATGGAGCTCCTACGAGCAGTACTTC	CALPVYSWSSYEQYF	TRBV2	TRBJ2-7
TGTGCCAGCTCCCAGGGGGATACTGAAGCTTTCTTT	CASSQGDTEAFF	TRBV6-5	TRBJ1-1
TGTGCCAGCAAAACTCGGAAACAGAACACCGGGGAGCTGTTTTTT	CASKTRKQNTGELFF	TRBV27	TRBJ2-2
TGTGCCAGCAGCCAAGGGGGCACCGAGGGTAACTATGGCTACACCTTC	CASSQGGTEGNYGYTF	TRBV4-2	TRBJ1-2
TGCAGTGCTAGACCCAGGGCGAGCTCCTACGAGCAGTACTTC	CSARPRASSYEQYF	TRBV20-1	TRBJ2-7
TGTGCCAGCAGCGGTCACCTGACAGAGACCCAGTACTTC	CASSGHLTETQYF	TRBV7-4	TRBJ2-5
TGCAGTGCTAGCCGCACTAGCGGGAGCCGTCCTGGATCCTACGAGCAGTACTTC	CSASRTSGSRPGSYEQYF	TRBV20-1	TRBJ2-7
TGTGCCGGTGAGGGGTACAATGAGCAGTTCTTC	CAGEGYNEQFF	TRBV10-3	TRBJ2-1
TGTGCCAGCAGCTTATTTTTTCCACTAGCGGGGGGGACCGGGGAGCTGTTTTTT	CASSLFFPLAGGTGELFF	TRBV11-3	TRBJ2-2
TGTGCCATCTCGGGACAGGGGACCTCCGGCTACACCTTC	CAISGQGTSGYTF	TRBV10-3	TRBJ1-2
TGCAAGGTGGAGGGACAGCCGGTGTTAAATCAGCCCCAGCATTTT	CKVEGQPVLNQPQHF	TRBV20-1	TRBJ1-5
TGCGCCAGCAGCTCCCGAAAAGCGATCAATGAGCAGTTCTTC	CASSSRKAINEQFF	TRBV5-1	TRBJ2-1
TGTGCCAGCCAAACAGGGTGTGGCTACACCTTC	CASQTGCGYTF	TRBV11-2	TRBJ1-2
TGTGCCAGCAGAAAAGGACGGGAGACCCAGTACTTC	CASRKGRETQYF	TRBV5-4	TRBJ2-5
TGTGCCATCAGTGCCGCAGGGGCCGCTGGGGCCAACGTCCTGACTTTC	CAISAAGAAGANVLTF	TRBV10-3	TRBJ2-6
TGTGCCAGCAGCTTAGGACCCCGTTCCGGGACTAGCCTGAGCACAGATACGCAGTATTTT	CASSLGPRSGTSLSTDTQYF	TRBV11-2	TRBJ2-3
TGTGCCTGGAGAGCGTTCCGACTAGCGGGAGCTTGGGGTGACGAGCAGTACTTC	CAWRAFRLAGAWGDEQYF	TRBV30	TRBJ2-7
TGTGCCAGCAGTTTTACGGGCTGGGCGTATGAAAAACTGTTTTTT	CASSFTGWAYEKLFF	TRBV28	TRBJ1-4
TGTGCCACCAGCGGAACCCAGGGCACCCAGCATTTT	CATSGTQGTQHF	TRBV15	TRBJ1-5
TGTGCCTGGGGGGTAGCAGGGCCCGAGAGCTCTGGGGCCAACGTCCTGACTTTC	CAWGVAGPESSGANVLTF	TRBV30	TRBJ2-6
TGCGCCAGCAGATCCTTCCCGAGACAGGGTGGAAGCGAAAAACTGTTTTTT	CASRSFPRQGGSEKLFF	TRBV10-1	TRBJ1-4
TGCGCCAGCAGCGAGCTGACGGGAGGCTCGGCCTCAGGATTGCGCGGGGAGCTGTTTTTT	CASSELTGGSASGLRGELFF	TRBV10-1	TRBJ2-2
TGTGCCAGCAGCTTAAATCGCCAGGGGGGTCCTGCCAATGAGCAGTTCTTC	CASSLNRQGGPANEQFF	TRBV7-8	TRBJ2-1
TGCGCCATCGTGGGACAGAACTCGGCCACCGGGGAGCTGTTTTTT	CAIVGQNSATGELFF	TRBV10-1	TRBJ2-2
TGTGCCAGCAGTGATCTAGCGGAGTACTTC	CASSDLAEYF	TRBV6-3	TRBJ2-5
TGTGCCAGCAGTGCGCTAGCTTCCGGGGAGCTGTTTTTT	CASSALASGELFF	TRBV2	TRBJ2-2
TGTGCCAGCAGCAAAAAGATAGGCCGGGGTAGCCTGGACGAGCAGTACTTC	CASSKKIGRGSLDEQYF	TRBV13	TRBJ2-7
TGCGCCAGCAGCCGAACTTACCGCAGGCCTACTAACTATGGCTACACCTTC	CASSRTYRRPTNYGYTF	TRBV4-3	TRBJ1-2
TGTGCCAGCAGTTACCGGGACATAGGAAACACCATATATTTT	CASSYRDIGNTIYF	TRBV6-5	TRBJ1-3
TGTGCCAGCAGCGCCAAAAACATTCAGTACTTC	CASSAKNIQYF	TRBV6-5	TRBJ2-4
TGTGCCAGCAGCTTAACCGGTACAGGGGTTAAAGAAAAACTGTTTTTT	CASSLTGTGVKEKLFF	TRBV7-8	TRBJ1-4
TGTGCCAGCAGCTTGAAGCGCACGCCGGGACAGGGGCCATATAGCAATCAGCCCCAGCATTTT	CASSLKRTPGQGPYSNQPQHF	TRBV5-6	TRBJ1-5
TGTGCCAGCAGTTTATGCCGGGACATCGGGGAAGCCACTGAAGCTTTCTTT	CASSLCRDIGEATEAFF	TRBV28	TRBJ1-1
TGTGCCAGCATACCCCACAGGGGACATCCTAACTATGGCTACACCTTC	CASIPHRGHPNYGYTF	TRBV6-2	TRBJ1-2
TGTGCCAGCAGCCTTGGACAGGGTCCTGCCAGGCCGATATACGAGCAGTACTTC	CASSLGQGPARPIYEQYF	TRBV9	TRBJ2-7
TGTGCCAGCAGTTATTCCCTAGGCGGTATGGCCGGGGAGCTGTTTTTT	CASSYSLGGMAGELFF	TRBV6-9	TRBJ2-2
TGTGCCAGCAGCTGGCAGGGGTCAGCCAAAAACATTCAGTACTTC	CASSWQGSAKNIQYF	TRBV7-9	TRBJ2-4
TGTGCCAGCAGCCTCGGGACGTCCTGCAATCAGCCCCAGCATTTT	CASSLGTSCNQPQHF	TRBV9	TRBJ1-5
TGTGCCAGCAGCTTGTGGGCGGACAATGAGCAGTTCTTC	CASSLWADNEQFF	TRBV13	TRBJ2-1
TGTGCCAGCAGCTTAGCCTTGGACGATACGCAGTATTTT	CASSLALDDTQYF	TRBV7-6	TRBJ2-3
TGTGCCAGCAGTCGACAGGGATCGTATAGCAATCAGCCCCAGCATTTT	CASSRQGSYSNQPQHF	TRBV6-1	TRBJ1-5
TGTGCCAGCAGCTGGGGACACGAAAACACTGAAGCTTTCTTT	CASSWGHENTEAFF	TRBV7-3	TRBJ1-1
TGTGCCAGCAGCTATAGGGACAGTAACTATGGCTACACCTTC	CASSYRDSNYGYTF	TRBV5-6	TRBJ1-2
TGTGCCAGCCCGGACACAGGTGGGATACCTACTGAAGCTTTCTTT	CASPDTGGIPTEAFF	TRBV7-9	TRBJ1-1
TGTGCCAGCACCTGGACAGGGGCCGGCTACACCTTC	CASTWTGAGYTF	TRBV12-3	TRBJ1-2
TGTGCCAGCAGCTTAGACCGGGACGCTAGCACAGATACGCAGTATTTT	CASSLDRDASTDTQYF	TRBV7-2	TRBJ2-3
TGTGCCAGCAGTGGATGGCTGGATTTAGGGTACGAGCAGTACTTC	CASSGWLDLGYEQYF	TRBV6-1	TRBJ2-7
TGTGCCAGCAGCTTAAATCCCATAACCCGGGACATTCCGAACACTGAAGCTTTCTTT	CASSLNPITRDIPNTEAFF	TRBV7-9	TRBJ1-1
TGTGCCCCCCGAAGATGGTCACCCCTCCACTTT	CAPRRWSPLHF	TRBV19	TRBJ1-6
TGTGCCAGCAGCCAGCACCTCAATCAGCCCCAGCATTTT	CASSQHLNQPQHF	TRBV5-6	TRBJ1-5
TGTGCCAGCAGCCACCGGACAGACAGGTTCCTAGCCAAAAACATTCAGTACTTC	CASSHRTDRFLAKNIQYF	TRBV14	TRBJ2-4
TGTGCCAGCAGCTTCACGCGTTCTACCTTCTACAATGAGCAGTTCTTC	CASSFTRSTFYNEQFF	TRBV7-3	TRBJ2-1
TGTGCCAGTAGTAGGACCAGGGCCAGGCAGACCCAGTACTTC	CASSRTRARQTQYF	TRBV19	TRBJ2-5
TGTGCCAGCAGTGGCCGAGCGCTAGGCTCTGGAAACACCATATATTTT	CASSGRALGSGNTIYF	TRBV27	TRBJ1-3
TGTGCCAGCAAAAGAGCAGACAGCCGTGGGGCCAACGTCCTGACTTTC	CASKRADSRGANVLTF	TRBV3-1	TRBJ2-6
TGTGCCAGCAGTTACAGGGGACACTACGAGCAGTACTTC	CASSYRGHYEQYF	TRBV6-5	TRBJ2-7
