TGTGCCAGCAGCAAGGACAGCAATTCACCCCTCCACTTT	CASSKDSNSPLHF	TRBV5-5	TRBJ1-6
TGTGCCAGCAGTCGCGGAATTCTTGGGAACCGAAACACTGAAGCTTTCTTT	CASSRGILGNRNTEAFF	TRBV6-1	TRBJ1-1
TGTGCCAGCAGTGAAAAGAGGGTGGACAGGGAAGGCAATCAGCCCCAGCATTTT	CASSEKRVDREGNQPQHF	TRBV2	TRBJ1-5
TGTGCCAGCAGTCCCCGGACTAGCGGGGGGACCGGGGAGCTGTTTTTT	CASSPRTSGGTGELFF	TRBV27	TRBJ2-2
TGTGCCACTCAGGTTGTCTCTTGTGGTTGTCATGCTTTCTTT	CATQVVSCGCHAFF	TRBV5-4	TRBJ1-1
TGTGCCACCAGCAGAAACTTAGCGGGAGTCTACAATGAGCAGTTCTTC	CATSRNLAGVYNEQFF	TRBV15	TRBJ2-1
TGTGCCAGCCGCGGGAGTGGGGGAGATACGCAGTATTTT	CASRGSGGDTQYF	TRBV6-1	TRBJ2-3
TGTGCCAGCAGCTTGTCGGACGGGACTAATGAAAAACTGTTTTTT	CASSLSDGTNEKLFF	TRBV7-2	TRBJ1-4
TGTGCCAGCAGTTACGTGCTAGCGGGATGCCGCACCGGGGAGCTGTTTTTT	CASSYVLAGCRTGELFF	TRBV6-2	TRBJ2-2
TGTGCCAGCAGCCAAGATCTAGCGGGCCGGGCCGGGGAGCTGTTTTTT	CASSQDLAGRAGELFF	TRBV4-2	TRBJ2-2
TGTGCCAGCAGAGGAAAGGGGGGGAGCCAAGAGACCCAGTACTTC	CASRGKGGSQETQYF	TRBV5-6	TRBJ2-5
TGTGCCAGTAGTATACTAGCGGGCTCGAAGTTATTTTCAGATACGCAGTATTTT	CASSILAGSKLFSDTQYF	TRBV19	TRBJ2-3
TGCGCCAGCAGCTTTCCCCGTGCCCTAGCGGGGCTATTCTCCTACGAGCAGTACTTC	CASSFPRALAGLFSYEQYF	TRBV5-1	TRBJ2-7
TGTGCCAGCAGAACAGGGATAGCTTTCTTT	CASRTGIAFF	TRBV6-5	TRBJ1-1
TGTGCCAGCAGTGACTCGGCGTTGGATTCCTATAATTCACCCCTCCACTTT	CASSDSALDSYNSPLHF	TRBV6-4	TRBJ1-6
TGTGCCAGCAGTTTCCAGCCAACCACGTGCCAAGAGACCCAGTACTTC	CASSFQPTTCQETQYF	TRBV27	TRBJ2-5
TGTGCCAGCAGTCCCGGGACTAGCGGGTTCGAGCAGTACTTC	CASSPGTSGFEQYF	TRBV12-4	TRBJ2-7
TGCAGTGCTATCGCAGGGAGGACCTACGAGCAGTACTTC	CSAIAGRTYEQYF	TRBV20-1	TRBJ2-7
TGTGCCAGCAGCCCAGTAATATTCCAAGATACGCAGTATTTT	CASSPVIFQDTQYF	TRBV6-5	TRBJ2-3
TGTGCCAGCAGTTACCCCATCAGTCAAGAGTATTTT	CASSYPISQEYF	TRBV6-5	TRBJ2-3
TGTGCCAGCAGCTTAGTTTTCGTTCCTTCCGCTGACAGGGTGGCCAGGGAGCAGTACTTC	CASSLVFVPSADRVAREQYF	TRBV7-2	TRBJ2-7
TGTGCCAGCAGCGCAACGGCGGACACTGAAGCTTTCTTT	CASSATADTEAFF	TRBV7-2	TRBJ1-1
TGCGCCAGCAGGGGACAGGGATTGTTCGGGCTAGCCAAAAACATTCAGTACTTC	CASRGQGLFGLAKNIQYF	TRBV10-1	TRBJ2-4
TGTGCCAGCAGTTCGCATCTTGAGCAGTACTTC	CASSSHLEQYF	TRBV6-5	TRBJ2-7
TGTGCCAGCAGGGCCGGACAGGTCAATCAGCCCCAGCATTTT	CASRAGQVNQPQHF	TRBV6-1	TRBJ1-5
TGTGCCACCGGGACAGAAGAGACCCAGTACTTC	CATGTEETQYF	TRBV24-1	TRBJ2-5
TGTGCCAAACCCCGCAAAGAGACCCAGTACTTC	CAKPRKETQYF	TRBV28	TRBJ2-5
TGTGCCAGCAGCTCTACGGAAGCTTTCTTT	CASSSTEAFF	TRBV5-6	TRBJ1-1
TGCAGTGCTAGAGATGTCTACCCTGAGCAGTTCTTC	CSARDVYPEQFF	TRBV20-1	TRBJ2-1
TGTGCCAGCAGTTCGGATACCTACCCCGGGGCTGGGGCCAACGTCCTGACTTTC	CASSSDTYPGAGANVLTF	TRBV6-1	TRBJ2-6
TGCGCCAGCAACAGGGGGCGGGCCTACGAGCAGTACTTC	CASNRGRAYEQYF	TRBV10-1	TRBJ2-7
TGTGCCAGCAGTTACGTGGAATTCGGGCCAGGGACCTCCTACGAGCAGTACTTC	CASSYVEFGPGTSYEQYF	TRBV6-5	TRBJ2-7
TGTGCCAGTAGGGGACAGGGAAGACTCCCGCTCGAGACCCAGTACTTC	CASRGQGRLPLETQYF	TRBV19	TRBJ2-5
TGTGCCAGCAGCCAAAGCGGGTACAATGAGCAGTTCTTC	CASSQSGYNEQFF	TRBV3-1	TRBJ2-1
TGTGCCAGCAGTGCACCTAAAAATCTAGAGACCCAGTACTTC	CASSAPKNLETQYF	TRBV13	TRBJ2-5
TGTGCCAGCAGACCAAGAAGTTCCTGCTCCTACGAGCAGTACTTC	CASRPRSSCSYEQYF	TRBV7-9	TRBJ2-7
TGTGCCAGCAGTAGGGGAAGAGAGGTCTACTTTAAGGGGTATGGCTACACCTTC	CASSRGREVYFKGYGYTF	TRBV28	TRBJ1-2
TGTGCCAGCAGTGAGGAACCGAAGGGTTGTGGCTACGAGCAGTACTTC	CASSEEPKGCGYEQYF	TRBV6-4	TRBJ2-7
TGTGCCAGCAGCGACCGACAAAAGAGAGGGTATGAGCAGTTCTTC	CASSDRQKRGYEQFF	TRBV7-3	TRBJ2-1
TGTGCCAGCCGGAAGGGGGGGCGAAAACAAGAGACCCAGTACTTC	CASRKGGRKQETQYF	TRBV7-6	TRBJ2-5
TGCGGCAAAGGACAGATGGACTATGGCTACACCTTC	CGKGQMDYGYTF	TRBV29-1	TRBJ1-2
TGCGCCAGCAGCCAAGATTCCAGGCCCACAGATACGCAGTATTTT	CASSQDSRPTDTQYF	TRBV4-1	TRBJ2-3
TGTGCCAGCAGCGTGCGATGGGTGCCAGGGGATGGCTACACCTTC	CASSVRWVPGDGYTF	TRBV7-4	TRBJ1-2
TGTGCCAGCAGCGGGGGGGGGCCCGGATCCTACGAGCAGTACTTC	CASSGGGPGSYEQYF	TRBV9	TRBJ2-7
TGTGCCAGCAGCTTTCCGCTAGCTAGCACAGATACGCAGTATTTT	CASSFPLASTDTQYF	TRBV5-6	TRBJ2-3
TGTGCCACCAGTGACCGGGGGCAGGGCGAGCAGTACTTC	CATSDRGQGEQYF	TRBV24-1	TRBJ2-7
TGTGCCACCAGTGAGCCGGGGGACAGGGTTGGCGCGGCTTTCTTT	CATSEPGDRVGAAFF	TRBV24-1	TRBJ1-1
TGTGCCAGCAGCACCCTTAACTATGGCTACACCTTC	CASSTLNYGYTF	TRBV7-4	TRBJ1-2
TGTGCCAGCAGCCCTAGCGTAGGCTACGAGCAGTACTTC	CASSPSVGYEQYF	TRBV7-9	TRBJ2-7
TGTGCCACCAGTTTCAGTCCTCGTGGGGGACAGGGGATTCAGTCAGATACGCAGTATTTT	CATSFSPRGGQGIQSDTQYF	TRBV24-1	TRBJ2-3
TGTGCCAGCAGTCTGACACGGACCGGGGAGCTGTTTTTT	CASSLTRTGELFF	TRBV12-3	TRBJ2-2
TGCGCCAGCCCCGGGGGCAATCAGCCCCAGCATTTT	CASPGGNQPQHF	TRBV10-1	TRBJ1-5
TGCGCCAGCAGCTTGGGACCGGGACAGGGGGCGCATCAGCCCCAGCATTTT	CASSLGPGQGAHQPQHF	TRBV5-1	TRBJ1-5
TGCGCCAGCAGTGAGGGACTAGCGGGATACAATGAGCAGTTCTTC	CASSEGLAGYNEQFF	TRBV10-1	TRBJ2-1
TGTGCCAGCATGTCCGGGACTAGCGGGAGACTGGAGAACACTGAAGCTTTCTTT	CASMSGTSGRLENTEAFF	TRBV6-2	TRBJ1-1
TGTGCCAGCAGTTTAAAGGGGAATTCACCCCTCCACTTT	CASSLKGNSPLHF	TRBV12-3	TRBJ1-6
TGTGCCAGCTCCCAGAGGCGACCACTTGAAAAACTGTTTTTT	CASSQRRPLEKLFF	TRBV18	TRBJ1-4
TGTGCCAGCAGCATACTCGGGGGGATCGGAATAAGCAATCAGCCCCAGCATTTT	CASSILGGIGISNQPQHF	TRBV7-4	TRBJ1-5
TGTGCCAGCTCCACTACGATGCTACTTGATGAGCAGTTCTTC	CASSTTMLLDEQFF	TRBV28	TRBJ2-1
TGTGCCAGCAGCCAGCCCGGGGGGGCTCCGGGAAATGAGCAGTTCTTC	CASSQPGGAPGNEQFF	TRBV7-8	TRBJ2-1
TGTGCCAGCAAGATAGGAGTAAGCACAGATACGCAGTATTTT	CASKIGVSTDTQYF	TRBV6-2	TRBJ2-3
TGTGCCAGCCGTGGGGGGGCAGGAGACTACGAGCAGTACTTC	CASRGGAGDYEQYF	TRBV27	TRBJ2-7
TGTGCCAGCAGCGCCGGACAGGGGAAACCTGGAAACACCATATATTTT	CASSAGQGKPGNTIYF	TRBV7-2	TRBJ1-3
TGTGCCAGCAGCTTAGGAGGGAACTACGAGCAGTACTTC	CASSLGGNYEQYF	TRBV5-4	TRBJ2-7
TGTGCCAGTTACCGGGGGGGAAACCCCTACGAGCAGTACTTC	CASYRGGNPYEQYF	TRBV28	TRBJ2-7
TGTGCCACCATTTCAGGATCCTACAATGAGCAGTTCTTC	CATISGSYNEQFF	TRBV24-1	TRBJ2-1
TGTGCCACCAGTGGCAGGGGGAATATAATCTCCTACGAGCAGTACTTC	CATSGRGNIISYEQYF	TRBV24-1	TRBJ2-7
TGTGCCAGCAGCTTGGCTTCCGTGCGGGACACTGAAGCTTTCTTT	CASSLASVRDTEAFF	TRBV5-4	TRBJ1-1
TGTGCCAGCAGTTACGGTTGTTTTGGGACAGGGCTGCCCCAGCATTTT	CASSYGCFGTGLPQHF	TRBV6-5	TRBJ1-5
TGTGCCAGCAGTTACGAACAACAGGGGGGCCTAGCCCTCCACTTT	CASSYEQQGGLALHF	TRBV6-6	TRBJ1-6
TGTGCCAGCAGCCCCCCCGGGAGGGAACGCTACGAGCAGTACTTC	CASSPPGRERYEQYF	TRBV2	TRBJ2-7
TGCGCCAGCAGCTTTTCGACGGGGTTGGATGAGCAGTTCTTC	CASSFSTGLDEQFF	TRBV5-1	TRBJ2-1
TGCAGTGCTAGAGCCTCCAGGACAGGGACAGATGAGCAGTTCTTC	CSARASRTGTDEQFF	TRBV20-1	TRBJ2-1
TGCGCCAGCAGCCCGAGAGCTGCGCCAGATACGCAGTATTTT	CASSPRAAPDTQYF	TRBV5-1	TRBJ2-3
TGTGCCAGCAGCGGGGGTGCAGCCACAACTAATGAAAAACTGTTTTTT	CASSGGAATTNEKLFF	TRBV9	TRBJ1-4
TGTGCCAGCTCACCAAGTAGCACCGGGGAGCTGTTTTTT	CASSPSSTGELFF	TRBV18	TRBJ2-2
TGTGCCAGCAGCTTAGGAAACCAGACTGTGCAAGAGACCCAGTACTTC	CASSLGNQTVQETQYF	TRBV7-4	TRBJ2-5
TGCGCCAGCAGCTTGAATACTAGCGAGGGACGAGCGACCCAGTACTTC	CASSLNTSEGRATQYF	TRBV5-1	TRBJ2-5
TGTGCCAGCAGCTACTCAGCGGGGAGTCTGGAAGGCACAGATACGCAGTATTTT	CASSYSAGSLEGTDTQYF	TRBV7-9	TRBJ2-3
TGTGCCAGCAGCTTGTCGGGACTAGGGAATGAGCAGTTCTTC	CASSLSGLGNEQFF	TRBV7-3	TRBJ2-1
TGTGCCAGCAGCTTACAACAGGGGGATCCTAATGAAAAACTGTTTTTT	CASSLQQGDPNEKLFF	TRBV7-3	TRBJ1-4
TGTGCCTTGAACCCCGGGGGGAATGGCACAGATACGCAGTATTTT	CALNPGGNGTDTQYF	TRBV7-2	TRBJ2-3
TGTGCCAGCTCACCTGCCCACTTAGGGGCAATCTTC	CASSPAHLGAIF	TRBV18	TRBJ2-1
TGCAGCGTTGCGCGACTAGCGGGGTACCAAGAGACCCAGTACTTC	CSVARLAGYQETQYF	TRBV29-1	TRBJ2-5
TGTGCCAGTAGTACGCGGACAGGGGGGGAGGGGCACTATGGCTACACCTTC	CASSTRTGGEGHYGYTF	TRBV19	TRBJ1-2
TGTGCCAGCAGCCGACGGTGTGGCTACACCTTC	CASSRRCGYTF	TRBV6-4	TRBJ1-2
TGTGCCAGCAGGAGGACTAGCGGGAACCCTGAGACCCAGTACTTC	CASRRTSGNPETQYF	TRBV12-3	TRBJ2-5
TGTGCCAGCAGCTTGCCAGGTCACGCGGGAGTACCGTGCTACAATGAGCAGTTCTTC	CASSLPGHAGVPCYNEQFF	TRBV5-8	TRBJ2-1
TGTGCCAGCAGCCGAAGTTACCAAGAGACCCAGTACTTC	CASSRSYQETQYF	TRBV7-7	TRBJ2-5
TGCGCCAGCAGTGATACTAGCGGGGGGGCTCGCAGACGCAATGAGCAGTTCTTC	CASSDTSGGARRRNEQFF	TRBV10-1	TRBJ2-1
TGTGCCAGCGTGGGATGTGGAGACTGGCACCGGGACACCGGGGAGCTGTTTTTT	CASVGCGDWHRDTGELFF	TRBV9	TRBJ2-2
TGTGCCAGCAGTGGAGGGAGGGTTTATCCATATGAGCAGTTCTTC	CASSGGRVYPYEQFF	TRBV28	TRBJ2-1
TGTGCCAGCGCCGCCGGGGCGCAGTACTTC	CASAAGAQYF	TRBV14	TRBJ2-7
TGTGCCAGCAGCATACGTCGGACTCGGGGTGAAAAACTGTTTTTT	CASSIRRTRGEKLFF	TRBV7-9	TRBJ1-4
TGCGCCAGCAGCCCCGGGGAGGGGACTGAAAACTATGGCTACACCTTC	CASSPGEGTENYGYTF	TRBV5-1	TRBJ1-2
TGTGCCAGCAGCCCTGGGGAGACCCAGTACTTC	CASSPGETQYF	TRBV7-2	TRBJ2-5
TGTGCCAGCAGCTTGCCCGGGACAGTCTCCTACGAGCAGTACTTC	CASSLPGTVSYEQYF	TRBV5-8	TRBJ2-7
TGTGCCAGCAGCTTTTTTAACCTACCGACCGGGACATACAATGAGCAGTTCTTC	CASSFFNLPTGTYNEQFF	TRBV11-3	TRBJ2-1
TGTGCTAGTGGTTTGGTTCATGGGACTAGCGGGGGGGATACGCAGTATTTT	CASGLVHGTSGGDTQYF	TRBV12-5	TRBJ2-3
TGTGCCATCAGTGAGTCGCCTCGGAGGGCCGAAAGCTCCCTGGACAATGAGCAGTTCTTC	CAISESPRRAESSLDNEQFF	TRBV10-3	TRBJ2-1
