TGCAGTGCTAGCGGACAGGGGATCGACACTGAAGCTTTCTTT	CSASGQGIDTEAFF	TRBV20-1	TRBJ1-1
TGTGCCAGCAGTTTCAAGTACAATGAGCAGTTCTTC	CASSFKYNEQFF	TRBV28	TRBJ2-1
TGTGCTAGTGGTTCTCAGTATGGTCAGCCCCAGCATTTT	CASGSQYGQPQHF	TRBV12-5	TRBJ1-5
TGTGCCAGCAGCCTAGAGGGGACAGGGGAGGCTTCACCCCTCCACTTT	CASSLEGTGEASPLHF	TRBV7-4	TRBJ1-6
TGTGCCAGCAGTTTGAGAAACCACCTAACCTGCAATCAGCCCCAGCATTTT	CASSLRNHLTCNQPQHF	TRBV12-4	TRBJ1-5
TGTGCCAGCAGCACGGGGGGGGACAGGCGGAATCAGCCCCAGCATTTT	CASSTGGDRRNQPQHF	TRBV7-9	TRBJ1-5
TGTGCCAGCAGCGTAGGACCCCGGCCGGGGGGGCATACCGGGGAGCTGTTTTTT	CASSVGPRPGGHTGELFF	TRBV9	TRBJ2-2
TGTGCCAGCAGTGACTCTGAAAGGGGTCCAACTGATTTGTGGTATGGCTACACCTTC	CASSDSERGPTDLWYGYTF	TRBV6-4	TRBJ1-2
TGCGCCAGCAGCTTGGCCGGGGCCAGGGGGGAGAGCTCCTACGAGCAGTACTTC	CASSLAGARGESSYEQYF	TRBV5-1	TRBJ2-7
TGCGCCAGCAGCGCCTCCTTTAATGGAAACACCATATATTTT	CASSASFNGNTIYF	TRBV5-1	TRBJ1-3
TGTGCCTGGAGTAGCCATGGACAGGGGGGGTACCAAGAGACCCAGTACTTC	CAWSSHGQGGYQETQYF	TRBV30	TRBJ2-5
TGTGCCAGCAGCCACCACCGTAACTATGGCTACACCTTC	CASSHHRNYGYTF	TRBV13	TRBJ1-2
TGCAGTGCTAGAGATGAGGACATTGGGTACTTC	CSARDEDIGYF	TRBV20-1	TRBJ2-7
TGTGCCAATCCTCGGGGGGGATACAATGAGCAGTTCTTC	CANPRGGYNEQFF	TRBV19	TRBJ2-1
TGTGCCAGTAGTACAAGGGGGGGCCAAAGGGGACAAGAGACCCAGTACTTC	CASSTRGGQRGQETQYF	TRBV19	TRBJ2-5
TGTGCCAGCAGCTCGGAACCCGGGACAGGGAATGGGCTTAAAGAGACCCAGTACTTC	CASSSEPGTGNGLKETQYF	TRBV11-3	TRBJ2-5
TGTGCCAGCAGTGCCTGGGGAGGAGACGAGCAGTACTTC	CASSAWGGDEQYF	TRBV27	TRBJ2-7
TGTGCCATCAGTGATTATGGCGACGGACAGGGCTGGGGGTACGAGCAGTACTTC	CAISDYGDGQGWGYEQYF	TRBV10-3	TRBJ2-7
TGTGCCAGCAGTGAAGGGTCCCAGGAATCGCTCTCTGGAAACACCATATATTTT	CASSEGSQESLSGNTIYF	TRBV2	TRBJ1-3
TGTGCCAGCAGCTTAGAACCACCGGACAGTCAATCACCCCTCCACTTT	CASSLEPPDSQSPLHF	TRBV7-6	TRBJ1-6
TGTGCCAGCAGTTCCACATACCGCAGGGCCCTAGATACGCAGTATTTT	CASSSTYRRALDTQYF	TRBV6-5	TRBJ2-3
TGTGCCAGCAGCTTAGGCCACCCGCCGGGACTCACTGAAGCTTTCTTT	CASSLGHPPGLTEAFF	TRBV7-3	TRBJ1-1
TGTGCCAGCAGCGTAGTAAGAGGGGACGCCCAGCCCCAGCATTTT	CASSVVRGDAQPQHF	TRBV9	TRBJ1-5
TGTGCCAGCAGTGGGATACCCCAAGCGACGGGGAAGAGTCGTAGCTATCAGCCCCAGCATTTT	CASSGIPQATGKSRSYQPQHF	TRBV2	TRBJ1-5
TGCGCCAGCAGCCAGGACAGGGTGAGGGGCTACGAGCAGTACTTC	CASSQDRVRGYEQYF	TRBV4-1	TRBJ2-7
TGTGCCTGGAGTGCCCCCCAACGCGACAGGGGCAATCAGCCCCAGCATTTT	CAWSAPQRDRGNQPQHF	TRBV30	TRBJ1-5
TGTGCCAGCAGCGAACGGGCTTACCAAGAGACCCAGTACTTC	CASSERAYQETQYF	TRBV13	TRBJ2-5
TGTGCCAGAGCAAAGCGGATTACAGGGCTGGAAGCTTTCTTT	CARAKRITGLEAFF	TRBV6-4	TRBJ1-1
TGTGCCAGCAGCCCCAAAAACAGTAACTATGGCTACACCTTC	CASSPKNSNYGYTF	TRBV7-8	TRBJ1-2
TGTGCCAGGACAGAAGGCTACGAGCAGTACTTC	CARTEGYEQYF	TRBV19	TRBJ2-7
TGTGCCAGCAGCCTTTTTACAGGGGCAAGCAATCAGCCCCAGCATTTT	CASSLFTGASNQPQHF	TRBV14	TRBJ1-5
TGTGCCAGTAGTATCCATCGGCCGAACACCGGGGAGCTGTTTTTT	CASSIHRPNTGELFF	TRBV19	TRBJ2-2
TGCAGCGTTGAGGGGGGACAGGGAAACACTGAAGCTTTCTTT	CSVEGGQGNTEAFF	TRBV29-1	TRBJ1-1
TGCGCCAGCAGCCTGGCGGGACAGAACGAGCAGTACTTC	CASSLAGQNEQYF	TRBV4-1	TRBJ2-7
TGTGCCAGCAGCCAAATTGGGGTTACCACTGAAGCTTTCTTT	CASSQIGVTTEAFF	TRBV14	TRBJ1-1
TGTGCCAGCAGTGACCCCCGGGGGCAAGCCAATGAGCAGTTCTTC	CASSDPRGQANEQFF	TRBV6-4	TRBJ2-1
TGTGCCAGCAGCTCCTTGGGGGCGCGGTCTAGCTATGGCTACACCTTC	CASSSLGARSSYGYTF	TRBV16	TRBJ1-2
TGTGCCAGCAGCCGGGGCGCATTGGGAGCCTATGGCTACACCTTC	CASSRGALGAYGYTF	TRBV6-5	TRBJ1-2
TGTGCCAGCAGACTCGCTACAGATACGCAGTATTTT	CASRLATDTQYF	TRBV12-4	TRBJ2-3
TGTGCCAGCAGCCTAACCCCGGGACTAGACAATGAGCAGTTCTTC	CASSLTPGLDNEQFF	TRBV13	TRBJ2-1
TGCGCCAGCAGCCAAGGAGGTCCGGGACTCCCCCATGGCTACACCTTC	CASSQGGPGLPHGYTF	TRBV4-3	TRBJ1-2
TGTGCCATCAGTGCCCCGACTAGCGGGCCGAGCTCCTACGAGCAGTACTTC	CAISAPTSGPSSYEQYF	TRBV10-3	TRBJ2-7
TGTGCCAGCAGCCCCGGGATGATCGGCTACACCTTC	CASSPGMIGYTF	TRBV7-3	TRBJ1-2
TGTGCCTGGAGTCCGGGAGAGAACACTGAAGCTTTCTTT	CAWSPGENTEAFF	TRBV30	TRBJ1-1
TGTGCCAGCAGCTTACCGAGTCACCGGACAACCTCTAACTATGGCTACACCTTC	CASSLPSHRTTSNYGYTF	TRBV7-8	TRBJ1-2
TGCGCCAGCAGCCCAGAGGACACAGATACGCAGTATTTT	CASSPEDTDTQYF	TRBV4-3	TRBJ2-3
TGTGCCAGCCCGTCTCTACCGCAGTACTTC	CASPSLPQYF	TRBV19	TRBJ2-7
TGTGCCAGCAGCTTAGGACTAGCGGGGGGGCCACCCTACAATGAGCAGTTCTTC	CASSLGLAGGPPYNEQFF	TRBV7-3	TRBJ2-1
TGCAGTGCTAGAGACGGTTCGATTCTCTCAGAGACCCAGTACTTC	CSARDGSILSETQYF	TRBV20-1	TRBJ2-5
TGTGCCAGCAGTGAAGCTCACAGGGGGCTTACTACGGATAGCAATCAGCCCCAGCATTTT	CASSEAHRGLTTDSNQPQHF	TRBV2	TRBJ1-5
TGTGCCAGCAGTACCCCCGGAGGGGGGACAGTCACTGAAGCTTTCTTT	CASSTPGGGTVTEAFF	TRBV6-3	TRBJ1-1
TGTGCCAGCAGCTTTGACCGATACAACCCGGGTGAGCAGTTCTTC	CASSFDRYNPGEQFF	TRBV11-2	TRBJ2-1
TGTGCCAGCAGCTCACCCACAGGGGTCCGGGGCTCCTATAATTCACCCCTCCACTTT	CASSSPTGVRGSYNSPLHF	TRBV7-9	TRBJ1-6
TGTGCCAGCAGTTTCGGGGTACCTGCCTATAATTCACCCCTCCACTTT	CASSFGVPAYNSPLHF	TRBV6-5	TRBJ1-6
TGTTGGGAGGAGTGGACCCCACATGAAAAACTGTTTTTT	CWEEWTPHEKLFF	TRBV20-1	TRBJ1-4
TGTGCCAGATCACGCCCAGATACGCAGTATTTT	CARSRPDTQYF	TRBV19	TRBJ2-3
TGCGCCAGCAGCCAAGTCAGGCTGCGTCTAGCTGGGACAGATACGCAGTATTTT	CASSQVRLRLAGTDTQYF	TRBV4-3	TRBJ2-3
TGTGCCACCGGGGGTCCGGGACTTCATCAGCCCCAGCATTTT	CATGGPGLHQPQHF	TRBV6-4	TRBJ1-5
TGTGCCACCAGTGTCAGGGGGGGACCGAACACTGAAGCTTTCTTT	CATSVRGGPNTEAFF	TRBV24-1	TRBJ1-1
TGTGCCAGCAGCTTATCGGACAGGGTTTATTTT	CASSLSDRVYF	TRBV7-4	TRBJ1-3
TGTGCTAGTGGTTGGGACAGGGCCCTTACTGAAGCTTTCTTT	CASGWDRALTEAFF	TRBV12-5	TRBJ1-1
TGTGCCAGCAGAGGACAGGGGTCCTTT	CASRGQGSF	TRBV7-9	TRBJ1-1
TGTGCCAGCTCACGGGCCTACGAGCAGTACTTC	CASSRAYEQYF	TRBV6-8	TRBJ2-7
TGTGCCAGCAGGGGCCCGCCGGGGCACAATGAGCAGTTCTTC	CASRGPPGHNEQFF	TRBV27	TRBJ2-1
TGTGACCTAGCGGGCACCGAGACCCAGTACTTC	CDLAGTETQYF	TRBV25-1	TRBJ2-5
TGTGCCAGCAGCCCTGGCAGGGGGCGGAGTGAAAAACTGTTTTTT	CASSPGRGRSEKLFF	TRBV13	TRBJ1-4
TGCGCCAGCACCCAAGGACAGGGTTACGAGCAGTACTTC	CASTQGQGYEQYF	TRBV10-1	TRBJ2-7
TGTGCCAGCATTCCGGGGAGGGCTCACACCATATATTTT	CASIPGRAHTIYF	TRBV6-1	TRBJ1-3
TGTGCCAGCAGTAATCCGATCTTGGGCAATGAGCAGTTCTTC	CASSNPILGNEQFF	TRBV6-4	TRBJ2-1
TGTGCCACCAGTGATTTTCGAATGACAGGGTGCGAAAAACTGTTTTTT	CATSDFRMTGCEKLFF	TRBV24-1	TRBJ1-4
TGTGCCAGCAGACTCAGGGGGAACTATGGCTACACCTTC	CASRLRGNYGYTF	TRBV7-3	TRBJ1-2
TGTGCCAGACCCCTTCTCCGGGGAGAGACCCAGTACTTC	CARPLLRGETQYF	TRBV6-5	TRBJ2-5
TGTGCCGGGAGGAGGAAAAACATTCAGTACTTC	CAGRRKNIQYF	TRBV27	TRBJ2-4
TGTGCCAGCAGCTGGGTGGACAGGGGAGAAAAACTGTTTTTT	CASSWVDRGEKLFF	TRBV11-2	TRBJ1-4
TGTGCCAGTAGCCCCAGCCCAGGGGAGCAGACAGATACGCAGTATTTT	CASSPSPGEQTDTQYF	TRBV19	TRBJ2-3
TGTGCTAGTGAGCAGGGTGGTAACACCGGGGAGCTGTTTTTT	CASEQGGNTGELFF	TRBV12-5	TRBJ2-2
TGCGCCAGCAGCTTGGCCCCCGCGGGAGCAGTGGCTGAAGCTTTCTTT	CASSLAPAGAVAEAFF	TRBV5-1	TRBJ1-1
TGTGCCAGCAGTGTCCCTGGACTAGCGGGGGGGCCCCACACCGGGGAGCTGTTTTTT	CASSVPGLAGGPHTGELFF	TRBV6-4	TRBJ2-2
TGTGCCAGCAGCCAAGATCTCCAGGAGAATTTTTCTTGGGAGACCCAGTACTTC	CASSQDLQENFSWETQYF	TRBV4-2	TRBJ2-5
TGTGCCAGCAGTCCCGTCCAGACAGGTGGCTACACCTTC	CASSPVQTGGYTF	TRBV12-3	TRBJ1-2
TGCGCCAGCAGCCGTGGGGTCACAGATACGCAGTATTTT	CASSRGVTDTQYF	TRBV5-1	TRBJ2-3
TGCAGCGTTGTTGGACACTTGAACCCTAGCAATCAGCCCCAGCATTTT	CSVVGHLNPSNQPQHF	TRBV29-1	TRBJ1-5
TGTGCCAGCAGCGTTCCGTCCCGGGACAGGGGCACCGGGGAGCTGTTTTTT	CASSVPSRDRGTGELFF	TRBV5-8	TRBJ2-2
TGCGCCAGCAGCCACCGGCCGGGACAGGCCTACGAGCAGTACTTC	CASSHRPGQAYEQYF	TRBV4-3	TRBJ2-7
TGTGCCATCAGTGAAGCAAAGGGGACCCTCTACGAGCAGTACTTC	CAISEAKGTLYEQYF	TRBV10-3	TRBJ2-7
TGTGCTAGTTTTGATGGGACAGGGGGCGCCGGAGATACGCAGTATTTT	CASFDGTGGAGDTQYF	TRBV12-5	TRBJ2-3
TGTGCCAGCAGGGTCGGCAATGAAAAACTGTTTTTT	CASRVGNEKLFF	TRBV12-4	TRBJ1-4
TGCGCCAATTCAGAACTTTGGCCTAGGGAAAAACTGTTTTTT	CANSELWPREKLFF	TRBV5-1	TRBJ1-4
TGTGCCAGCACGGTACTAGCGGGAGTCGGGACCTACGAGCAGTACTTC	CASTVLAGVGTYEQYF	TRBV3-1	TRBJ2-7
TGTGCCAGCAGCGTAGCGGTTTACCACAGGGGGCATCTTAGGGTAGATTACGAGCAGTACTTC	CASSVAVYHRGHLRVDYEQYF	TRBV9	TRBJ2-7
TGTGCCAGCAGTCATCAGGGGAGGGGCTACACCTTC	CASSHQGRGYTF	TRBV6-1	TRBJ1-2
TGTGCCACACTACTAGCGGGAGGGCTTCTCAGCAATCAGCCCCAGCATTTT	CATLLAGGLLSNQPQHF	TRBV6-5	TRBJ1-5
TGTGCCATCAGTGGGGGGCAGGAAGGGAATGAAGCTTTCTTT	CAISGGQEGNEAFF	TRBV10-3	TRBJ1-1
TGTGCCAGCAGCGGTAGGACTTTCTCCTACGAGCAGTACTTC	CASSGRTFSYEQYF	TRBV9	TRBJ2-7
TGTGCCAGACGGGGAGGACCACTTCCTCAGCCCCAGCATTTT	CARRGGPLPQPQHF	TRBV6-5	TRBJ1-5
TGTGCCAGCAGTTTACGTCGTATAGGGTCGACTATCCCGTCAAGACCTAGAACTAGCAATCAGCCCCAGCATTTT	CASSLRRIGSTIPSRPRTSNQPQHF	TRBV28	TRBJ1-5
TGCGCCAGCAGCTTGGGTAAAACAAAGGGGGCAGAGCACTCTGGAAACACCATATATTTT	CASSLGKTKGAEHSGNTIYF	TRBV5-1	TRBJ1-3
TGTGCCAGCACTCGGGGCCCAGGGGGACCCGAGCAGTACTTC	CASTRGPGGPEQYF	TRBV6-4	TRBJ2-7
TGTGCCAGCAGCTTCCCGGGGGGAGACAGTGGGAATGAAAAACTGTTTTTT	CASSFPGGDSGNEKLFF	TRBV5-5	TRBJ1-4
TGTGCCAGCAGTGAAGGGAGGGCCTACGAGCAGTACTTC	CASSEGRAYEQYF	TRBV6-4	TRBJ2-7
