TGTGCCAGTATGGACGGGGACGGGCCCTACGAGCAGTACTTC	CASMDGDGPYEQYF	TRBV19	TRBJ2-7
TGTGCCAGCAGCTTTCCCAGACCTAGGGAGTCGAATCAGCCCCAGCATTTT	CASSFPRPRESNQPQHF	TRBV7-3	TRBJ1-5
TGCGCCAGCAGCGACCGATTCCGGGACACCTACGAGCAGTACTTC	CASSDRFRDTYEQYF	TRBV5-1	TRBJ2-7
TGTGCTAGCAGCTTATGGGTGGACAGCAGTGAAGCTTTCTTT	CASSLWVDSSEAFF	TRBV7-7	TRBJ1-1
TGTGGACCCGGGACAGGGACCGAGGAGCTGTTTTTT	CGPGTGTEELFF	TRBV28	TRBJ2-2
TGTGCCAGCAGCTTAGCCCACAGGGGGCAGACTGAAGCTTTCTTT	CASSLAHRGQTEAFF	TRBV7-2	TRBJ1-1
TGTGCCAGCAGCTTAGGAGTACATGGAGTTGGCTACACCTTC	CASSLGVHGVGYTF	TRBV11-3	TRBJ1-2
TGTGCCAGCAGCCAAGATTCTGGGACACTCGAAACTGAAGCTTTCTTT	CASSQDSGTLETEAFF	TRBV14	TRBJ1-1
TGTGCCAGCAGCGGCCCCCCAGGGAATCAGCCCCAGCATTTT	CASSGPPGNQPQHF	TRBV5-5	TRBJ1-5
TGTGCCAGCAGCTTACTACTTACAGAGGGCAAAAACATTCAGTACTTC	CASSLLLTEGKNIQYF	TRBV11-3	TRBJ2-4
TGTGCCAGCAGTTTATGTGGGGGGTTCACTGAAGCTTTCTTT	CASSLCGGFTEAFF	TRBV27	TRBJ1-1
TGTGCCTGGAGTCATAGGACGAAAGAGACCCAGTACTTC	CAWSHRTKETQYF	TRBV30	TRBJ2-5
TGTGCCAGCAGACACCGGGACAGAGCCACAGATACGCAGTATTTT	CASRHRDRATDTQYF	TRBV2	TRBJ2-3
TGTGCCAGCATGGGGGGTTATGAGACCCAGTACTTC	CASMGGYETQYF	TRBV6-4	TRBJ2-5
TGTGCATTCCTCCAATATCAGCCCCAGCATTTT	CAFLQYQPQHF	TRBV9	TRBJ1-5
TGTGCCAGCAGCGACCCGCAAGTCCTCGAAGAGACCCAGTACTTC	CASSDPQVLEETQYF	TRBV5-6	TRBJ2-5
TGCGCCAGCAGCTTGGTCGGGTTTGGGGGGGAGGGAGGAACCGGTTTTTCACTGGGCTACACCTTC	CASSLVGFGGEGGTGFSLGYTF	TRBV5-1	TRBJ1-2
TGTGCCAGCAGCGCGTTCCTTGGGGACAGCCCCTCCTACGAGCAGTACTTC	CASSAFLGDSPSYEQYF	TRBV9	TRBJ2-7
TGTGCCATCAGTGGCAGTCCGGATGGGGAGCCCCAGCATTTT	CAISGSPDGEPQHF	TRBV10-3	TRBJ1-5
TGTGCCTGGAGTGAGCATTTAAAGCGGGCAGTCAGGGAAAAACTGTTTTTT	CAWSEHLKRAVREKLFF	TRBV30	TRBJ1-4
TGTGCCAGCAGTAACGAGCTGTCAGGACAGGGCAACGAGCAGTACTTC	CASSNELSGQGNEQYF	TRBV6-3	TRBJ2-7
TGTGCCAGCAGTTTATCCTGGAAGCCAGGGTGCCAAGAGACCCAGTACTTC	CASSLSWKPGCQETQYF	TRBV27	TRBJ2-5
TGTGCCAGCAGCTTTCAGGGGCCCTACGAGCAGTACTTC	CASSFQGPYEQYF	TRBV7-2	TRBJ2-7
TGCAGGGCCGGACAGGGGGCTAGGGAACATCCTCCCACCGGGGAGCTGTTTTTT	CRAGQGAREHPPTGELFF	TRBV20-1	TRBJ2-2
TGTGCCAGCAGCCAAACAACAGGGGGGAGCCCAAATCAGCCCCAGCATTTT	CASSQTTGGSPNQPQHF	TRBV13	TRBJ1-5
TGCGCCAGCAGCTTGGAACAATTGGGGGCGATCTCAACTAATGAAAAACTGTTTTTT	CASSLEQLGAISTNEKLFF	TRBV5-1	TRBJ1-4
TGTGCCAGCAGTTACTCGCCCCAATCGGACAGGGAACCCTACGAGCAGTACTTC	CASSYSPQSDREPYEQYF	TRBV6-2	TRBJ2-7
TGTGCCACAAAATTTGTGTACTTTCCCTCTAACTATGGCTACACCTTC	CATKFVYFPSNYGYTF	TRBV19	TRBJ1-2
TGTGCCTGGAGTGTCAGGGGAGACGGGAGCTCCTACGAGCAGTACTTC	CAWSVRGDGSSYEQYF	TRBV30	TRBJ2-7
TGTGCCAGCAGTTTGCCCTCGCGGACTAGCTCCTACAATGAGCAGTTCTTC	CASSLPSRTSSYNEQFF	TRBV12-3	TRBJ2-1
TGTGCCAGCAGCGTAGCTGACTGGATGGGGCGAAAACTGTTTTTT	CASSVADWMGRKLFF	TRBV9	TRBJ1-4
TGTGCCAGCAGCGGGTTAGGCGCGGACTATGGCTACACCTTC	CASSGLGADYGYTF	TRBV5-6	TRBJ1-2
TGTAACCACAGGCCCGCCATTTACGAGCAGTACTTC	CNHRPAIYEQYF	TRBV30	TRBJ2-7
TGTGCCAGCCTAAACGGACAGGGGGCAGAGTGCTTC	CASLNGQGAECF	TRBV6-3	TRBJ1-2
TGTGCCAGCAGTGAAGGGGGCAGTGAGACCCAGTACTTC	CASSEGGSETQYF	TRBV12-3	TRBJ2-5
TGTGCCACCAGCAGGTCCCTGGGACAGGGGGCGCGTTACTACGAGCAGTACTTC	CATSRSLGQGARYYEQYF	TRBV15	TRBJ2-7
TGCGCCAGCAGCCAAGATGGGGGCGCTTTGACGGCCTACGAGCAGTACTTC	CASSQDGGALTAYEQYF	TRBV4-1	TRBJ2-7
TGTGCCTGGAACCAGGGGGCTTGGAGGGACGTGAACACCGGGGAGCTGTTTTTT	CAWNQGAWRDVNTGELFF	TRBV30	TRBJ2-2
TGTGCCAGTAGTGTTCCCCTACTAGCGGGAGGCCCCGGATACAATGAGCAGTTCTTC	CASSVPLLAGGPGYNEQFF	TRBV19	TRBJ2-1
TGTGCCACCAGGAACTTGGGAGACAGGAACTATGGCTACACCTTC	CATRNLGDRNYGYTF	TRBV24-1	TRBJ1-2
TGTGCCAGCAGCGGGGGGGAACGGGGCTGCTTGGACGAGCAGTACTTC	CASSGGERGCLDEQYF	TRBV7-4	TRBJ2-7
TGTGCCAGCAGCTTCTTGTTGGGAGTGGGGAGCTCCTACAATGAGCAGTTCTTC	CASSFLLGVGSSYNEQFF	TRBV5-6	TRBJ2-1
TGCAGTGCTAGCCCCCTTAATTCACCCCTCCACTTT	CSASPLNSPLHF	TRBV20-1	TRBJ1-6
TGTGCCAGCAGTTACCCCGGGGGCCCAGGCGGTGGCACAGATACGCAGTATTTT	CASSYPGGPGGGTDTQYF	TRBV6-3	TRBJ2-3
TGTGCCAGCAGCTTCGGGGGGGGAACGCCCTTTTTGAGTGCCGAGCAGTACTTC	CASSFGGGTPFLSAEQYF	TRBV9	TRBJ2-7
TGTGCCAGCAGCCCAGGGACAGTCGGGGTGAACACTGAAGCTTTCTTT	CASSPGTVGVNTEAFF	TRBV3-1	TRBJ1-1
TGCGCCAGCAGATACGTTCCGGTCGGGACAGGTACACCCGGGGAGCTGTTTTTT	CASRYVPVGTGTPGELFF	TRBV10-2	TRBJ2-2
TGTGCCAGCAGTTACCCACCGGTTGAGGCCTACGAGCAGTACTTC	CASSYPPVEAYEQYF	TRBV6-5	TRBJ2-7
TGTGCCAGCAGTTTAGGGGGTCGGTCCGGGGAGCTGTTTTTT	CASSLGGRSGELFF	TRBV27	TRBJ2-2
TGTGCCAGTAGTTCCTGGAGAAATCAGCCCCAGCATTTT	CASSSWRNQPQHF	TRBV19	TRBJ1-5
TGTGCCAGCACAGACAAAACCGATGAAAAACTGTTTTTT	CASTDKTDEKLFF	TRBV6-3	TRBJ1-4
TGTGCCAGCAGTGGTCGGGGGCGCCGTCAGCCCCAGCATTTT	CASSGRGRRQPQHF	TRBV27	TRBJ1-5
TGTGCCAGCAGCCAAGATCGTATTGTCAACTACAGTTCTGGAAACACCATATATTTT	CASSQDRIVNYSSGNTIYF	TRBV3-1	TRBJ1-3
TGTGCCAGCGTGGCATCCCTTATCGAGCAGTACTTC	CASVASLIEQYF	TRBV13	TRBJ2-7
TGTGCCAGCAGCTTGGGGGAGGGACCCCCTCACGAGCAGTACTTC	CASSLGEGPPHEQYF	TRBV5-5	TRBJ2-7
TGCGCCAGCAGCCCCAGGCTCGTGAACACTGAAGCTTTCTTT	CASSPRLVNTEAFF	TRBV4-3	TRBJ1-1
TGTGCCAGCTCCCGGGGTAGGAATCAGCCCCAGCATTTT	CASSRGRNQPQHF	TRBV18	TRBJ1-5
TGTGCCAGCAGCGTGCGTGACAGCATGCAGCCCCAGCATTTT	CASSVRDSMQPQHF	TRBV14	TRBJ1-5
TGTGCCAGCAGCCCCGGGGGCACAGATACGCAGTATTTT	CASSPGGTDTQYF	TRBV7-2	TRBJ2-3
TGCAGTGCTAGAGATCAGTCGGATGGCTACACCTTC	CSARDQSDGYTF	TRBV20-1	TRBJ1-2
TGTGCCAGCACTCTGGACGCGGTTGACCGTGAGCAGTTCTTC	CASTLDAVDREQFF	TRBV25-1	TRBJ2-1
TGTGCCAGCGGAGGACAGGGGGTAGCCTACGAGCAGTACTTC	CASGGQGVAYEQYF	TRBV6-2	TRBJ2-7
TGCGCCAGCAGTGGGGGGGGCCCAAGCACAGATACGCAGTATTTT	CASSGGGPSTDTQYF	TRBV10-2	TRBJ2-3
TGCGCCAGCAACGCGTACAGGGGTTCGAACACCGGGGAGCTGTTTTTT	CASNAYRGSNTGELFF	TRBV10-1	TRBJ2-2
TGTGCCAGCAGTTTGGGTAGTTACGGGGCACGAGGAAAAGAGACCCAGTACTTC	CASSLGSYGARGKETQYF	TRBV27	TRBJ2-5
TGTGCCAGCAGCGTAGTTATATTAAGCAATCAGCCCCAGCATTTT	CASSVVILSNQPQHF	TRBV9	TRBJ1-5
TGTGCCAGCAGCCAACGGGACAGGGAAGGAACTCGAGTCAACTATGGCTACACCTTC	CASSQRDREGTRVNYGYTF	TRBV13	TRBJ1-2
TGTGCCTGGAGTTGGACTAGCGGCTACAATGAGCAGTTCTTC	CAWSWTSGYNEQFF	TRBV30	TRBJ2-1
TGTGCCCCCAGGGGAGTCAATCAGCCCCAGCATTTT	CAPRGVNQPQHF	TRBV19	TRBJ1-5
TGCAGTGCTCCCTGGGAGGGGAGGGTGAACACCGGGGAGCTGTTTTTT	CSAPWEGRVNTGELFF	TRBV20-1	TRBJ2-2
TGTGCCAGTAGTATCTTCCCGGGACAGGCAAGGCGGGCCTATAATTCACCCCTCCACTTT	CASSIFPGQARRAYNSPLHF	TRBV19	TRBJ1-6
TGTGCCAGCAGCGTAGTTAAGAATTGCACCGGGGAGCTGTTTTTT	CASSVVKNCTGELFF	TRBV9	TRBJ2-2
TGCAGCGTTGCTAGGGACAGCCGTCGGGCAAATGAGCAGTTCTTC	CSVARDSRRANEQFF	TRBV29-1	TRBJ2-1
TGTGCCAGTAGTATAAACAGGGATAATGAAAAACTGTTTTTT	CASSINRDNEKLFF	TRBV19	TRBJ1-4
TGCGCCAGCAGCTGGTCGGGGGCCGGTGACTATGGCTACACCTTC	CASSWSGAGDYGYTF	TRBV5-1	TRBJ1-2
TGCGCCAGCAGCTTCCCCGGGGGGGCCGACGAGCAGTACTTC	CASSFPGGADEQYF	TRBV5-1	TRBJ2-7
TGTGCCAGCAGCTCGGGCGGAGGGAAGAACACTGAAGCTTTCTTT	CASSSGGGKNTEAFF	TRBV7-9	TRBJ1-1
TGTGCCAGCAGTTACCCCCTGGGACAGGGAGGGACCCGTGGCTACACCTTC	CASSYPLGQGGTRGYTF	TRBV6-5	TRBJ1-2
TGTGCCAGCAGTTGTTGGGACAGGGGTCCCCTCCACTTT	CASSCWDRGPLHF	TRBV12-3	TRBJ1-6
TGTGCCAGCAGCGAGCAGGGAACTGAAGCTTTCTTT	CASSEQGTEAFF	TRBV13	TRBJ1-1
TGTGCCAGCAGCCAAGGGAGATGGACTAGAACTGGGTCCTACAATGAGCAGTTCTTC	CASSQGRWTRTGSYNEQFF	TRBV14	TRBJ2-1
TGTGCCAGTAGTATCCCGACAGGGCACGGAAACACCATATATTTT	CASSIPTGHGNTIYF	TRBV19	TRBJ1-3
TGTGCCAGCACGGGTGGGGAGCTGTTTTTT	CASTGGELFF	TRBV9	TRBJ2-2
TGTGCCATCAGTGGACAGGGAGTCAATGAGCAGTTCTTC	CAISGQGVNEQFF	TRBV10-3	TRBJ2-1
TGTGCCAGCAAAACCGGGACTAGCGGGAATCGAGAGACCCAGTACTTC	CASKTGTSGNRETQYF	TRBV7-9	TRBJ2-5
TGCGCCAGCAGCTGCCCTCCCCCAGGGAAGAACACTGAAGCTTTCTTT	CASSCPPPGKNTEAFF	TRBV5-1	TRBJ1-1
TGTGCCAGCAGTTTAGGGGGACCTGCCTACGAGCAGTACTTC	CASSLGGPAYEQYF	TRBV6-2	TRBJ2-7
TGTGCCAGCAGCGTACTTGGGGCCCAGGAAAGGACTGAAGCTTTCTTT	CASSVLGAQERTEAFF	TRBV9	TRBJ1-1
TGCGCCAGCAGCTTGGCCAGGCTGGAGACCCAGTACTTC	CASSLARLETQYF	TRBV4-1	TRBJ2-5
TGCGCCAGCAGCGCCACGACAGGGGGAGGCCGAGATGAACTAGGCTACACCTTC	CASSATTGGGRDELGYTF	TRBV5-1	TRBJ1-2
TGCAGTGCAAATCGAGGAAGGGTCCAAGAGACCCAGTACTTC	CSANRGRVQETQYF	TRBV20-1	TRBJ2-5
TGTGCCAGCAGCTTAGATGCAATGGGTCGGAAAATCAGGCCCTACAATGAGCAGTTCTTC	CASSLDAMGRKIRPYNEQFF	TRBV7-8	TRBJ2-1
TGTGCCAGCAGGGAACCTCGGACTAGCGGGAGGACCTACGAGCAGTACTTC	CASREPRTSGRTYEQYF	TRBV12-4	TRBJ2-7
TGTGCCTCCCCCCAACAGGATAGCTCCTACGAGCAGTACTTC	CASPQQDSSYEQYF	TRBV27	TRBJ2-7
TGTGCCAGCAGCGAGATCGCGGAGAAGCACAATGAGCAGTTCTTC	CASSEIAEKHNEQFF	TRBV9	TRBJ2-1
TGTGCCAGCAGCCCCCCCCTCTACGAGCAGTACTTC	CASSPPLYEQYF	TRBV7-4	TRBJ2-7
TGTGCCAGCAGCCATGAATCCCTAGCGGGTAGGGGGACCTCCTACGAGCAGTACTTC	CASSHESLAGRGTSYEQYF	TRBV7-9	TRBJ2-7
TGTGGAGGACGGACCTTGAACATTCAGTACTTC	CGGRTLNIQYF	TRBV2	TRBJ2-4
TGTGCCAGCAGCTTAGTCGCCGGAGCCTCCTACAATGAGCAGTTCTTC	CASSLVAGASYNEQFF	TRBV7-4	TRBJ2-1
TGTGCCAGCACCGACCCGGGGGGGCTTAAAAGGGACACCGGGGAGCTGTTTTTT	CASTDPGGLKRDTGELFF	TRBV11-2	TRBJ2-2
