TGTGCCAGCAGCTGTCGGGGCGCGGGTCATTCACCCCTCCACTTT	CASSCRGAGHSPLHF	TRBV5-6	TRBJ1-6
TGTGCCAGCATCTCCAGGGGAATCCCCAACGAGCAGTACTTC	CASISRGIPNEQYF	TRBV27	TRBJ2-7
TGTGCTAGTGGTTTGGTACTAAGGGGCCGAGGGACTTCTGTAGAGCAGTTCTTC	CASGLVLRGRGTSVEQFF	TRBV12-5	TRBJ2-1
TGTGCCAGCCAGAGGGGGGGAGCACTAACTGAGCAGTTCTTC	CASQRGGALTEQFF	TRBV6-4	TRBJ2-1
TGCAGTGCTAGAGTTCCAAACAGGGGTTACTCCTACGAGCAGTACTTC	CSARVPNRGYSYEQYF	TRBV20-1	TRBJ2-7
TGTGCCAGCAGCTTAGAAGGGGGGCGAGAACCTGAGACCCAGTACTTC	CASSLEGGREPETQYF	TRBV11-3	TRBJ2-5
TGTGCCACCCCAGGGTCGCCAGAAGAGACCCAGTACTTC	CATPGSPEETQYF	TRBV6-5	TRBJ2-5
TGCAGCGTAAGGGGACAGGGTGCACCCCTCCACTTT	CSVRGQGAPLHF	TRBV29-1	TRBJ1-6
TGTGCCAGCAGTTATAAAAAAAGGACAGGGTGTGGAACTGAAGCTTTCTTT	CASSYKKRTGCGTEAFF	TRBV6-6	TRBJ1-1
TGTGCCAGCAGTTTAAAGGACCACGAGCAGTACTTC	CASSLKDHEQYF	TRBV27	TRBJ2-7
TGCAGTGCTCCCCCCGACAGAGATACGCAGTATTTT	CSAPPDRDTQYF	TRBV20-1	TRBJ2-3
TGTGCTAGTGGTTTGCTTTCGTCCGGGACTAGCGGGAGGGGTAATTGGGCTAACTATGGCTACACCTTC	CASGLLSSGTSGRGNWANYGYTF	TRBV12-5	TRBJ1-2
TGTGCCAGCACCCCTTCTGGAAACACCATATATTTT	CASTPSGNTIYF	TRBV9	TRBJ1-3
TGTGCCAGCAGCACCTTGGACAGGGAGCAGTATTTT	CASSTLDREQYF	TRBV2	TRBJ2-3
TGTGCCACCTTAGGGAAGGTGACCTCCTACGAGCAGTACTTC	CATLGKVTSYEQYF	TRBV24-1	TRBJ2-7
TGTGCCACCAGCAGAGGGTTACAGGGACAGTGGAAATCTTTCTTT	CATSRGLQGQWKSFF	TRBV15	TRBJ1-1
TGTGCCAGCAGTGAAGGGAGGGGGCACCCGTGGCCCTCTGGAAACACCATATATTTT	CASSEGRGHPWPSGNTIYF	TRBV6-5	TRBJ1-3
TGTGCCAGCTCAGAGACGGGTGACGCGTACGAGCAGTACTTC	CASSETGDAYEQYF	TRBV18	TRBJ2-7
TGCAGTGCTAGTAAGGACAGGGAGGTGTCCTATAATTCACCCCTCCACTTT	CSASKDREVSYNSPLHF	TRBV20-1	TRBJ1-6
TGTGCCAGCAGTGACTCGCGCACAGATACGCAGTATTTT	CASSDSRTDTQYF	TRBV6-4	TRBJ2-3
TGCGCCAGCAGCTGGGACTCCGCAATTCGACTAGCGGGTCAGTGGGTCTACGAGCAGTACTTC	CASSWDSAIRLAGQWVYEQYF	TRBV5-1	TRBJ2-7
TGCGCCAGCAGCCAAGATCGACCCGACAGCACCGGGGAGCTGTTTTTT	CASSQDRPDSTGELFF	TRBV4-3	TRBJ2-2
TGCGCCAGCAGCTTGACACAGGGGGCTGGCTACACCTTC	CASSLTQGAGYTF	TRBV5-1	TRBJ1-2
TGTGCCAGAAAAGCTGTTGGGGAGATTAACTACGAGCAGTACTTC	CARKAVGEINYEQYF	TRBV6-4	TRBJ2-7
TGTGCCAGCAGCCAAGATTCTTCCCCCCGGACAGGGACTGAAGCTTTCTTT	CASSQDSSPRTGTEAFF	TRBV4-2	TRBJ1-1
TGCAGCGTATGTCGTCCCCCTCAAGGGACATCAGATACGCAGTATTTT	CSVCRPPQGTSDTQYF	TRBV29-1	TRBJ2-3
TGTGCCATCAGTGATACCCTCCGGGGTCCTCCGACTGAAGCTTTCTTT	CAISDTLRGPPTEAFF	TRBV10-3	TRBJ1-1
TGTGCCAGCAAGGGGGGTGATGGCTACACCTTC	CASKGGDGYTF	TRBV27	TRBJ1-2
TGCAGTGCCCGGACAGGTGGATCGGGCCAAGAGACCCAGTACTTC	CSARTGGSGQETQYF	TRBV20-1	TRBJ2-5
TGTGCCAGCAGAACGTTGAGGCGCAATCAGCCCCAGCATTTT	CASRTLRRNQPQHF	TRBV6-6	TRBJ1-5
TGTGCCAGCAGCCGAGGAGAACGACCCCCCGGGACTAGATTCCAGGAGACCCAGTACTTC	CASSRGERPPGTRFQETQYF	TRBV7-3	TRBJ2-5
TGTGCCAGCAGCGTGGGGGGGGCACGGGGGAATGAGCAGTTCTTC	CASSVGGARGNEQFF	TRBV13	TRBJ2-1
TGTGCCAGCAGCGCACTGGGGGTATATAGCAATCAGCCCCAGCATTTT	CASSALGVYSNQPQHF	TRBV9	TRBJ1-5
TGCGCCAGCAGCCGTGGGGCCCCGTATGAAAAACTGTTTTTT	CASSRGAPYEKLFF	TRBV5-1	TRBJ1-4
TGTGCCAGTAATCAGGGAGGCACCTACGAGCAGTACTTC	CASNQGGTYEQYF	TRBV19	TRBJ2-7
TGCAGCGTTCTCCGGGGGCCTCGGTGGTCACCCCTCCACTTT	CSVLRGPRWSPLHF	TRBV29-1	TRBJ1-6
TGTGCCAGCAGCGCCGCCCAGGGGGAGCGTGCCGGGGAGCTGTTTTTT	CASSAAQGERAGELFF	TRBV13	TRBJ2-2
TGTGCCACCAGTGATCCCGGGACCAAAAGAGGGTACGAGCAGTACTTC	CATSDPGTKRGYEQYF	TRBV24-1	TRBJ2-7
TGTGCCTGGACGGAATCTAAAGCTTTCTTT	CAWTESKAFF	TRBV30	TRBJ1-1
TGCGCCAGCAGTGTGCCGACCGCTAGCGGGCCCCGCTCCTACAATGAGCAGTTCTTC	CASSVPTASGPRSYNEQFF	TRBV10-1	TRBJ2-1
TGTGCCATCAGCGGAGGTGGCTACACCTTC	CAISGGGYTF	TRBV10-3	TRBJ1-2
TGTGCCAGCAGCCAAGGGGGGCCAGGCAACACTGAAGCTTTCTTT	CASSQGGPGNTEAFF	TRBV3-1	TRBJ1-1
TGTGCCAGCAGTTTTGAGGACAGCCAAGGTTACTATGGCTACACCTTC	CASSFEDSQGYYGYTF	TRBV27	TRBJ1-2
TGTGCCAGCACCTGGGGGACAGGGGGCCTAGACACTGAAGCTTTCTTT	CASTWGTGGLDTEAFF	TRBV6-2	TRBJ1-1
TGCAGTGCTCACGGACAGGGACATGGCTACACCTTC	CSAHGQGHGYTF	TRBV20-1	TRBJ1-2
TGTGCCAGCATCCCGGGGGGCGGGGACACCGGGGAGCTGTTTTTT	CASIPGGGDTGELFF	TRBV5-4	TRBJ2-2
TGTGCCAGCAGCTGGACAGCCCCCTACGAGCAGTACTTC	CASSWTAPYEQYF	TRBV13	TRBJ2-7
TGTGCCAGCAGCTTAGATGACGGCTACACCTTC	CASSLDDGYTF	TRBV11-3	TRBJ1-2
TGTGCCAGCAGCACCTCAGATACGCAGTATTTT	CASSTSDTQYF	TRBV2	TRBJ2-3
TGCAGCCCCGACTCGGCCGAGGACTATGGCTACACCTTC	CSPDSAEDYGYTF	TRBV29-1	TRBJ1-2
TGCGCCAGCAGTTTAAACACAGGGGGCGGGCGCGCGAACACCGGGGAGCTGTTTTTT	CASSLNTGGGRANTGELFF	TRBV10-1	TRBJ2-2
TGTGCCAGCAGTTCGGGATGCCCGAACACTGAAGCTTTCTTT	CASSSGCPNTEAFF	TRBV12-4	TRBJ1-1
TGTGCCAGCAGCAAGGGGACCCACACTGAAGCTTTCTTT	CASSKGTHTEAFF	TRBV7-2	TRBJ1-1
TGTGCCAGCAGCCAAGATCTCTATTCCATCAAGAACACTGAAGCTTTCTTT	CASSQDLYSIKNTEAFF	TRBV14	TRBJ1-1
TGTGCCAGCAGCTCACACCCCCGGGACTATTCCTACGAGCAGTACTTC	CASSSHPRDYSYEQYF	TRBV11-2	TRBJ2-7
TGTGCCAGCAGAACCGGGACTAGAATTAAGAGCTCCTACAATGAGCAGTTCTTC	CASRTGTRIKSSYNEQFF	TRBV27	TRBJ2-1
TGCAGTGCGTCCTTTCGGCAAAATCAGCCCCAGCATTTT	CSASFRQNQPQHF	TRBV20-1	TRBJ1-5
TGCGCCAGCAGCTTCAACTTACAAAGCTCCTACGAGCAGTACTTC	CASSFNLQSSYEQYF	TRBV5-1	TRBJ2-7
TGTGCCACCGGGACAGGGGGTAAATGGCACGAGCAGTACTTC	CATGTGGKWHEQYF	TRBV19	TRBJ2-7
TGTGCCAGCAGTTCCCAGAGGGGTCAGCCCCAGCATTTT	CASSSQRGQPQHF	TRBV6-6	TRBJ1-5
TGTGCCAGCAGCAGCACTTGCTACGAGCAGTACTTC	CASSSTCYEQYF	TRBV7-9	TRBJ2-7
TGTGCCAGCAGATCGCCAGAGCCGGGACTAGCGGTTGGGGAGGACAATGAGCAGTTCTTC	CASRSPEPGLAVGEDNEQFF	TRBV6-5	TRBJ2-1
TGTGCCAGCAGCCCCTCGCGGGAGGGGAACGAGCAGTACTTC	CASSPSREGNEQYF	TRBV7-3	TRBJ2-7
TGTGCCAGCAGCGGATTCGACTGTAATGAGCAGTTCTTC	CASSGFDCNEQFF	TRBV7-9	TRBJ2-1
TGCGCCAGCACGCCGGGTACTAGCCAGGATAAAGAGACCCAGTACTTC	CASTPGTSQDKETQYF	TRBV10-2	TRBJ2-5
TGTGCCAGCAGTTTAGTTTGGACTAGCGGGGGGGCCGGCAATGAGCAGTTCTTC	CASSLVWTSGGAGNEQFF	TRBV12-4	TRBJ2-1
TGCAGCGTTGTAAACAGGGAAGGAACCCAGTACTTC	CSVVNREGTQYF	TRBV29-1	TRBJ2-5
TGTGCCAGTAGTATGCGTCAGGACGGCTGCTGGGAAGCTTTCTTT	CASSMRQDGCWEAFF	TRBV19	TRBJ1-1
TGCAGTGCTAGAGCCCCTAGAGGGAGAGGGCAGCCCCAGCATTTT	CSARAPRGRGQPQHF	TRBV20-1	TRBJ1-5
TGCGCCAGCAGCTTAAGACACAGGGTGGGGTCTTATAGCAATCAGCCCCAGCATTTT	CASSLRHRVGSYSNQPQHF	TRBV5-1	TRBJ1-5
TGTGCCAAAGGGAAGACCAATCAGCCCCAGCATTTT	CAKGKTNQPQHF	TRBV4-2	TRBJ1-5
TGTGCCAGCACAGTCGCTAGCGGGACAGAGACCCAGTACTTC	CASTVASGTETQYF	TRBV6-5	TRBJ2-5
TGTGCCAGCAGCTTAGGGGGTGCGGGACTTTTCGAAAAACTGTTTTTT	CASSLGGAGLFEKLFF	TRBV7-8	TRBJ1-4
TGTGCCAGCAGCCAAGCACCCCCCGGGACAGGACGCGGCTACACCTTC	CASSQAPPGTGRGYTF	TRBV14	TRBJ1-2
TGCGCCAGCACCCTCCTACCGGCGATCTACGAGCAGTACTTC	CASTLLPAIYEQYF	TRBV5-1	TRBJ2-7
TGTGCCATCAGTGCGTCAAGGGACTGGAGCATGAACACTGAAGCTTTCTTT	CAISASRDWSMNTEAFF	TRBV10-3	TRBJ1-1
TGTGCCAGCAGCCCGGGACTAGCGGGAGCATGTGAGCAGTACTTC	CASSPGLAGACEQYF	TRBV7-3	TRBJ2-7
TGTGCCAGCAGCCCCACACTAGGGACTAGCGGGCGATTGATCCAAGATACGCAGTATTTT	CASSPTLGTSGRLIQDTQYF	TRBV7-3	TRBJ2-3
TGTGCCAGCAGGTCGGTGGGACAGCGGGATCAGCCCCAGCATTTT	CASRSVGQRDQPQHF	TRBV12-4	TRBJ1-5
TGTGCCAGCAGCGGACCAACCAAGGGGCACCGGGGGCGTACCCAGGAGCAGTACTTC	CASSGPTKGHRGRTQEQYF	TRBV9	TRBJ2-7
TGTGCCGCACGACTAGCGGGAGTGCAAGCCAAAAACATTCAGTACTTC	CAARLAGVQAKNIQYF	TRBV6-1	TRBJ2-4
TGTGCCAGCATGGGCAGACTGCTACCTGGAAACACCATATATTTT	CASMGRLLPGNTIYF	TRBV6-4	TRBJ1-3
TGTGCCAGGCCTGGGGACAGGTGCTCTGGGGCCAACGTCCTGACTTTC	CARPGDRCSGANVLTF	TRBV6-4	TRBJ2-6
TGTGCCAGCAGCTTGTACCAGGGGTCAGACTACGAGCAGTACTTC	CASSLYQGSDYEQYF	TRBV7-4	TRBJ2-7
TGTGCCAGCAGCTTAGCTCCGTGCGGGAGATGTGGCTACACCTTC	CASSLAPCGRCGYTF	TRBV11-2	TRBJ1-2
TGTGCCAGCAGCTGCCCGGGACTAGCGGGAGGGCGTACCGGGGAGCTGTTTTTT	CASSCPGLAGGRTGELFF	TRBV14	TRBJ2-2
TGTGCCAGCAGCGATCTGAAAGGCTACAATGAGCAGTTCTTC	CASSDLKGYNEQFF	TRBV13	TRBJ2-1
TGTGCCACCCGGGCGGGACTAGCGGGGGCCATGAATGAGCAGTTCTTC	CATRAGLAGAMNEQFF	TRBV9	TRBJ2-1
TGTGCCACCAGCACCCCTAGCGGGTGCAAGGATACGCAGTATTTT	CATSTPSGCKDTQYF	TRBV15	TRBJ2-3
TGTGCCAGCAGCGATTGCCGAGGACAGGGGAATGGCTACACCTTC	CASSDCRGQGNGYTF	TRBV13	TRBJ1-2
TGTGCCAGCAGTTTATCGGACGGGACTAGCGGGGGGGCCTCGAGGCCTAACATGGGGAATGAGCAGTTCTTC	CASSLSDGTSGGASRPNMGNEQFF	TRBV27	TRBJ2-1
TGTGCCAGCAGCTGTTCCGAAAGACATCGGGGACGACCATTAGAGACCCAGTACTTC	CASSCSERHRGRPLETQYF	TRBV3-1	TRBJ2-5
TGCAGCCAACCGGGACAGAATAGCTACGAGCAGTACTTC	CSQPGQNSYEQYF	TRBV29-1	TRBJ2-7
TGTGCCAGCAGCCCTATTCGTTTCCCTAACTATGGCTACACCTTC	CASSPIRFPNYGYTF	TRBV7-3	TRBJ1-2
TGTGCCAGCCACCTGGGGGCTTATGGCTACACCTTC	CASHLGAYGYTF	TRBV6-6	TRBJ1-2
TGTGCCAGCAGCTTAGATCTGCCGGGGGCAAGGTACTCTGGAAACACCATATATTTT	CASSLDLPGARYSGNTIYF	TRBV11-2	TRBJ1-3
TGTGCCATCAGTATAGTCCAGCGGCGGGCCAAAAACATTCAGTACTTC	CAISIVQRRAKNIQYF	TRBV10-3	TRBJ2-4
TGTGCCAAGAAGGGGTTAAACAGGTCCACCGGGGAGCTGTTTTTT	CAKKGLNRSTGELFF	TRBV27	TRBJ2-2
TGTGCCAGCAGCTTACTGCGTGGATTCCGGGACAGCGGCGAGCAGTACTTC	CASSLLRGFRDSGEQYF	TRBV7-3	TRBJ2-7
TGCAGTGCCGTTCAGCAGAACACTGAAGCTTTCTTT	CSAVQQNTEAFF	TRBV20-1	TRBJ1-1
