TGCGCCAGCAGTGAGTTGAAGGGGGATGGGGCCAACGTCCTGACTTTC	CASSELKGDGANVLTF	TRBV10-1	TRBJ2-6
TGTGCCACGTCTCGACTAGCGGCCGGAAGTATAAGCACAGATACGCAGTATTTT	CATSRLAAGSISTDTQYF	TRBV24-1	TRBJ2-3
TGTGCCAGCAGCTTACTAACTGGGGAGGAGAAATTACCCTACAATGAGCAGTTCTTC	CASSLLTGEEKLPYNEQFF	TRBV7-9	TRBJ2-1
TGTGCCAGCAGTAGCAGGCCGGGACAGTCACCCCTCCACTTT	CASSSRPGQSPLHF	TRBV12-3	TRBJ1-6
TGTGCCAGAACTAGCGGCGGGGGCGAGGGGCAGTTCTTC	CARTSGGGEGQFF	TRBV11-2	TRBJ2-1
TGTGCCAGCAGTTACTCCAGTGGGGTACGAGCAACTAATGAAAAACTGTTTTTT	CASSYSSGVRATNEKLFF	TRBV6-5	TRBJ1-4
TGTGCCAGCAGCTTAGACTGGACTAGCGGCAGTGAGCAGTTCTTC	CASSLDWTSGSEQFF	TRBV7-9	TRBJ2-1
TGTGCCAGCAGCTTCCGACAGAATCAGCCCCAGCATTTT	CASSFRQNQPQHF	TRBV27	TRBJ1-5
TGTGCCAGCAGCCTTGACAGGCGTTTAGAGCAGTTCTTC	CASSLDRRLEQFF	TRBV27	TRBJ2-1
TGTGCTAGTTTCCGGGGGACTGAAGCTTTCTTT	CASFRGTEAFF	TRBV12-5	TRBJ1-1
TGCGCCAGCAGCCAAGATCAAACCGCGGGAGATGGGAGCAATCAGCCCCAGCATTTT	CASSQDQTAGDGSNQPQHF	TRBV4-3	TRBJ1-5
TGTGCCAGCAGCAGCCGGGTCGTGCCCTTCACCTACGAGCAGTACTTC	CASSSRVVPFTYEQYF	TRBV7-9	TRBJ2-7
TGTGCCAGCAGAAGAGCCTCCCAGTGCTCTGGAAACACCATATATTTT	CASRRASQCSGNTIYF	TRBV6-3	TRBJ1-3
TGTGCCAGCATATCAGCGGGAGGCGAGCAGTACTTC	CASISAGGEQYF	TRBV7-2	TRBJ2-7
TGTGCCAGCAGGGCACAGGTTCACCCGGGGTGGCGCTCTGGGGCCAACGTCCTGACTTTC	CASRAQVHPGWRSGANVLTF	TRBV7-4	TRBJ2-6
TGTGCCAGCGGTCTGGTGGGAGCTTTCTTT	CASGLVGAFF	TRBV6-4	TRBJ1-1
TGTGCCAGCAGCACGAGGGACAGATACCGGGAACCTGAAGCTTTCTTT	CASSTRDRYREPEAFF	TRBV7-9	TRBJ1-1
TGTGCCAGCAGCCCCGGGGGAGAGACCCAGTACTTC	CASSPGGETQYF	TRBV25-1	TRBJ2-5
TGTGCCAGCAAGGGGGTTACCTACGAGCAGTACTTC	CASKGVTYEQYF	TRBV5-4	TRBJ2-7
TGTGCCAGCAGCACCATAACTAAGGACAGGTACCGCACCGGGGAGCTGTTTTTT	CASSTITKDRYRTGELFF	TRBV13	TRBJ2-2
TGCGCCAGCAGCCGGACTAGCGTAGATGAAAGGTGGGACAATGAGCAGTTCTTC	CASSRTSVDERWDNEQFF	TRBV4-1	TRBJ2-1
TGCAGTGCTAGAGTTTGTGTCGACAGTAGGTGTGCTTTCTTT	CSARVCVDSRCAFF	TRBV20-1	TRBJ1-1
TGTGCCAGCAGCATGAGGCGTTGGGGGGGCTACACTGAAGCTTTCTTT	CASSMRRWGGYTEAFF	TRBV9	TRBJ1-1
TGTGCCAGCAGGGAGCAGGTTAGGACTAGCAATCAGCCCCAGCATTTT	CASREQVRTSNQPQHF	TRBV9	TRBJ1-5
TGTGCCAGCAGCGTCCATAACCCTGCAAAGGACAGGGGGAGCAATCAGCCCCAGCATTTT	CASSVHNPAKDRGSNQPQHF	TRBV13	TRBJ1-5
TGTGCCAGCAGAGAGGACAGGGGAGGACCCGGAAACACCATATATTTT	CASREDRGGPGNTIYF	TRBV6-5	TRBJ1-3
TGTGCCAGCAGCTGGCCCCGGACAGGCAATCAGCCCCAGCATTTT	CASSWPRTGNQPQHF	TRBV7-9	TRBJ1-5
TGTGCCAGCAGTCAGGGGAACCGACCTGCCTACGAGCAGTACTTC	CASSQGNRPAYEQYF	TRBV6-3	TRBJ2-7
TGTGCCACGGTTGTCCCCCACAGGGAAGAGACCCAGTACTTC	CATVVPHREETQYF	TRBV9	TRBJ2-5
TGTGCCAGCACCTTGGGGCCGGGACTAGCGGGGGGGGCCAAAAACATTCAGTACTTC	CASTLGPGLAGGAKNIQYF	TRBV7-4	TRBJ2-4
TGTGCCTGGAGTGTGGGGGGGGGCACAGATACGCAGTATTTT	CAWSVGGGTDTQYF	TRBV30	TRBJ2-3
TGTGCCACCAGTGGCCCGGGACCGGGTCATGAGCAGTTCTTC	CATSGPGPGHEQFF	TRBV24-1	TRBJ2-1
TGTGCCAGCAGCCTCAGTGACTTCAGGGTGAAATCCTATAATTCACCCCTCCACTTT	CASSLSDFRVKSYNSPLHF	TRBV13	TRBJ1-6
TGTGCCAGCAGTCATTCCAGTGGCTACACCTTC	CASSHSSGYTF	TRBV27	TRBJ1-2
TGTGCCACCAGTGATTTGCACCTGTCCGGGACAGGGGGGGTCTACGAGCAGTACTTC	CATSDLHLSGTGGVYEQYF	TRBV24-1	TRBJ2-7
TGTGCCAGCAGCGGACCTACCTACGAGCAGTACTTC	CASSGPTYEQYF	TRBV13	TRBJ2-7
TGTGCCAGCACTCGACCCCTGCTACGTGAGCAGTTCTTC	CASTRPLLREQFF	TRBV6-6	TRBJ2-1
TGTGCCAGCAGCCTCAGGTACTTC	CASSLRYF	TRBV7-3	TRBJ2-7
TGCAGTGCTAACAAGGTTCGACAGGGTAGCTCCTATAATTCACCCCTCCACTTT	CSANKVRQGSSYNSPLHF	TRBV20-1	TRBJ1-6
TGTGCCAGCAGTGAAGCTTCCGGGACATCCCCAAGTCGGCGTCAGCCCCAGCATTTT	CASSEASGTSPSRRQPQHF	TRBV6-1	TRBJ1-5
TGTGCCAGCAGAAGCGGGACCCCGAACACCGGGGAGCTGTTTTTT	CASRSGTPNTGELFF	TRBV6-3	TRBJ2-2
TGTGCCAGCACCCCCGACAGACCCCGGAGCTCTGGAAACACCATATATTTT	CASTPDRPRSSGNTIYF	TRBV11-3	TRBJ1-3
TGCAGTGCCCACGGACAGGGAAGGCCCAAAAACATTCAGTACTTC	CSAHGQGRPKNIQYF	TRBV20-1	TRBJ2-4
TGCGCCAGCAGTCAGATCAAGCAGCCCCAGCATTTT	CASSQIKQPQHF	TRBV10-2	TRBJ1-5
TGTGCCACCAGTGAGAAGCAGAGGGATCCAGGGGTTAAAGGCTCTGGAAACACCATATATTTT	CATSEKQRDPGVKGSGNTIYF	TRBV24-1	TRBJ1-3
TGTGCCAGCAGGAACAGAGGCTACACCTTC	CASRNRGYTF	TRBV6-5	TRBJ1-2
TGTGCCAGCAGCTTAGGAACCGGGACAGAAGCCGCTATGAACACTGAAGCTTTCTTT	CASSLGTGTEAAMNTEAFF	TRBV7-6	TRBJ1-1
TGTGCCAGCAGTTACCCCGATCTCAAAGAGCTCCAATCGGAGACCCAGTACTTC	CASSYPDLKELQSETQYF	TRBV6-2	TRBJ2-5
TGTGCCAGCAGTTTAACTATTCCAGCGGAGATGGACACAGATACGCAGTATTTT	CASSLTIPAEMDTDTQYF	TRBV27	TRBJ2-3
TGTGCCAGCACGGGAAGGCAGGGCGATCAGCCCCAGCATTTT	CASTGRQGDQPQHF	TRBV6-2	TRBJ1-5
TGTGCCAGCAGCCAGGGACAGGGAGTATACGAGCAGTACTTC	CASSQGQGVYEQYF	TRBV14	TRBJ2-7
TGTGCCAGCAGACCGATGACTAGCGGGAGAACTCCCACTGAAGCTTTCTTT	CASRPMTSGRTPTEAFF	TRBV6-8	TRBJ1-1
TGCAGCGTTGGGGGGGGGGTCCAAGAGACCCAGTACTTC	CSVGGGVQETQYF	TRBV29-1	TRBJ2-5
TGTGCCAGCAGTGACTCGCCCGGGCCAGGAAAGCACATTCAGTACTTC	CASSDSPGPGKHIQYF	TRBV6-4	TRBJ2-4
TGTGCTAGTGGTAGACGGGGGACAGGGCTTACTTCCATGAACACTGAAGCTTTCTTT	CASGRRGTGLTSMNTEAFF	TRBV12-5	TRBJ1-1
TGTGCCAGCAGCCGGACCCTACCTAATGAAAAACTGTTTTTT	CASSRTLPNEKLFF	TRBV3-1	TRBJ1-4
TGCGCCAGCAGCGACTGCCAAGAGACCCAGTACTTC	CASSDCQETQYF	TRBV5-1	TRBJ2-5
TGTGCCAGTAGTATCCCTGGGGGGAATCGTGAAAAACTGTTTTTT	CASSIPGGNREKLFF	TRBV19	TRBJ1-4
TGCGCCAGCAGCTGCGCGCTGACTAGCGGGAGGGCCCGACACATTCAGCCCCAGCATTTT	CASSCALTSGRARHIQPQHF	TRBV5-1	TRBJ1-5
TGTGCCAGCAGCTGGGGGGGGGAGCCCTACGAGCAGTACTTC	CASSWGGEPYEQYF	TRBV7-9	TRBJ2-7
TGTGCCACCAGCCAACACGGGGAGGCCTACAATGAGCAGTTCTTC	CATSQHGEAYNEQFF	TRBV15	TRBJ2-1
TGTGCCAGCAAGACGGGGCGACGGGGCACAGGTTATGGCTACACCTTC	CASKTGRRGTGYGYTF	TRBV7-9	TRBJ1-2
TGTGCCAGCAGCTTATCCGACAGGGAGGGCGGAGGTTGGTGGGGGAATGGGAACACTGAAGCTTTCTTT	CASSLSDREGGGWWGNGNTEAFF	TRBV7-6	TRBJ1-1
TGCAGTGCTAGGTCCGGACGAACCGGGGAGCTGTTTTTT	CSARSGRTGELFF	TRBV20-1	TRBJ2-2
TGTGCCAGCAGTGACTCGAGGCGGAGCGAGCAGTACTTC	CASSDSRRSEQYF	TRBV6-4	TRBJ2-7
TGTGCCAGCAGCTTAGCCGCCACCCCCCCTGAAGCTTTCTTT	CASSLAATPPEAFF	TRBV7-9	TRBJ1-1
TGTGCCAGCAGTGACTCCAGACAAGTGAGCTCCTACAATGAGCAGTTCTTC	CASSDSRQVSSYNEQFF	TRBV6-4	TRBJ2-1
TGTGCCAGCAGTTTGTGTAGAGGGCCGGGGCCGGCTCGCTACGAGCAGTACTTC	CASSLCRGPGPARYEQYF	TRBV28	TRBJ2-7
TGTGCCAGCAGCCGGCTAGCGGGGAGCTTTACTCGAGGCAATGAGCAGTTCTTC	CASSRLAGSFTRGNEQFF	TRBV3-1	TRBJ2-1
TGCGCCAGCAGGGGGTGCAAGACTAGCGGGCAGCAGTACTTC	CASRGCKTSGQQYF	TRBV10-1	TRBJ2-7
TGTGCCTGGACGTTACCAGCGGGATTGGGCCTCAGGGAAAAACTGTTTTTT	CAWTLPAGLGLREKLFF	TRBV30	TRBJ1-4
TGCAGTGCTCGCGGGACTTACGAGCAGTACTTC	CSARGTYEQYF	TRBV20-1	TRBJ2-7
TGTGCCATTGACAGTCCCGCCCAGCATTTT	CAIDSPAQHF	TRBV13	TRBJ1-5
TGCGCCAGCAGTAAACCCAGCAGGGGGGGCACCGGGGAGCTGTTTTTT	CASSKPSRGGTGELFF	TRBV10-1	TRBJ2-2
TGTGCCAGCAGTTACTCCTGGAGTCCCCCCACAGGAGGAAATTCACCCCTCCACTTT	CASSYSWSPPTGGNSPLHF	TRBV6-8	TRBJ1-6
TGTGCCAGACCGCCCCCAGGAAAGAATTCACCCCTCCACTTT	CARPPPGKNSPLHF	TRBV5-5	TRBJ1-6
TGTGCCAGCAGTTTAAAAGGAACGGGGCTCCTAGAAGCTTTCTTT	CASSLKGTGLLEAFF	TRBV12-3	TRBJ1-1
TGTGCCAGCAGCCACAGGGGAGATACGCAGTATTTT	CASSHRGDTQYF	TRBV27	TRBJ2-3
TGTGTCGAGATTCACGGGCACCCACCAAGAACTACCAGCAATCAGCCCCAGCATTTT	CVEIHGHPPRTTSNQPQHF	TRBV3-1	TRBJ1-5
TGTGCCAGCAGTTACGGACAGGGGGGGCAGCCCCAGCATTTT	CASSYGQGGQPQHF	TRBV6-5	TRBJ1-5
TGTGCCAGAGGCGGGACTCACCTGGGAAACACCATATATTTT	CARGGTHLGNTIYF	TRBV19	TRBJ1-3
TGTGCCAGCGGACCCCAACTAGCGGGAGCTACTGGCACAGATACGCAGTATTTT	CASGPQLAGATGTDTQYF	TRBV7-3	TRBJ2-3
TGTGCCAGCAGTTTCCCGGTCTGCGGGAGGCCCGAGCAGTACTTC	CASSFPVCGRPEQYF	TRBV27	TRBJ2-7
TGTGCCAGCAGTTTAGGGAGCCCAGGGTTAACGGGGGAAAGCAATCAGCCCCAGCATTTT	CASSLGSPGLTGESNQPQHF	TRBV27	TRBJ1-5
TGCGCCAGCACTAAGGAGGTGGGGTATGGCTACACCTTC	CASTKEVGYGYTF	TRBV5-1	TRBJ1-2
TGTGCCAGTGGGACGGGAAGCTCCTACGAGCAGTACTTC	CASGTGSSYEQYF	TRBV19	TRBJ2-7
TGTTGCAAGACAACCCCGAATGAAAAACTGTTTTTT	CCKTTPNEKLFF	TRBV6-1	TRBJ1-4
TGTGCCAGCAGCCAAGAAAGGGGGGGGGGGCCTCCCGACCAAGAGACCCAGTACTTC	CASSQERGGGPPDQETQYF	TRBV14	TRBJ2-5
TGTGCCAGCAGCTTCTGCAGGGGGGAAGAAAAACTGTTTTTT	CASSFCRGEEKLFF	TRBV3-1	TRBJ1-4
TGTGCCATCAGTGTTAAAGGGTCACCCAAGAACACTGAAGCTTTCTTT	CAISVKGSPKNTEAFF	TRBV10-3	TRBJ1-1
TGCAGTGCTAGTCCCCCCCCCACAGTGTACCACACAGATACGCAGTATTTT	CSASPPPTVYHTDTQYF	TRBV20-1	TRBJ2-3
TGTGCCAGCAACAAAATCCCCGGGACAGCTTTTCTCTATGGCTACACCTTC	CASNKIPGTAFLYGYTF	TRBV2	TRBJ1-2
TGTGCCACCCGACAGAGTGAGCAGTTCTTC	CATRQSEQFF	TRBV24-1	TRBJ2-1
TGCAGTGCTACCACACCTAATGAGCAGTTCTTC	CSATTPNEQFF	TRBV20-1	TRBJ2-1
TGTGCCAGCAGTGAGGTGGAGGGAAGGTTCACCGGGGAGCTGTTTTTT	CASSEVEGRFTGELFF	TRBV6-4	TRBJ2-2
TGCAGTGCTAGCCGGGTGAAAGGTACCGACACTGAAGCTTTCTTT	CSASRVKGTDTEAFF	TRBV20-1	TRBJ1-1
TGTGCCAGCAGTCTGACAGGGGTCGCCAAGAATCAGCCCCAGCATTTT	CASSLTGVAKNQPQHF	TRBV27	TRBJ1-5
TGTGCCAGCATAAGACAGGGAACTGAAGCTTTCTTT	CASIRQGTEAFF	TRBV7-9	TRBJ1-1
TGTGCCAGAAAGTCCAGGGTCTATGGCTACACCTTC	CARKSRVYGYTF	TRBV12-3	TRBJ1-2
TGTGCCAGCAGTGATGCGGGACAGACCTCTTCAGGCAGACATAATCAGCCCCAGCATTTT	CASSDAGQTSSGRHNQPQHF	TRBV2	TRBJ1-5
