TGTGCCAGCAGCCGGACAGGGGCCTTAGAGACCCAGTACTTC	CASSRTGALETQYF	TRBV7-3	TRBJ2-5
TGTGCCACCAGTGACCACAGGGCCATCAGGGCTGAAGCTTTCTTT	CATSDHRAIRAEAFF	TRBV24-1	TRBJ1-1
TGTGCCAGCAGCGTCCGGGACAGGAATCCCTATCAGCCCCAGCATTTT	CASSVRDRNPYQPQHF	TRBV11-2	TRBJ1-5
TGCAGTGCTAGAGAGTATCGGGCCCCCAACTATGGCTACACCTTC	CSAREYRAPNYGYTF	TRBV20-1	TRBJ1-2
TGTGCCAGCCAGAAGTCTAAAGAAGAGACTAGAGGGGGAGCCCGGATGAATGAGCAGTTCTTC	CASQKSKEETRGGARMNEQFF	TRBV7-6	TRBJ2-1
TGCGCCAGCAGTGAGTCACTCGGGGGCCCGACCGGGGAGCTGTTTTTT	CASSESLGGPTGELFF	TRBV10-2	TRBJ2-2
TGTGCCTGGAGTGCCTTCGCGGTGGGACAAGTGAAAGGCTACACCTTC	CAWSAFAVGQVKGYTF	TRBV30	TRBJ1-2
TGCAGTGCTAGAGTTGGGGCAGGGGGTAATCAGCCCCAGCATTTT	CSARVGAGGNQPQHF	TRBV20-1	TRBJ1-5
TGTGCTAGTGGTTTGGTACTTGTTCAGGGGGTTTCCTATGGCTACACCTTC	CASGLVLVQGVSYGYTF	TRBV12-5	TRBJ1-2
TGTGCCAGCAGCGCTCTAGAGGGGGCCACAAAACTGTTTTTT	CASSALEGATKLFF	TRBV9	TRBJ1-4
TGTGCCAGCAGTTTATTGCATTCCTATAGGTCACCAGCAACTAATGAAAAACTGTTTTTT	CASSLLHSYRSPATNEKLFF	TRBV27	TRBJ1-4
TGTGCCAGCAGTTCGGGAGGGGCCTGTGGCTACACCTTC	CASSSGGACGYTF	TRBV12-3	TRBJ1-2
TGCAGTGCTAGAGATGGGGAAAGCCTCACCATATATTTT	CSARDGESLTIYF	TRBV20-1	TRBJ1-3
TGTGCCACCAGCAGCCGCCCTCCCGTCCCTGCGGGGCCTAACTATGGCTACACCTTC	CATSSRPPVPAGPNYGYTF	TRBV15	TRBJ1-2
TGTGCCAGTAGTGGGGGGGGACCGCAAGAGACCCAGTACTTC	CASSGGGPQETQYF	TRBV19	TRBJ2-5
TGTGCCAGCAGTGAGAAGAAGGGAAACACAGATACGCAGTATTTT	CASSEKKGNTDTQYF	TRBV6-1	TRBJ2-3
TGTGCCATCAGTGACGTTCGCCCGGCTTGGGGAGAAGCTTTCTTT	CAISDVRPAWGEAFF	TRBV10-3	TRBJ1-1
TGTGCCATCATGGTAGGGACTAACTATGGCTACACCTTC	CAIMVGTNYGYTF	TRBV10-3	TRBJ1-2
TGTGCCAGCAGTGGGGGGTCCACTAGCGGGAGGATTGAGACCCAGTACTTC	CASSGGSTSGRIETQYF	TRBV6-1	TRBJ2-5
TGTGCCAGCATCGCGAGACAGGACAGGGAGGGGGCCACCTTC	CASIARQDREGATF	TRBV6-5	TRBJ1-2
TGCGCCAGCAGTCGGGGCAATACTAGCGGGAGACCTGGAAACACCATATATTTT	CASSRGNTSGRPGNTIYF	TRBV10-1	TRBJ1-3
TGTGCCACCATTCCGCAGGGGCCGGTTCAGCCCCAGCATTTT	CATIPQGPVQPQHF	TRBV24-1	TRBJ1-5
TGTGCCAGCAGCTTCCGGGACAAGCCCCTAGAAGCTTTCTTT	CASSFRDKPLEAFF	TRBV5-5	TRBJ1-1
TGTGCCAGCAGTCGGGGACAGGGAGTAGGGAGGGGTAACGACGAGCAGTACTTC	CASSRGQGVGRGNDEQYF	TRBV27	TRBJ2-7
TGTGCCAGCAGGCCCCAGGGGGAGGATTACACTGAAGCTTTCTTT	CASRPQGEDYTEAFF	TRBV25-1	TRBJ1-1
TGTGCCAGCAGGCAGGCCCCGGGACAAAGAAATCAGCCCCAGCATTTT	CASRQAPGQRNQPQHF	TRBV6-4	TRBJ1-5
TGCAGCGGGATAGCGGGAAGTATCGACGAGCAGTACTTC	CSGIAGSIDEQYF	TRBV29-1	TRBJ2-7
TGTGCCAGCAGTTTATTTCCCTCTAATCCGGGACTAGCATACAATGAGCAGTTCTTC	CASSLFPSNPGLAYNEQFF	TRBV28	TRBJ2-1
TGTGCCAGCAGTGAAGCCAGGGTTGACTCCCGGGACGGGGAGGCAGATACGCAGTATTTT	CASSEARVDSRDGEADTQYF	TRBV6-1	TRBJ2-3
TGTGCCACCAGTGACAATCCGGACGCAGCTTTCTTT	CATSDNPDAAFF	TRBV24-1	TRBJ1-1
TGCAGTGCATCGACCGGGACAGGCCTCCATGAGCAGTTCTTC	CSASTGTGLHEQFF	TRBV20-1	TRBJ2-1
TGCAGCGCGAGGCACAGGGGGGGCTACGAGCAGTACTTC	CSARHRGGYEQYF	TRBV29-1	TRBJ2-7
TGTGCCAGCAGTGACGGGGGGGGTAATGAAAAACTGTTTTTT	CASSDGGGNEKLFF	TRBV6-4	TRBJ1-4
TGTGCCAGCAGCGTAGGGGGGGGGACCGGGAGAGATACGCAGTATTTT	CASSVGGGTGRDTQYF	TRBV9	TRBJ2-3
TGCGCCAGCAGCTTGATACGGAGGGCCAATGAGCAGTTCTTC	CASSLIRRANEQFF	TRBV5-1	TRBJ2-1
TGTGCCTCCACGGACAGGAATTCAACGAACACCGGGGAGCTGTTTTTT	CASTDRNSTNTGELFF	TRBV10-3	TRBJ2-2
TGCGCCAGCAGCATTGGGGACAGGGAGGCTAATGAAAAACTGTTTTTT	CASSIGDREANEKLFF	TRBV10-1	TRBJ1-4
TGTGCCATCAGCCGGAACTACAATGAGCAGTTCTTC	CAISRNYNEQFF	TRBV10-3	TRBJ2-1
TGCGCCAGCACCCACCCTGGGACAAGCTACGAGCAGTACTTC	CASTHPGTSYEQYF	TRBV10-1	TRBJ2-7
TGTGCCAGCAGCGAGGGGGGGTACCAAGAGACCCAGTACTTC	CASSEGGYQETQYF	TRBV7-3	TRBJ2-5
TGTGCCAGCAGCCAAGATAAGGGGGGGGCACCGTCCTACAATGAGCAGTTCTTC	CASSQDKGGAPSYNEQFF	TRBV4-2	TRBJ2-1
TGCAGTGCTGGAAGGGGTTCGGGCTCTGGAAACACCATATATTTT	CSAGRGSGSGNTIYF	TRBV20-1	TRBJ1-3
TGTGCCAGAAAAGGGCCTAACCGGGACAATGAAAAACTGTTTTTT	CARKGPNRDNEKLFF	TRBV6-5	TRBJ1-4
TGTGCCAGCAGTTACTCCCGAGGGACAGGGGGGGAGCCTAGCAATCAGCCCCAGCATTTT	CASSYSRGTGGEPSNQPQHF	TRBV6-3	TRBJ1-5
TGTGCCAGAGGGCTTAACATTCAGTACTTC	CARGLNIQYF	TRBV19	TRBJ2-4
TGTGCCAGCTCAAACTTACGGCAGTACTTC	CASSNLRQYF	TRBV18	TRBJ2-7
TGTGCCAGAGGCCCGGGACTAGCGGGCACAGATACGCAGTATTTT	CARGPGLAGTDTQYF	TRBV25-1	TRBJ2-3
TGCGCCAGCAGCTTGCCGGGACAGGGCGGCAATCAGCCCCAGCATTTT	CASSLPGQGGNQPQHF	TRBV5-1	TRBJ1-5
TGTGCCAGCAAGCCTTCAAGTAACAGGGTCGAATGGGCTGAAGCTTTCTTT	CASKPSSNRVEWAEAFF	TRBV6-4	TRBJ1-1
TGTGCCAGCCGGACACAGGTTGCAACTAATGAAAAACTGTTTTTT	CASRTQVATNEKLFF	TRBV6-5	TRBJ1-4
TGTGCCAGCAGCTTGGCAGAGAGGGGCGTGAGATGCACTGAAGCTTTCTTT	CASSLAERGVRCTEAFF	TRBV5-4	TRBJ1-1
TGTGCCAGCAGCCAAGCGCTCCATGTGGTACGTGGAGCGAACACCGGGGAGCTGTTTTTT	CASSQALHVVRGANTGELFF	TRBV4-2	TRBJ2-2
TGTGCCACCGGGGGTTCCTACGAGCAGTACTTC	CATGGSYEQYF	TRBV7-9	TRBJ2-7
TGCGCCAGCACGGCACAGGGGGGCCTAGTTGAAGCTTTCTTT	CASTAQGGLVEAFF	TRBV10-2	TRBJ1-1
TGTGCCACCACTGGCTACGCCCGGTTCAATCAGCCCCAGCATTTT	CATTGYARFNQPQHF	TRBV19	TRBJ1-5
TGTGCCAGCAGCTTAAGGGGGACGAGGCAGTACTTC	CASSLRGTRQYF	TRBV11-3	TRBJ2-7
TGTGCCAGCAGCCAAGCCACTACTAGCGGGAGGAGGGGCACTGAAGCTTTCTTT	CASSQATTSGRRGTEAFF	TRBV14	TRBJ1-1
TGTGCCAGCAGCCCCCCCCAATGTTTTTATAGGCCACACATTCAGTACTTC	CASSPPQCFYRPHIQYF	TRBV7-3	TRBJ2-4
TGCGCCAGCAGCTTGCAAGGCCAAGGGGGATGCACTGAAGCTTTCTTT	CASSLQGQGGCTEAFF	TRBV5-1	TRBJ1-1
TGTGCCAGCAGGGTAATCGCGTCCGCGGGGGCTGGGAACACTGAAGCTTTCTTT	CASRVIASAGAGNTEAFF	TRBV5-4	TRBJ1-1
TGTGCCAGCAGCCAAGATCTTAGGGGGCCGAGGGGGGCCTACGAGCAGTACTTC	CASSQDLRGPRGAYEQYF	TRBV14	TRBJ2-7
TGTGCCAGCAGTTATCCATCCTCTACTGAAGCTTTCTTT	CASSYPSSTEAFF	TRBV6-3	TRBJ1-1
TGTGCCAGCAGTTACGCCGGGACAGCCAGCAATCAGCCCCAGCATTTT	CASSYAGTASNQPQHF	TRBV6-6	TRBJ1-5
TGTGCCAGCAGCTGGGGGACAGCTGGGGAGCTGTTTTTT	CASSWGTAGELFF	TRBV13	TRBJ2-2
TGTGCCAGCAGAGGATACCAGGTGGGCACCTTC	CASRGYQVGTF	TRBV27	TRBJ1-2
TGTGCCAGCACAGGGACTAGCGGGGGGTATAATGAGCAGTTCTTC	CASTGTSGGYNEQFF	TRBV6-5	TRBJ2-1
TGTGCCTCCAGGGAGGGCCAGCCCCAGCATTTT	CASREGQPQHF	TRBV7-9	TRBJ1-5
TGTGCCAGCAGCGGGGGCCGGGTAAATTCACCCCTCCACTTT	CASSGGRVNSPLHF	TRBV7-9	TRBJ1-6
TGTGCCAGCAGTAACGGATTTGACAGGGATGTAGAGACCCAGTACTTC	CASSNGFDRDVETQYF	TRBV6-4	TRBJ2-5
TGTGCCAGCAGCGGGGCGGGAGCCTACGAGCAGTACTTC	CASSGAGAYEQYF	TRBV7-3	TRBJ2-7
TGTGCCAGCAAGGGGGGGTGGACCTACGAGCAGTACTTC	CASKGGWTYEQYF	TRBV9	TRBJ2-7
TGTGCCAGCAGCGTGCGGGAAGGGAGGCTCCCCCAGTACTTC	CASSVREGRLPQYF	TRBV9	TRBJ2-5
TGCAGTGCTACCACGAAGGAAAAACTGTTTTTT	CSATTKEKLFF	TRBV20-1	TRBJ1-4
TGTGCCATCGAAAGTGAGCAGTACTTC	CAIESEQYF	TRBV10-3	TRBJ2-7
TGCAGGTACCCAGGGTCGTTGATGAACACTGAAGCTTTCTTT	CRYPGSLMNTEAFF	TRBV20-1	TRBJ1-1
TGTGCCAGCAGCTTTATTCAGTGCTCACCCCTCCACTTT	CASSFIQCSPLHF	TRBV5-6	TRBJ1-6
TGCAGCGTCTGGGACGTGAGCCCATACTATGGCTACACCTTC	CSVWDVSPYYGYTF	TRBV29-1	TRBJ1-2
TGCGCCAGCAGCATCCGTACTCTAAGACGGAATGAGCAGTTCTTC	CASSIRTLRRNEQFF	TRBV5-1	TRBJ2-1
TGCGCCAGCAGCTTTAGGGGGTATGGCTACACCTTC	CASSFRGYGYTF	TRBV5-1	TRBJ1-2
TGTGCCTGGATCCTCTGTAGGGCCTCTGGAAACACCATATATTTT	CAWILCRASGNTIYF	TRBV30	TRBJ1-3
TGTGCCAGCAGCAGTCCGACTAGCGGGCCGAAATACGAGCAGTACTTC	CASSSPTSGPKYEQYF	TRBV13	TRBJ2-7
TGTGCCCGGCACGAGCAGTACTTC	CARHEQYF	TRBV6-2	TRBJ2-7
TGCGCCAGCAGCTTCCGGGGTCATCAGCCCCAGCATTTT	CASSFRGHQPQHF	TRBV5-1	TRBJ1-5
TGTGCCAGCAGCTGCGTCTACTATGGCTACACCTTC	CASSCVYYGYTF	TRBV13	TRBJ1-2
TGTGCCAGCAGTTTATTTCCTACGAGGAGGAACACTGAAGCTTTCTTT	CASSLFPTRRNTEAFF	TRBV12-4	TRBJ1-1
TGTGCCAGCAGGGTTTCGGGGCTAGCCAATGAGCAGTTCTTC	CASRVSGLANEQFF	TRBV6-5	TRBJ2-1
TGCAGTGCTAGGGGGCCGGGGAACTACGAGCAGTACTTC	CSARGPGNYEQYF	TRBV20-1	TRBJ2-7
TGTGCCAGCAGCTTAGGGGTCCTCTACAATGAGCAGTTCTTC	CASSLGVLYNEQFF	TRBV7-4	TRBJ2-1
TGCGCCAGCAGCGGTACCGCGGGACTAGGTCAAGAGACCCAGTACTTC	CASSGTAGLGQETQYF	TRBV5-1	TRBJ2-5
TGTGCCAGCAGCTTATGGTACCTGGAACTTACTGTGACAGATACGCAGTATTTT	CASSLWYLELTVTDTQYF	TRBV11-3	TRBJ2-3
TGTGCCAGCAGCTTACCGGGACAGGGGGTCTCCTATAATTCACCCCTCCACTTT	CASSLPGQGVSYNSPLHF	TRBV7-3	TRBJ1-6
TGTGCCAGCAGCCCCCGAGGTTACAATGAGCAGTTCTTC	CASSPRGYNEQFF	TRBV7-4	TRBJ2-1
TGTGCCAGCAGCAGCGGGGTTTTACCGGGACGCAAAGACTCCTATAATTCACCCCTCCACTTT	CASSSGVLPGRKDSYNSPLHF	TRBV13	TRBJ1-6
TGTGCCAGCAGCTTGAAGGGGGGGCCACACTTC	CASSLKGGPHF	TRBV5-6	TRBJ2-7
TGTGCCAGCAGTTTCCCGTGGGTAGTAGAGGGGAAAATTCCGACCTATAATTCACCCCTCCACTTT	CASSFPWVVEGKIPTYNSPLHF	TRBV27	TRBJ1-6
TGTGCCAGCAGCAGTCCCCCGCTGTGGCAACCATGCCCTTACACCATATATTTT	CASSSPPLWQPCPYTIYF	TRBV28	TRBJ1-3
TGTGCCAGCAGCTCAGACAATGAGCAGTTCTTC	CASSSDNEQFF	TRBV11-3	TRBJ2-1
TGCGCCAGCAAGACTTCGGCCTACGAGCAGTACTTC	CASKTSAYEQYF	TRBV5-1	TRBJ2-7
TGTGCCAGCAGGGGGGTCACCTTC	CASRGVTF	TRBV27	TRBJ1-2
TGCAGCGTTGAATTCCAGGGGGCCGACTATGGCTACACCTTC	CSVEFQGADYGYTF	TRBV29-1	TRBJ1-2
