TGTGCCAGCTCACCCCCCCGACAGACTGGGATGACTGAAGCTTTCTTT	CASSPPRQTGMTEAFF	TRBV18	TRBJ1-1
TGTGCCAGTAGTCATGGGGATCCTTTTCGGGACCCCCTGGGGGGCAATCAGCCCCAGCATTTT	CASSHGDPFRDPLGGNQPQHF	TRBV19	TRBJ1-5
TGTGCCAGCTCACCGGGGGATGTCCTGAACACTGAAGCTTTCTTT	CASSPGDVLNTEAFF	TRBV18	TRBJ1-1
TGTGCCAGTAGGCGCGGGGAGAGTGAGACCCAGTACTTC	CASRRGESETQYF	TRBV27	TRBJ2-5
TGTGCCAGAACCCGGTCAGTTTACGGTTCTAAAAACATTCAGTACTTC	CARTRSVYGSKNIQYF	TRBV6-5	TRBJ2-4
TGTGCCACCCGTCTCCCCCCGGACAATGAGCAGTTCTTC	CATRLPPDNEQFF	TRBV24-1	TRBJ2-1
TGTGCCAGGGGAACTCTCTGCCTGGGGCGAGGCACAGATACGCAGTATTTT	CARGTLCLGRGTDTQYF	TRBV7-3	TRBJ2-3
TGTGCCAGCAGTTACTCGAACCCAGGACAGGCCCTCGGGGCCAACGTCCTGACTTTC	CASSYSNPGQALGANVLTF	TRBV6-2	TRBJ2-6
TGTGCCAGCAGAACTAGGATCGAGCAGTTCTTC	CASRTRIEQFF	TRBV2	TRBJ2-1
TGCAGTGCTAGAGTGACTAGCGGGACTAAGACCCAGTACTTC	CSARVTSGTKTQYF	TRBV20-1	TRBJ2-5
TGTGCCAGCATAAACCTGGAACTGGGAGGGGCCGGAAAACGAGAGACCCAGTACTTC	CASINLELGGAGKRETQYF	TRBV5-4	TRBJ2-5
TGTGCCAGCAGGGTGAGAGGACAGGGCACGGGAGGGGTTGAGACCCAGTACTTC	CASRVRGQGTGGVETQYF	TRBV6-6	TRBJ2-5
TGCAGTGCCAGGGGGCATGGCAATGAAAAACTGTTTTTT	CSARGHGNEKLFF	TRBV20-1	TRBJ1-4
TGTGCTAGTGGTAAGGGACCGACTGAAGCTTTCTTT	CASGKGPTEAFF	TRBV12-5	TRBJ1-1
TGCGCCAGCAGCGGGGTGGGGGCTGTTGAAAAACTGTTTTTT	CASSGVGAVEKLFF	TRBV5-1	TRBJ1-4
TGTGCCAGCAGTTACTCGAATCTTAGGGGGCCTGAAGGCCGTTGGAATCAGCCCCAGCATTTT	CASSYSNLRGPEGRWNQPQHF	TRBV6-5	TRBJ1-5
TGTGCCATCCATCTCTACGAGCAGTACTTC	CAIHLYEQYF	TRBV10-3	TRBJ2-7
TGTGCCAGCAGCCAAGCGACGGGGACGTCCCAAGGTTTCCAAGAGACCCAGTACTTC	CASSQATGTSQGFQETQYF	TRBV14	TRBJ2-5
TGTGCCAGCTCACCAGACCAGGGGGCGCTTAAGTCCTACGAGCAGTACTTC	CASSPDQGALKSYEQYF	TRBV18	TRBJ2-7
TGTGCCAGCACCGCAGGATCGCCCCAGCATTTT	CASTAGSPQHF	TRBV6-1	TRBJ1-5
TGTGCCAGCAAACGGTCCCGACAGGGGTTTCCCTCCTACGAGCAGTACTTC	CASKRSRQGFPSYEQYF	TRBV6-4	TRBJ2-7
TGTGCCAGCAGCCAAGACTGGCGGGGACTAGCGGGATCAGATACGCAGTATTTT	CASSQDWRGLAGSDTQYF	TRBV3-1	TRBJ2-3
TGCAGTGCTAACCCCCCAAGACAGGGTTATTTCTACAATGAGCAGTTCTTC	CSANPPRQGYFYNEQFF	TRBV20-1	TRBJ2-1
TGTGCCAGCAGCCAAGATACAAGTGAGTTCGACAGAAATGCTGGGGCCAACGTCCTGACTTTC	CASSQDTSEFDRNAGANVLTF	TRBV4-2	TRBJ2-6
TGTGCCAGCTCACCTTTTCAGGGAGGTGATGAGCAGTTCTTC	CASSPFQGGDEQFF	TRBV18	TRBJ2-1
TGTGCCAGCAGCTTAGTAGTCGCCGAAACTAGGGTCCGTGAGCAGTTCTTC	CASSLVVAETRVREQFF	TRBV7-6	TRBJ2-1
TGTGCCAGCAGCTCCATTGACCCGGGACAGGCCGGCAAAAACATTCAGTACTTC	CASSSIDPGQAGKNIQYF	TRBV11-3	TRBJ2-4
TGTGCCAGCAGCAAGAAAGGGGGAAGTCCCCCCTACAATGAGCAGTTCTTC	CASSKKGGSPPYNEQFF	TRBV9	TRBJ2-1
TGCAGCGTTGCCGACAGGGGGGTCCTCAACAATGAGCAGTTCTTC	CSVADRGVLNNEQFF	TRBV29-1	TRBJ2-1
TGTGCCACCAGTGACAATTGCCACCCTACTCACTATGGCTACACCTTC	CATSDNCHPTHYGYTF	TRBV24-1	TRBJ1-2
TGTGCCAGCAGCGGTGTTTTAGGGGGAGCAAAACTGTTTTTT	CASSGVLGGAKLFF	TRBV7-9	TRBJ1-4
TGCGCCAGCAGCCAAGAAACTTGGGGCGGTTGGCTAGCCAAAAACATTCAGTACTTC	CASSQETWGGWLAKNIQYF	TRBV4-1	TRBJ2-4
TGCAGTGCTAGAATGTATTCCCGGCCGGGACTAGCAAGCTCCTACAATGAGCAGTTCTTC	CSARMYSRPGLASSYNEQFF	TRBV20-1	TRBJ2-1
TGTGCCAGCAGCCGGGAAAACACCATATATTTT	CASSRENTIYF	TRBV7-4	TRBJ1-3
TGCAGTGCTAACCCCGGGACAGGGGCGTTCAAATTCGGCACTGAAGCTTTCTTT	CSANPGTGAFKFGTEAFF	TRBV20-1	TRBJ1-1
TGTGCCACCAGTGACTCTAAGTGCACAGATACGCAGTATTTT	CATSDSKCTDTQYF	TRBV24-1	TRBJ2-3
TGTGCCAGCAGCTTAGGTCCACACCCCCCCTACGAGCAGTACTTC	CASSLGPHPPYEQYF	TRBV13	TRBJ2-7
TGTGCCAGGTCGACAGGCTGGGATTTCAATGAGCAGTTCTTC	CARSTGWDFNEQFF	TRBV19	TRBJ2-1
TGTGCCAGCAGTCCTTCGGAGGGAGAGCAGTACTTC	CASSPSEGEQYF	TRBV6-4	TRBJ2-7
TGCGCCAGCAGCTTCCCGGATCAGTCCATAGTAGAGTTAGCCAAAAACATTCAGTACTTC	CASSFPDQSIVELAKNIQYF	TRBV5-1	TRBJ2-4
TGCAGTGCTAGAAGTGGGCAGCCCCAGCATTTT	CSARSGQPQHF	TRBV20-1	TRBJ1-5
TGTGCCAGCAGGGAGAGGGAGGTTTCCTACAATGAGCAGTTCTTC	CASREREVSYNEQFF	TRBV13	TRBJ2-1
TGCAGTGCTAGCGCCCAGGGAGGGAAGGATGAGCAGTTCTTC	CSASAQGGKDEQFF	TRBV20-1	TRBJ2-1
TGTGCCAGCAGTACCCACAGCCTAAGGGATGAAAAACTGTTTTTT	CASSTHSLRDEKLFF	TRBV28	TRBJ1-4
TGTGCCAGCAGCGCCAGGGGGAATCCCGGGGAGCTGTTTTTT	CASSARGNPGELFF	TRBV11-3	TRBJ2-2
TGTGCCAGCTCCAATCACAAGAGAGCAGAGAATGAGCAGTTCTTC	CASSNHKRAENEQFF	TRBV18	TRBJ2-1
TGTGCCAGCACAGGGCGGCACATTCAGTACTTC	CASTGRHIQYF	TRBV5-6	TRBJ2-4
TGCGCCAGCAGCGAAAGGTTCCGAACAGGGCTTGAAGAGCCCCAGCATTTT	CASSERFRTGLEEPQHF	TRBV4-3	TRBJ1-5
TGCAGTGCTAGGCTAGGCTATGGCTACACCTTC	CSARLGYGYTF	TRBV20-1	TRBJ1-2
TGTGCCATCAGTGAGGACCCTCGACAGGTCTCCGGGGAGCTGTTTTTT	CAISEDPRQVSGELFF	TRBV10-3	TRBJ2-2
TGTGCCAGCAGCAAAGGTGACCCGACACGTTCGCACAGACAGCCCGGGGCTTTCTTT	CASSKGDPTRSHRQPGAFF	TRBV7-4	TRBJ1-1
TGTGCCAGCACCGACAGGGCCGCAGCCAAAAACATTCAGTACTTC	CASTDRAAAKNIQYF	TRBV2	TRBJ2-4
TGTGCCAGCTATGGACTAGCGGGAGAATACCACCACAATGAGCAGTTCTTC	CASYGLAGEYHHNEQFF	TRBV9	TRBJ2-1
TGTGCCAGCAGCTTATCCGTTATGGTCGGAAGCTACGAGCAGTACTTC	CASSLSVMVGSYEQYF	TRBV11-3	TRBJ2-7
TGTGCCAACGGGGGAGCCTACGAGCAGTACTTC	CANGGAYEQYF	TRBV28	TRBJ2-7
TGTGCCAGCAGCTCTCTGGGGGGGGCCCCCACACTGCAAGAGACCCAGTACTTC	CASSSLGGAPTLQETQYF	TRBV7-9	TRBJ2-5
TGTGCCAGCAGCTTAGATAGGGACAGCCGGCTCCTGAACACTGAAGCTTTCTTT	CASSLDRDSRLLNTEAFF	TRBV7-7	TRBJ1-1
TGTGCCAGCGTCCCAGGGAGTACGGGCTACACCTTC	CASVPGSTGYTF	TRBV6-4	TRBJ1-2
TGTGCCAGCATCCTTGCGCCAGACACCGGGGAGCTGTTTTTT	CASILAPDTGELFF	TRBV6-5	TRBJ2-2
TGTGCCAGCAGCTTGGGAACAGGTACAGGGTTTGGCTACACCTTC	CASSLGTGTGFGYTF	TRBV5-6	TRBJ1-2
TGCAGTGCTGGCTTTACGGGGACATACGAGCAGTACTTC	CSAGFTGTYEQYF	TRBV20-1	TRBJ2-7
TGTGCCAGCAGTTTACTATTGTGCGGGGATCATGAGCAGTTCTTC	CASSLLLCGDHEQFF	TRBV27	TRBJ2-1
TGCGCCAGCTATCCCCAGAGATACGAGCAGTACTTC	CASYPQRYEQYF	TRBV5-1	TRBJ2-7
TGTGCCACCAGTGATTCCGAGGGAGGATCTAGCTACGAGCAGTACTTC	CATSDSEGGSSYEQYF	TRBV24-1	TRBJ2-7
TGTGCCACCCTCCGTAGTGGACAGTGGTACGAGCAGTACTTC	CATLRSGQWYEQYF	TRBV6-1	TRBJ2-7
TGTGCCAGCAGTGAAAGGATGAGGAGGGTTAAGGTGACCGGGGAGCTGTTTTTT	CASSERMRRVKVTGELFF	TRBV2	TRBJ2-2
TGTGCCAGCAGCGTAGCCTCTCAGACAGTTCTTCAGTACTTC	CASSVASQTVLQYF	TRBV9	TRBJ2-5
TGTGCCAGCTGGACAGGGATTCAGCCCCAGCATTTT	CASWTGIQPQHF	TRBV5-8	TRBJ1-5
TGTGCCAGCAGCTGCCCCCCCGGGACTAGCGGGGCCTACAATGAGCAGTTCTTC	CASSCPPGTSGAYNEQFF	TRBV9	TRBJ2-1
TGTGCCAGCTCTTCGGGTAGGGAGGGAGAGGAGGGCGAGCAGTACTTC	CASSSGREGEEGEQYF	TRBV18	TRBJ2-7
TGTGCCAGCTCATCCGTAGCGGGAGGAGGCGGGGAGACCCAGTACTTC	CASSSVAGGGGETQYF	TRBV18	TRBJ2-5
TGTGCCAGCAGTTTATTACGGGGGAAGGCAATCAATCAGCCCCAGCATTTT	CASSLLRGKAINQPQHF	TRBV27	TRBJ1-5
TGTGCCAGCAGCTTAGGACTTCCACTGTCTCGACTAGCAAATGAGCAGTTCTTC	CASSLGLPLSRLANEQFF	TRBV7-6	TRBJ2-1
TGTGCTAGTGGTTTCCAGGGGGGTTCAGCCCTAACTGAAGCTTTCTTT	CASGFQGGSALTEAFF	TRBV12-5	TRBJ1-1
TGTGCCAGCAGCCCCGGCACGGGCCCGCAGTACAATGAGCAGTTCTTC	CASSPGTGPQYNEQFF	TRBV13	TRBJ2-1
TGTGCCAGCAGTTATGCAGGGACTAATGAAAAACTGTTTTTT	CASSYAGTNEKLFF	TRBV6-5	TRBJ1-4
TGCGCCAGGGGGGGGCCATACACCGGGGAGCTGTTTTTT	CARGGPYTGELFF	TRBV5-1	TRBJ2-2
TGTGCCAGCAGTTCCGAAAGGGCCTACGAGCAGTACTTC	CASSSERAYEQYF	TRBV27	TRBJ2-7
TGTGCCAACAGGCAGTGTGTCGGGAGGACCAAAAACATTCAGTACTTC	CANRQCVGRTKNIQYF	TRBV24-1	TRBJ2-4
TGTGCCAGCAGTCGCCAATCAGGGTTGCAGTTCTTC	CASSRQSGLQFF	TRBV6-1	TRBJ2-1
TGTGCCAGCATTAGGGGGCCAAGGGCCAATCAGCCCCAGCATTTT	CASIRGPRANQPQHF	TRBV6-4	TRBJ1-5
TGTGCCAGCAGCCAATCCAGGGTGTCTCCCAGGTGTCAGCCCCAGCATTTT	CASSQSRVSPRCQPQHF	TRBV4-2	TRBJ1-5
TGTGCCAGCAGTCCCGGATTGAGAGACACTGAAGCTTTCTTT	CASSPGLRDTEAFF	TRBV7-6	TRBJ1-1
TGTTGGGGGGGGGCGAAATATCAGCCCCAGCATTTT	CWGGAKYQPQHF	TRBV19	TRBJ1-5
TGTGCCAGCAGCCAGAACGACCGGGACAGGGACGAGCAGTACTTC	CASSQNDRDRDEQYF	TRBV3-1	TRBJ2-7
TGTGCCAGCAGCAATGAGCGGGAGAGGAACACCGGGGAGCTGTTTTTT	CASSNERERNTGELFF	TRBV7-3	TRBJ2-2
TGCGCCAGCAGCAACCCTAATCAGGGGATACTCTCCTACGAGCAGTACTTC	CASSNPNQGILSYEQYF	TRBV5-1	TRBJ2-7
TGTGCCAGCAGCGTTGCAGGGACTAGCTTACGCTCTGGGGCCAACGTCCTGACTTTC	CASSVAGTSLRSGANVLTF	TRBV6-5	TRBJ2-6
TGTGCCAGTAGGGGGCAGGGGACAGGGTTCCCCTATGGCTACACCTTC	CASRGQGTGFPYGYTF	TRBV19	TRBJ1-2
TGTGTAGCCCTCTCACCCCTCCACTTT	CVALSPLHF	TRBV5-6	TRBJ1-6
TGTGCCAGCAGTCGTTGGACAGGCGACAGCAATCAGCCCCAGCATTTT	CASSRWTGDSNQPQHF	TRBV2	TRBJ1-5
TGTGCATACCCACAGGGGCCCTCCTACAATGAGCAGTTCTTC	CAYPQGPSYNEQFF	TRBV2	TRBJ2-1
TGCAGTGCTGCACCACTAGCGGGACCAGATACGCAGTATTTT	CSAAPLAGPDTQYF	TRBV20-1	TRBJ2-3
TGTGCCAGCAGCTCGAATGATCAGACGGAGCATGGCTACACCTTC	CASSSNDQTEHGYTF	TRBV7-2	TRBJ1-2
TGTGCCAGCAGCCAAGCCCAATGGGGACAGGGCGAGACCCAGTACTTC	CASSQAQWGQGETQYF	TRBV14	TRBJ2-5
TGTGCCAGCAGCGTAGCTAAGGGGGTCGATACGCAGTATTTT	CASSVAKGVDTQYF	TRBV9	TRBJ2-3
TGTGCCAGCAGGGCAGGGATACCAGACTTAGTCTCCTACGAGCAGTACTTC	CASRAGIPDLVSYEQYF	TRBV7-9	TRBJ2-7
TGTGCCAGCGGTAGGGGGGGACAGGGCATACCGAACACTGAAGCTTTCTTT	CASGRGGQGIPNTEAFF	TRBV12-3	TRBJ1-1
TGTGCCAGCAGCTTACATCCCGATCAACAGGACTACGAGCAGTACTTC	CASSLHPDQQDYEQYF	TRBV7-9	TRBJ2-7
TGTGCCAGCAGGACAGTTCGACTAGGGGTGGGGGGCACAGATACGCAGTATTTT	CASRTVRLGVGGTDTQYF	TRBV6-4	TRBJ2-3
