TGCGCCAGCAGCTTGGTAGGCTTTCAGGGCGCTAACTATGGCTACACCTTC	CASSLVGFQGANYGYTF	TRBV5-1	TRBJ1-2
TGTGCCAGCAGCTTAGGGGGGACAGGGGAAAGGCCCTATGGCTACACCTTC	CASSLGGTGERPYGYTF	TRBV11-2	TRBJ1-2
TGTGAGGGACTAGCGGGGAACAAAAACATTCAGTACTTC	CEGLAGNKNIQYF	TRBV11-3	TRBJ2-4
TGTGCCAGCAGCGATACACTACTCTCTGGGGCCAACGTCCTGACTTTC	CASSDTLLSGANVLTF	TRBV11-2	TRBJ2-6
TGTGCCATCGTATCGGGCGAGACCGGGGAGCTGTTTTTT	CAIVSGETGELFF	TRBV10-3	TRBJ2-2
TGCGCCAGCAGCGTGGGGGGGTTGGCAGAGACCCAGTACTTC	CASSVGGLAETQYF	TRBV5-1	TRBJ2-5
TGTGCCAGCAGCCGAAACGTAGGACACCATACCCACGAGCAGTACTTC	CASSRNVGHHTHEQYF	TRBV13	TRBJ2-7
TGTGCCACGCTTCTTGACAGGCTTTACACTGAAGCTTTCTTT	CATLLDRLYTEAFF	TRBV6-4	TRBJ1-1
TGTGCCAGCTCACCAACGGGGACTAGCGGGGCGTCGGAGCAGTTCTTC	CASSPTGTSGASEQFF	TRBV18	TRBJ2-1
TGCGCCAGCAGCCAAGATCGGCTAGGGACAGCAGAAGAGACCCAGTACTTC	CASSQDRLGTAEETQYF	TRBV4-1	TRBJ2-5
TGTGCCAGCATTCGGGGTGCGAACACCGGGGAGCTGTTTTTT	CASIRGANTGELFF	TRBV7-3	TRBJ2-2
TGTGCCACCAGCAGGAGAAAGCGGACAGGGGGTTACACTGAAGCTTTCTTT	CATSRRKRTGGYTEAFF	TRBV15	TRBJ1-1
TGTGCCAGTAAAATTAGGACAGGGTGGGATGGCTACACCTTC	CASKIRTGWDGYTF	TRBV19	TRBJ1-2
TGTGCCAGCACCCCGAACCCAGTCAGCTCCTACGAGCAGTACTTC	CASTPNPVSSYEQYF	TRBV7-2	TRBJ2-7
TGCAGTGCTAGAGACAGAGGTCTGGATCAGCCCCAGCATTTT	CSARDRGLDQPQHF	TRBV20-1	TRBJ1-5
TGTGCTAGTGGTTTGTTAGGGGAGTGGAACACTGAAGCTTTCTTT	CASGLLGEWNTEAFF	TRBV12-5	TRBJ1-1
TGTGCCAGCAGCTGGGGGGACAGCCTTAGGTATAGCAATCAGCCCCAGCATTTT	CASSWGDSLRYSNQPQHF	TRBV5-6	TRBJ1-5
TGTGCGACCCGGGTAAGCTCCTACGAGCAGTACTTC	CATRVSSYEQYF	TRBV7-3	TRBJ2-7
TGTGCCAGCAGCAAGCTACGGGAGGGTTGGGGAAACATTCAGTACTTC	CASSKLREGWGNIQYF	TRBV13	TRBJ2-4
TGCAGTGCTAGATTTGCCCGGGACGGAAGACGAACGAACACTGAAGCTTTCTTT	CSARFARDGRRTNTEAFF	TRBV20-1	TRBJ1-1
TGCACGGACACCCGAGTTAGACCTGCCAAAAACATTCAGTACTTC	CTDTRVRPAKNIQYF	TRBV20-1	TRBJ2-4
TGTGCCAGCTTGGACAAGGGAGCTTTCTTT	CASLDKGAFF	TRBV6-4	TRBJ1-1
TGTGCCAGCAGCCCCGGTTGGAGAGGGTCTCCCTACAATGAGCAGTTCTTC	CASSPGWRGSPYNEQFF	TRBV14	TRBJ2-1
TGTGCCACCAGTGATCCTCGCCGACCCCCTGAGACCCAGTACTTC	CATSDPRRPPETQYF	TRBV24-1	TRBJ2-5
TGCAGTGCGTTGGGGGGGGAAAAACTGTTTTTT	CSALGGEKLFF	TRBV20-1	TRBJ1-4
TGTGCCTGGTCACATCGGGACATCATGAACACTGAAGCTTTCTTT	CAWSHRDIMNTEAFF	TRBV30	TRBJ1-1
TGTGCCAGCAGTTACTCGAAGGGCAGACGCTCAAATCGCTCCTATAATTCACCCCTCCACTTT	CASSYSKGRRSNRSYNSPLHF	TRBV6-5	TRBJ1-6
TGCATCGGGACACCCGTAAAACCCTCCGACGAGCAGTACTTC	CIGTPVKPSDEQYF	TRBV20-1	TRBJ2-7
TGTGCCTGGAGTGTACCCCTGGGACAGGGGTACGAGCAGTACTTC	CAWSVPLGQGYEQYF	TRBV30	TRBJ2-7
TGTGCCAGCAGCAGGGGGACACCTCCCAAAAACATTCAGTACTTC	CASSRGTPPKNIQYF	TRBV5-4	TRBJ2-4
TGTGCCAGCAGCATCCGGACAATCAAACGTAACTATGGCTACACCTTC	CASSIRTIKRNYGYTF	TRBV14	TRBJ1-2
TGTGCCAGCAAACGACGGGGCTACACCTTC	CASKRRGYTF	TRBV9	TRBJ1-2
TGCGCCAGCAGCAGACAACGGGGGAATGAAAAACTGTTTTTT	CASSRQRGNEKLFF	TRBV5-1	TRBJ1-4
TGTGCCAGCGCCATTTCCTCCACAGGGGGTCCGGGCTCCTACAATGAGCAGTTCTTC	CASAISSTGGPGSYNEQFF	TRBV6-8	TRBJ2-1
TGTGCCAGCAGCTTACGGGACTGGAGTAGCACAGATACGCAGTATTTT	CASSLRDWSSTDTQYF	TRBV11-1	TRBJ2-3
TGTGCCAGCAGCCCCAGGGACAGGGCGGACTCCTACAATGAGCAGTTCTTC	CASSPRDRADSYNEQFF	TRBV13	TRBJ2-1
TGTGCCAGTAGTATACGAGAGGGGAACACTGAAGCTTTCTTT	CASSIREGNTEAFF	TRBV19	TRBJ1-1
TGCAGTCCACTAGCGGCTACCACAGATACGCAGTATTTT	CSPLAATTDTQYF	TRBV20-1	TRBJ2-3
TGTGCTAGCAGCCAGGGGGGGAACACTGAAGCTTTCTTT	CASSQGGNTEAFF	TRBV7-7	TRBJ1-1
TGCGCCAGCATAGTAGGACGTCTCTGCGAGCAGTACTTC	CASIVGRLCEQYF	TRBV10-2	TRBJ2-7
TGCAGTGCTAGTCTGGACAGGGGTAGCTCTGGAAACACCATATATTTT	CSASLDRGSSGNTIYF	TRBV20-1	TRBJ1-3
TGTGCCAGCAGTTTCTACGGCTCCTACGAGCAGTACTTC	CASSFYGSYEQYF	TRBV12-4	TRBJ2-7
TGTGCCATCACGAGCGGGAAGAACAATGAGCAGTTCTTC	CAITSGKNNEQFF	TRBV10-3	TRBJ2-1
TGTGCCAGCCATTCGACCCGACAGGGCGAAGAGACCCAGTACTTC	CASHSTRQGEETQYF	TRBV7-9	TRBJ2-5
TGCGCCAGCAGCCGACGCGGGAGATTGGGCTACACCTTC	CASSRRGRLGYTF	TRBV5-1	TRBJ1-2
TGTGCCAGCAGGGACAGGTTGGGTAGTACCGGGGAGCTGTTTTTT	CASRDRLGSTGELFF	TRBV14	TRBJ2-2
TGTGGAAGGGGGGAGCGGGAGACCCAGTACTTC	CGRGERETQYF	TRBV2	TRBJ2-5
TGTGCCAGCAGCTGTCTCAGGGGGGTACTGTTTTTT	CASSCLRGVLFF	TRBV7-4	TRBJ1-4
TGCAGTGCTAGCTGCGGGGACAGCTCCTACAATGAGCAGTTCTTC	CSASCGDSSYNEQFF	TRBV20-1	TRBJ2-1
TGTGCCAGCAGCGTCCCCCAACAGGGGAGAAACACCTTC	CASSVPQQGRNTF	TRBV9	TRBJ1-2
TGTGCCAGCTCACCAACATCAGGCCGGACTCGGTCGAATTCACCCCTCCACTTT	CASSPTSGRTRSNSPLHF	TRBV18	TRBJ1-6
TGTGCCAGCTCGTCCCCCGGAGGGCATGAAAAACTGTTTTTT	CASSSPGGHEKLFF	TRBV18	TRBJ1-4
TGTGCCAGCAGCTTAGGACCGGTGGAGACCCAGTACTTC	CASSLGPVETQYF	TRBV7-2	TRBJ2-5
TGTGCCAGCAGCGGACGCACCGGGGACGAGCAGTACTTC	CASSGRTGDEQYF	TRBV7-3	TRBJ2-7
TGTGCCAGCAGTCGCCCCGCAGTGTCGGGTTCCTACGAGCAGTACTTC	CASSRPAVSGSYEQYF	TRBV11-3	TRBJ2-7
TGTGCCAGCAGTTCCCCTAGAGTCCGGGGGCCCCAGCATTTT	CASSSPRVRGPQHF	TRBV12-3	TRBJ1-5
TGTGCCAGCTTAACGCAGGGTTGCACTGAAGCTTTCTTT	CASLTQGCTEAFF	TRBV18	TRBJ1-1
TGCAGTGCTAGAGAAGGGAGTCGGTCGGCTGGGAACACCGGGGAGCTGTTTTTT	CSAREGSRSAGNTGELFF	TRBV20-1	TRBJ2-2
TGTGCCAGCAGCCGACAGGGGGGCTACGAGCAGTACTTC	CASSRQGGYEQYF	TRBV7-9	TRBJ2-7
TGTGCCAGCAGCCAGTATAGGGGGCGAAGGAGCTACGAGCAGTACTTC	CASSQYRGRRSYEQYF	TRBV3-1	TRBJ2-7
TGTGCCAGCTTCCTCCTGGTTAACCCGCGCGGGAGTCGTTGGTCCTACAATGAGCAGTTCTTC	CASFLLVNPRGSRWSYNEQFF	TRBV27	TRBJ2-1
TGTGCCAGCAGTTACCCTGGGCGGGACAGCTCCTACAATGAGCAGTTCTTC	CASSYPGRDSSYNEQFF	TRBV28	TRBJ2-1
TGTGCCAGCAGCGCGGGGGACGGGTACTACAATGAGCAGTTCTTC	CASSAGDGYYNEQFF	TRBV9	TRBJ2-1
TGTGCCAGCAGCTCGGTTGGGGCCTATGGGGACGGTCAGCCCCAGCATTTT	CASSSVGAYGDGQPQHF	TRBV6-1	TRBJ1-5
TGTGCCAGCAGCTTACGACGGGCTATATATGGCTACACCTTC	CASSLRRAIYGYTF	TRBV7-9	TRBJ1-2
TGTGCCAGCAGCCCGGGAGCCGGGACACCAAAGTTAATGAACACTGAAGCTTTCTTT	CASSPGAGTPKLMNTEAFF	TRBV27	TRBJ1-1
TGCATGAGAGGGACCGGGGAGCTGTTTTTT	CMRGTGELFF	TRBV20-1	TRBJ2-2
TGTGCTAGTGGTTTGACCCGCTCGGACCACCGCACAGATACGCAGTATTTT	CASGLTRSDHRTDTQYF	TRBV12-5	TRBJ2-3
TGTGCTAGCCGGGACAGGGGCTCAGATTGCTACACCTTC	CASRDRGSDCYTF	TRBV12-5	TRBJ1-2
TGTGCCAGCAGCTTAGCGATGCGGGGCTACGCGGACATTGACACTGAAGCTTTCTTT	CASSLAMRGYADIDTEAFF	TRBV7-4	TRBJ1-1
TGCGCCAGCAGCTGCCGCCTCTCGCTGCGGAGCTATGGCTACACCTTC	CASSCRLSLRSYGYTF	TRBV5-1	TRBJ1-2
TGTGCCAGCAGCCGGAGGGGAAGGTATGAGTACTTC	CASSRRGRYEYF	TRBV7-7	TRBJ2-7
TGTGCCAGCAGCCCGCTGAGCGGGACCTTCGGTCATTACAATGAGCAGTTCTTC	CASSPLSGTFGHYNEQFF	TRBV7-3	TRBJ2-1
TGTGCCAGCCGGGGGGGCCTTGAGCAGTACTTC	CASRGGLEQYF	TRBV28	TRBJ2-7
TGTGCCAGCAGTGACTCGAGCCCAGCGGAGGATCCCTACGAGCAGTACTTC	CASSDSSPAEDPYEQYF	TRBV6-4	TRBJ2-7
TGCGCCAGCAGCAGTCTCGGACACCTCAATCAGCCCCAGCATTTT	CASSSLGHLNQPQHF	TRBV5-1	TRBJ1-5
TGTGCCAGCAGCTTAGTATTGGGTAGGGGCTACACCTTC	CASSLVLGRGYTF	TRBV7-2	TRBJ1-2
TGTGCCAGCAGCCGAACGGGGGGCTACGACGAGCAGTACTTC	CASSRTGGYDEQYF	TRBV9	TRBJ2-7
TGTGCCAGCTCCTCTGGACTAGCGGGCGCGGACACCGGGGAGCTGTTTTTT	CASSSGLAGADTGELFF	TRBV18	TRBJ2-2
TGCAGCGTTGTCTTCGAGGAGCTGATCAGGGGCTCCTACGAGCAGTACTTC	CSVVFEELIRGSYEQYF	TRBV29-1	TRBJ2-7
TGTGCCCTCTATGGCTACACCTTC	CALYGYTF	TRBV19	TRBJ1-2
TGTGCCAGCAGCTTAGTGCGGGAGCAGTACTTC	CASSLVREQYF	TRBV11-2	TRBJ2-7
TGTGCCGAAAGGCGGAACAATGAGCAGTTCTTC	CAERRNNEQFF	TRBV24-1	TRBJ2-1
TGTGCCAGCAGTTTTCTGTACTTGGAAAAACTGTTTTTT	CASSFLYLEKLFF	TRBV27	TRBJ1-4
TGTGCCAGCTGGACGGTCACAGGCCGTAATTCACCCCTCCACTTT	CASWTVTGRNSPLHF	TRBV25-1	TRBJ1-6
TGTGCCAGCAGCTCGACAGGGGGCGGCCCCTCGAACACTGAAGCTTTCTTT	CASSSTGGGPSNTEAFF	TRBV5-8	TRBJ1-1
TGCAGCGTTGGTACCGGGGGGCACTGGCCTGCAACTAATGAAAAACTGTTTTTT	CSVGTGGHWPATNEKLFF	TRBV29-1	TRBJ1-4
TGTGCCAGTAGTCGACCCGGGATGGATAATGAAAAACTGTTTTTT	CASSRPGMDNEKLFF	TRBV19	TRBJ1-4
TGCAGTGCTGAAAGCATCTACGAGCAGTACTTC	CSAESIYEQYF	TRBV20-1	TRBJ2-7
TGTGCCAGCAGCCAGGGGAGGGTTTATTTCACAGATACGCAGTATTTT	CASSQGRVYFTDTQYF	TRBV4-2	TRBJ2-3
TGTGCCACCAGTGAGAGGGGGGCGGCGCTTTTAGGCTACACCTTC	CATSERGAALLGYTF	TRBV24-1	TRBJ1-2
TGTGCCAGCAGTTCTAGGGGGACCCAGTACTTC	CASSSRGTQYF	TRBV27	TRBJ2-5
TGTGCCAGTAGTTCTTATATCAGGGGGCACTTTACCTATAATTCACCCCTCCACTTT	CASSSYIRGHFTYNSPLHF	TRBV19	TRBJ1-6
TGTGCCAGCAGTACCGTCGGCTTGACCTACGAGCAGTACTTC	CASSTVGLTYEQYF	TRBV27	TRBJ2-7
TGTGCCAGCAGAAGGGCGCTTAATTCACCCCTCCACTTT	CASRRALNSPLHF	TRBV12-4	TRBJ1-6
TGTGCCAGCAGTACTGGACTAGCGGGTGGACCGCAGTATTTT	CASSTGLAGGPQYF	TRBV3-1	TRBJ2-3
TGCGCCAGCGCCGGGGACAGGGGGCGGAGCTCCTATAATTCACCCCTCCACTTT	CASAGDRGRSSYNSPLHF	TRBV10-1	TRBJ1-6
TGTGCCAGCACTTGGTCCGACGGGGGCCGGACAGGATGGGGTTACCGTAATGAGCAGTTCTTC	CASTWSDGGRTGWGYRNEQFF	TRBV27	TRBJ2-1
TGTGCCAGCAGTTTGGGTCGGATAACCAGCCACAATGAGCAGTTCTTC	CASSLGRITSHNEQFF	TRBV27	TRBJ2-1
TGTGCCAGCAGCGCCGTAGATATACAGGGCACCCTTAGCAATCAGCCCCAGCATTTT	CASSAVDIQGTLSNQPQHF	TRBV13	TRBJ1-5
