TGTGCCAGCAGCGGGCCGTGGTGCACAGATACGCAGTATTTT	CASSGPWCTDTQYF	TRBV6-1	TRBJ2-3
TGTGCCAGCAGTTGGGGGGGGTCTAACACTGAAGCTTTCTTT	CASSWGGSNTEAFF	TRBV27	TRBJ1-1
TGTGCCAGCAGCGCACCGCCAGTGGGACAGGGGCTTATGCGCAATCAGCCCCAGCATTTT	CASSAPPVGQGLMRNQPQHF	TRBV7-4	TRBJ1-5
TGTGCCTGGCGCACCGACCGGGACGTCATGAACACTGAAGCTTTCTTT	CAWRTDRDVMNTEAFF	TRBV30	TRBJ1-1
TGCGCCAGCGGCTGGGGCTATGGCTACACCTTC	CASGWGYGYTF	TRBV5-1	TRBJ1-2
TGTGCCAGCAGATCTAAGACTTCTACCTACGAGCAGTACTTC	CASRSKTSTYEQYF	TRBV12-4	TRBJ2-7
TGTGCCAGCATGGTCCGGAGCATCACAGATACGCAGTATTTT	CASMVRSITDTQYF	TRBV18	TRBJ2-3
TGTGCCAGCAGCCAAGACGGGAGGGTTCTCACCGGGGAGCTGTTTTTT	CASSQDGRVLTGELFF	TRBV14	TRBJ2-2
TGTGCCAGCAGCTCACGGCGGGGACAAGCAGGAATTAAGGGGATAGCTTTCTTT	CASSSRRGQAGIKGIAFF	TRBV7-2	TRBJ1-1
TGTGCCTGGAGTGCGTATGAGATGGGTTACGAGCAGTACTTC	CAWSAYEMGYEQYF	TRBV30	TRBJ2-7
TGTGCCAGCAGATGGGGGCAAGGATGGTCCTACAATGAGCAGTTCTTC	CASRWGQGWSYNEQFF	TRBV6-6	TRBJ2-1
TGTGCCAGCAGTGAGGGCCAGGTAATCCCCCCGTATAGCAATCAGCCCCAGCATTTT	CASSEGQVIPPYSNQPQHF	TRBV6-4	TRBJ1-5
TGCAGTGCTTTCGCATACCAGCCGGCGGGGTGGTCGGCCAAAAACATTCAGTACTTC	CSAFAYQPAGWSAKNIQYF	TRBV20-1	TRBJ2-4
TGCAGTGCTAGTAACCGATGGGACTACGAGCAGTACTTC	CSASNRWDYEQYF	TRBV20-1	TRBJ2-7
TGTGCCAGCAGCTTAAGATGGGGGCGGGGCCGGTCGAACACTGAAGCTTTCTTT	CASSLRWGRGRSNTEAFF	TRBV7-8	TRBJ1-1
TGTGCCAGCAGCATCTTAAGGACAGAACGCGAGCAGTACTTC	CASSILRTEREQYF	TRBV7-9	TRBJ2-7
TGTGCCAGCAGTTTTCGCCTGCCTAGCGGAGGGAACCTTGGGGCCAACGTCCTGACTTTC	CASSFRLPSGGNLGANVLTF	TRBV28	TRBJ2-6
TGCAGTGCCGTTTGGGACAGGCTGCCCCTAGACCCACGACCCTACGAGCAGTACTTC	CSAVWDRLPLDPRPYEQYF	TRBV20-1	TRBJ2-7
TGTGCCAGCAGCTTTGGATGCCCGGGGAATCGTGGCACTTGGACCAATGAGCAGTTCTTC	CASSFGCPGNRGTWTNEQFF	TRBV5-6	TRBJ2-1
TGTGCCACAGTCTTAGGCAACAATGAGCAGTTCTTC	CATVLGNNEQFF	TRBV19	TRBJ2-1
TGTGCCAGCAGCCAAGCTGGGGGTGGCGAGCAGTACTTC	CASSQAGGGEQYF	TRBV3-1	TRBJ2-7
TGTGCCAGCACAATAGCGGGCTCCTACGAGCAGTACTTC	CASTIAGSYEQYF	TRBV6-2	TRBJ2-7
TGTGCCACCAGCAGGGCCGGGACACATGGCAATCAGCCCCAGCATTTT	CATSRAGTHGNQPQHF	TRBV15	TRBJ1-5
TGTGCCAGCTCACCTAAGGACAGGGAGATCTACGAGCAGTACTTC	CASSPKDREIYEQYF	TRBV18	TRBJ2-7
TGTGCCAGCCTCCGGGACAGGGGGGACGATAGCAATCAGCCCCAGCATTTT	CASLRDRGDDSNQPQHF	TRBV9	TRBJ1-5
TGTGCCAGCAGTTTATCTACAGGGCGAGGGAGAGCGGGGGCCTTCGGGAACACTGAAGCTTTCTTT	CASSLSTGRGRAGAFGNTEAFF	TRBV27	TRBJ1-1
TGTGCCAGCAGCTTATCCCTTTTGACAGGGGCCATCTATTACAATGAGCAGTTCTTC	CASSLSLLTGAIYYNEQFF	TRBV7-9	TRBJ2-1
TGTGCCATCAGCCAACCCCCTGGGACTGGGGCTCACAATGAGCAGTTCTTC	CAISQPPGTGAHNEQFF	TRBV10-3	TRBJ2-1
TGTGCCAGCAGTTTATCCCCGAGGGGACCCCGGGAGACCCAGTACTTC	CASSLSPRGPRETQYF	TRBV27	TRBJ2-5
TGTGCCAGCAGTTGGCCACCTAAAAGCAATCAGCCCCAGCATTTT	CASSWPPKSNQPQHF	TRBV6-2	TRBJ1-5
TGCGCCGAGGACGGTACCTGGGGGAGGTGTATGAACACCGGGGAGCTGTTTTTT	CAEDGTWGRCMNTGELFF	TRBV5-1	TRBJ2-2
TGTGCCAGCAGCCGAAGAGTGGACCCGGACCGGACCCAGGGTAAATACAATGAGCAGTTCTTC	CASSRRVDPDRTQGKYNEQFF	TRBV7-9	TRBJ2-1
TGTGCCAGCACCTCCTTCCAACTGGGGCGCCGTAATTCACCCCTCCACTTT	CASTSFQLGRRNSPLHF	TRBV6-2	TRBJ1-6
TGTGCCAGCAGTTATCCACCCACCTACGAGCAGTACTTC	CASSYPPTYEQYF	TRBV6-5	TRBJ2-7
TGTGCCAGCAGTTATAGCGGGAACCTAAATATGGCCGGGGAGCTGTTTTTT	CASSYSGNLNMAGELFF	TRBV6-5	TRBJ2-2
TGTGCCAGCAGTTGGGGGCTTGGTAGCTCCTACAATGAGCAGTTCTTC	CASSWGLGSSYNEQFF	TRBV27	TRBJ2-1
TGCAGCGTTGAACTCCTTGATAGCGGGACCAGGGAAATTAGCACAGATACGCAGTATTTT	CSVELLDSGTREISTDTQYF	TRBV29-1	TRBJ2-3
TGCAGTGCGGGGGGAGAGCAGTACTTC	CSAGGEQYF	TRBV20-1	TRBJ2-7
TGTGCCAGCAGCCAAGATTCCATGGAGACGGACAGGCGGGGAGAATCCCTCAATGAGCAGTTCTTC	CASSQDSMETDRRGESLNEQFF	TRBV14	TRBJ2-1
TGTGCCATCAGGATCATAGCTGCCGAGCAGTACTTC	CAIRIIAAEQYF	TRBV7-9	TRBJ2-7
TGTGCCAGCAGCAAGAACTATCAGCCCCAGCATTTT	CASSKNYQPQHF	TRBV7-3	TRBJ1-5
TGTGCCAGCAGCGCCCGGGGGAGGGGGAGCTACGAGCAGTACTTC	CASSARGRGSYEQYF	TRBV6-5	TRBJ2-7
TGTGCCAGCAGTTTACCCACTAGCGGGAGGGCAGATAGATACGAGCAGTACTTC	CASSLPTSGRADRYEQYF	TRBV28	TRBJ2-7
TGCAGTGCTAGCGGTTACAGGACTGAAGCTTTCTTT	CSASGYRTEAFF	TRBV20-1	TRBJ1-1
TGTGCCAGCAGCGGAGTCTTGACAGGCTACGAGCAGTACTTC	CASSGVLTGYEQYF	TRBV9	TRBJ2-7
TGTGCCAGCAGCCAAAGACGGGAGAAGGTGGGACTGAACACTGAAGCTTTCTTT	CASSQRREKVGLNTEAFF	TRBV3-1	TRBJ1-1
TGTGCCTGGAGGGTAAACGGGACAGGCGGAGGCAATCAGCCCCAGCATTTT	CAWRVNGTGGGNQPQHF	TRBV30	TRBJ1-5
TGCAGCGTTGAATGTGGCACTAAAGATACGCAGTATTTT	CSVECGTKDTQYF	TRBV29-1	TRBJ2-3
TGTGCCAGCAGCGGACGGGGGGCCGGGGAGCTGTTTTTT	CASSGRGAGELFF	TRBV13	TRBJ2-2
TGTGCCAGCACCAGAGGCGGGACAGGCAGAAACTATGGCTACACCTTC	CASTRGGTGRNYGYTF	TRBV6-1	TRBJ1-2
TGTGCCACCAGCAGCTTAGGGGACGATTACTACGAGCAGTACTTC	CATSSLGDDYYEQYF	TRBV15	TRBJ2-7
TGTGCCAGCAGGACGGACAGGGGGCGGGTGGGGTTTGAAAAACTGTTTTTT	CASRTDRGRVGFEKLFF	TRBV6-4	TRBJ1-4
TGTGCCAGCAGTTTATCGCTTTTCCGGGAGCCCTACGAGCAGTACTTC	CASSLSLFREPYEQYF	TRBV27	TRBJ2-7
TGTGCCAGCAGCTTAAAGGACCCGAGCAAGGGCGGGGAAGCTTTCTTT	CASSLKDPSKGGEAFF	TRBV7-3	TRBJ1-1
TGCGCCAGCAGCTTGGAGGACGACGGCTCTGGAAACACCATATATTTT	CASSLEDDGSGNTIYF	TRBV5-1	TRBJ1-3
TGTGCTAGCAGCGGCCGGGACACTTTGACTGAAGCTTTCTTT	CASSGRDTLTEAFF	TRBV7-7	TRBJ1-1
TGTGCCAGCAGCGCGGTGAGGAAGAACACTGAAGCTTTCTTT	CASSAVRKNTEAFF	TRBV9	TRBJ1-1
TGTGCCAGCAGCAAGGGAAATCGAGGACAGGGCCCTAACTATGGCTACACCTTC	CASSKGNRGQGPNYGYTF	TRBV5-6	TRBJ1-2
TGTGCCAGCAGCTTAGAACCAACAGGAAAAGAGACCCAGTACTTC	CASSLEPTGKETQYF	TRBV7-6	TRBJ2-5
TGTGCCAGCAGCCCCTGTGGGGGTGCCTATGGCTACACCTTC	CASSPCGGAYGYTF	TRBV11-1	TRBJ1-2
TGTGCCAGCAGCTTGGGGGGGACAGGGACCCAAGAGACCCAGTACTTC	CASSLGGTGTQETQYF	TRBV7-8	TRBJ2-5
TGCGCCAGCAGCGGGGGGCACGAGCAGTACTTC	CASSGGHEQYF	TRBV5-1	TRBJ2-7
TGCAGTGCCCTCCCGCCTGATGAGCAGTTCTTC	CSALPPDEQFF	TRBV20-1	TRBJ2-1
TGTGCCACCAGTGATTTCCCATCCCCGATCGGCAATCAGCCCCAGCATTTT	CATSDFPSPIGNQPQHF	TRBV24-1	TRBJ1-5
TGTGCCAGCAGTTACTACCGGGACAGGGTAGAGAGGAGCAATCAGCCCCAGCATTTT	CASSYYRDRVERSNQPQHF	TRBV6-5	TRBJ1-5
TGTGCCACCAGTGTCCAGACTTACAGGGCCCGTAGGGCTGGAAACACCATATATTTT	CATSVQTYRARRAGNTIYF	TRBV24-1	TRBJ1-3
TGTGCCAGCAGCTTACTCGTCGAGGGACTGGGGAGCTCCTACGAGCAGTACTTC	CASSLLVEGLGSSYEQYF	TRBV7-6	TRBJ2-7
TGTGCCAGCAGTAATAGGCTTCCCTACAATGAGCAGTTCTTC	CASSNRLPYNEQFF	TRBV28	TRBJ2-1
TGCGCCAGCAGCCAAGATCAGGGGGGGGGGCCCTCCTACGAGCAGTACTTC	CASSQDQGGGPSYEQYF	TRBV4-1	TRBJ2-7
TGTGCCAGCAGTTACGCTTTACCGGGTAACTATGGCTACACCTTC	CASSYALPGNYGYTF	TRBV6-5	TRBJ1-2
TGCAGTGCTAGATTCAGGCAGTACTTC	CSARFRQYF	TRBV20-1	TRBJ2-7
TGTGCCAGCAGTGACTCGGGTACCTCATATCCCCCCGGACGAGTCTACGAGCAGTACTTC	CASSDSGTSYPPGRVYEQYF	TRBV6-4	TRBJ2-7
TGTGCCCACCCAGGTCCGGGAGGGGGAAGTGGCACAGATACGCAGTATTTT	CAHPGPGGGSGTDTQYF	TRBV7-9	TRBJ2-3
TGTGCCAGCAGTGTCAGGGGGTCGCTTTGGGCCAACGTCCTGACTTTC	CASSVRGSLWANVLTF	TRBV6-1	TRBJ2-6
TGTGCCAGCAGTTTACGCCGGACAGTTAGATCCCAGCCCCAGCATTTT	CASSLRRTVRSQPQHF	TRBV27	TRBJ1-5
TGTGCCAGCAGCAGGAATAGCGGGACCCCCTACGAGCAGTACTTC	CASSRNSGTPYEQYF	TRBV7-3	TRBJ2-7
TGTGCCAGCAGTGAGAAACTGACGGGACTAGCGGGCTTGGGTACGGGAGAGCAGTACTTC	CASSEKLTGLAGLGTGEQYF	TRBV25-1	TRBJ2-7
TGTGCCAGCAGTTATCCAGGGGATAGCAATCAGCCCCAGCATTTT	CASSYPGDSNQPQHF	TRBV6-5	TRBJ1-5
TGTGCCAGCAGCAGTCGGGGTTCTTTTATTGTTAGCGAGTACGAGCAGTACTTC	CASSSRGSFIVSEYEQYF	TRBV7-2	TRBJ2-7
TGTGCCAGCAGCTTCCCAGGGGACAGATTCAAAAACATTCAGTACTTC	CASSFPGDRFKNIQYF	TRBV7-2	TRBJ2-4
TGCAGTGCTGGGCCGTTCTGGGAGCAGTACTTC	CSAGPFWEQYF	TRBV20-1	TRBJ2-7
TGTGCCAGCATCGGGAAAGCAGGGATGTTCAATCAGCCCCAGCATTTT	CASIGKAGMFNQPQHF	TRBV11-2	TRBJ1-5
TGTGCCAGCAGTTTGGCTGACAGGTGGGTGTACAATGAGCAGTTCTTC	CASSLADRWVYNEQFF	TRBV12-4	TRBJ2-1
TGTGCCAGCAGCGCCCTTCATTCGCAGTACAATCAGCCCCAGCATTTT	CASSALHSQYNQPQHF	TRBV7-2	TRBJ1-5
TGTGCCAGCAGCGTAGGTGGATTTCAGGAGCAGTACTTC	CASSVGGFQEQYF	TRBV9	TRBJ2-7
TGCGCCAGCAGCTGGCATTCCAGCAATCAGCCCCAGCATTTT	CASSWHSSNQPQHF	TRBV5-1	TRBJ1-5
TGTGCCAGCAGCTTAGCCTCGTCACGAGGGACTAGCGGCTCTGGGGCCAACGTCCTGACTTTC	CASSLASSRGTSGSGANVLTF	TRBV7-2	TRBJ2-6
TGTGCCAGTAGAGCCTTGGGTAAGACCGGGGAGCTGTTTTTT	CASRALGKTGELFF	TRBV19	TRBJ2-2
TGCGCCAGTCCTGCAGGGGCGAACACCGGGGAGCTGTTTTTT	CASPAGANTGELFF	TRBV10-1	TRBJ2-2
TGCGCCAGCAGCTTGTTAGCGGGAGAGAGTAGCACAGATACGCAGTATTTT	CASSLLAGESSTDTQYF	TRBV5-1	TRBJ2-3
TGCAGTGCTAGAGATAGCCCGGGACGGAGCACAGATACGCAGTATTTT	CSARDSPGRSTDTQYF	TRBV20-1	TRBJ2-3
TGTGCGGGGTTCGGGGTCGGGGGCTACACCTTC	CAGFGVGGYTF	TRBV12-5	TRBJ1-2
TGTGCCAGCAGTGCGCCGGGGTGCCCGAGTCCAGCCCTAGGGACAGGGGGGCAAGGCTACACCTTC	CASSAPGCPSPALGTGGQGYTF	TRBV28	TRBJ1-2
TGTGCCAGCAAGCGGGACAGGGGGGGCCACGGGCCGAACACCGGGGAGCTGTTTTTT	CASKRDRGGHGPNTGELFF	TRBV14	TRBJ2-2
TGCGCCAGCAGCCGAAGGGGGAACACTGAAGCTTTCTTT	CASSRRGNTEAFF	TRBV5-1	TRBJ1-1
TGTGCCAGCAGTGGGACTTACGAGCAGTACTTC	CASSGTYEQYF	TRBV28	TRBJ2-7
TGCAGTGCTAGTCCGATCAGGGCCCCCCCGAACACCGGGGAGCTGTTTTTT	CSASPIRAPPNTGELFF	TRBV20-1	TRBJ2-2
TGTGCCAGCAGTGGCAGGGTGGGCCTACTAATTAAAGAGACCCAGTACTTC	CASSGRVGLLIKETQYF	TRBV28	TRBJ2-5
TGTGCCAGCAGCTTCCCGAGCCGTCGACAGGCTAGGAGATGGTCGGGAAGGGGCGAGCAGTACTTC	CASSFPSRRQARRWSGRGEQYF	TRBV11-3	TRBJ2-7
TGTGCCAGCAGTTTCCGAGGGACATCCAACAACGAGCAGTACTTC	CASSFRGTSNNEQYF	TRBV28	TRBJ2-7
