TGTGCCAGCAGTAAGGGAGGGCCCGGCTACACCTTC	CASSKGGPGYTF	TRBV6-1	TRBJ1-2
TGCAGTGCTAGAGCCCCAGCGGGACAGGGGCTCTACGAGCAGTACTTC	CSARAPAGQGLYEQYF	TRBV20-1	TRBJ2-7
TGTGCCACCAGTGATTTCCGGCGGTCCCCGATCTACGAGCAGTACTTC	CATSDFRRSPIYEQYF	TRBV24-1	TRBJ2-7
TGTGCCAGCAGCGGGGGCCTGACAGGGGACACTGAAGCTTTCTTT	CASSGGLTGDTEAFF	TRBV9	TRBJ1-1
TGTGCCAGTAGCCCTAGCGGTTCTCGGTACGAGCAGTACTTC	CASSPSGSRYEQYF	TRBV19	TRBJ2-7
TGTGCCAGCAGGGGCAGGGCCGGCTCCTACAATGAGCAGTTCTTC	CASRGRAGSYNEQFF	TRBV6-1	TRBJ2-1
TGTGCCAGCAGTTATCCAAGGGGGCCGAACACTGAAGCTTTCTTT	CASSYPRGPNTEAFF	TRBV27	TRBJ1-1
TGCAGTGCTAGAGAGGGAAACGGGGGGGGCAACACTGAAGCTTTCTTT	CSAREGNGGGNTEAFF	TRBV20-1	TRBJ1-1
TGTGCCAGCAGAAGGGACACCCAAAATGGCTACACCTTC	CASRRDTQNGYTF	TRBV6-5	TRBJ1-2
TGTGCCACCCTTGGTTGCCAAAAAGCCAAAAACATTCAGTACTTC	CATLGCQKAKNIQYF	TRBV7-9	TRBJ2-4
TGTGCCAGCAGCTTGGTGAGGCAGCCCCAGCATTTT	CASSLVRQPQHF	TRBV6-2	TRBJ1-5
TGTGCCAGTAGGCCACAGGGGAGGGGGGCCTATAATTCACCCCTCCACTTT	CASRPQGRGAYNSPLHF	TRBV19	TRBJ1-6
TGTGCCAGCAGCGTAGTATACCTGGGGGCAGGAGAGAACACTGAAGCTTTCTTT	CASSVVYLGAGENTEAFF	TRBV9	TRBJ1-1
TGTGCCAGCAGCTTGGCCGCGACAGGCGGTTTAAACGAGCAGTACTTC	CASSLAATGGLNEQYF	TRBV5-4	TRBJ2-7
TGTGCCAGCAGCGGAGGGGTTAACTATGGCTACACCTTC	CASSGGVNYGYTF	TRBV13	TRBJ1-2
TGTGCCAGCAGTTTGTCCCCTAGGACGGGCGGCGCAACTGAAGCTTTCTTT	CASSLSPRTGGATEAFF	TRBV27	TRBJ1-1
TGTGCCAGTAGGATTCTTAGGAACGAGCAGTACTTC	CASRILRNEQYF	TRBV19	TRBJ2-7
TGTGCTAGTGGTTTGGCGAACGGGACAGGGGTGGTCAACTACGAGCAGTACTTC	CASGLANGTGVVNYEQYF	TRBV12-5	TRBJ2-7
TGCAGTGCTAGACAGAAACATTCGCGGGAGAATTATCTGAACACTGAAGCTTTCTTT	CSARQKHSRENYLNTEAFF	TRBV20-1	TRBJ1-1
TGTGCCAGCAGTTTATGGGGGGTATGGGGGGGGAGCTACGAGCAGTTCTTC	CASSLWGVWGGSYEQFF	TRBV28	TRBJ2-1
TGTGCCAGCAGCGTTAGCTACAGGGTTAATGAAAAACTGTTTTTT	CASSVSYRVNEKLFF	TRBV7-2	TRBJ1-4
TGTGCCAGTCAAGGGGCAGTCGTCTTAAATAGCAATCAGCCCCAGCATTTT	CASQGAVVLNSNQPQHF	TRBV19	TRBJ1-5
TGTGCCAGACCGACAGGGCTACATGGCTACACCTTC	CARPTGLHGYTF	TRBV7-2	TRBJ1-2
TGTGCCACCCGGACAGGGGCGGAGGAGACCCAGTACTTC	CATRTGAEETQYF	TRBV24-1	TRBJ2-5
TGTGCCAGCAGTTACTCGGTACGCGGGGCTGAAGCTTTCTTT	CASSYSVRGAEAFF	TRBV6-6	TRBJ1-1
TGTGCCAGCAGCGGACAAGGTGAAGCTTTCTTT	CASSGQGEAFF	TRBV13	TRBJ1-1
TGTGCCAGCAGCCGGCCGGTCACCCCTTCCGAGCAGTACTTC	CASSRPVTPSEQYF	TRBV5-4	TRBJ2-7
TGCAGCGCACCGAGGCCACTGAAAGCTAGCACAGATACGCAGTATTTT	CSAPRPLKASTDTQYF	TRBV29-1	TRBJ2-3
TGTGCCAGCAGCTTACGTCTCGGGACTTATCCAGATACGCAGTATTTT	CASSLRLGTYPDTQYF	TRBV11-2	TRBJ2-3
TGTGCCAGCAGCTCCGCTCCACATCCGATACGCGGCTACACCTTC	CASSSAPHPIRGYTF	TRBV7-8	TRBJ1-2
TGTGCCAGTAGTTCGCTAGCGGGCCACACCGGGGAGCTGTTTTTT	CASSSLAGHTGELFF	TRBV19	TRBJ2-2
TGTGCCAGCAGCTTAGCGCCGGGAGGGGCCTTAGGTCCGGTCTACGAGCAGTACTTC	CASSLAPGGALGPVYEQYF	TRBV7-2	TRBJ2-7
TGTGCCAGCAGCCAACCCAGCCGGCTCCACTTT	CASSQPSRLHF	TRBV7-9	TRBJ1-6
TGCAGTGCTAGAGATTACCCGAAGGACAGGGGGTACGAGCAGTACTTC	CSARDYPKDRGYEQYF	TRBV20-1	TRBJ2-7
TGTGCCAGCAGTCCTCGGGGAAATGCCACCTACGAGCAGTACTTC	CASSPRGNATYEQYF	TRBV6-1	TRBJ2-7
TGCGCCAGCAGCTCCCAGGTTTTAGCTGGAAACACCATATATTTT	CASSSQVLAGNTIYF	TRBV5-1	TRBJ1-3
TGCAGTGCTACACGGGAGGAGCAAGGGTGCAATGAGCAGTTCTTC	CSATREEQGCNEQFF	TRBV20-1	TRBJ2-1
TGTGCCAGCAGCGGGGACAGGCCCGCCTACGAGCAGTACTTC	CASSGDRPAYEQYF	TRBV7-4	TRBJ2-7
TGTGCCAGCAGCAGACTGGTGGAAGGCTACACCTTC	CASSRLVEGYTF	TRBV7-9	TRBJ1-2
TGTGCCAGCAGCGTCCATTGGGACGCCTACGAGCAGTACTTC	CASSVHWDAYEQYF	TRBV9	TRBJ2-7
TGTGCCAGCAGCCAAGTTGGACAGAGACCACTTCCTGGGGCCAACGTCCTGACTTTC	CASSQVGQRPLPGANVLTF	TRBV3-1	TRBJ2-6
TGTGCCAGCAGCTTAGTCTTACCAGGGACTTACTTC	CASSLVLPGTYF	TRBV11-2	TRBJ2-4
TGTGCCAGCAGCGCGGGAGAAGATGGCGAGACAGATACGCAGTATTTT	CASSAGEDGETDTQYF	TRBV13	TRBJ2-3
TGCGCCAGCAGGGCGCGCCCGGGACAGTCGTGCGAGCAGTACTTC	CASRARPGQSCEQYF	TRBV5-1	TRBJ2-7
TGTGCCAGCAGTTACTCGCCGGGACAGTCCCTTGACCCTGAAGCTTTCTTT	CASSYSPGQSLDPEAFF	TRBV6-5	TRBJ1-1
TGTGCCAGCACTGGGGCCCCCAATGAGCAGTTCTTC	CASTGAPNEQFF	TRBV6-3	TRBJ2-1
TGCGCCAGCAAGGGTCCTTACAATCAGCCCCAGCATTTT	CASKGPYNQPQHF	TRBV10-1	TRBJ1-5
TGTGCCAGCAGCTTAGCCGTAAGCCCCCGGGGGGAGGTGCGCGGGTCTAACTATGGCTACACCTTC	CASSLAVSPRGEVRGSNYGYTF	TRBV7-2	TRBJ1-2
TGTGCCAGCAGCGGGGAGGGGGAGCGTGAGAACACTGAAGCTTTCTTT	CASSGEGERENTEAFF	TRBV7-3	TRBJ1-1
TGTGCCAGGGAGCGGGAGGCCACTGAAAAACTGTTTTTT	CAREREATEKLFF	TRBV10-3	TRBJ1-4
TGTGCCAACGGACAGGCGATGAAAGAGACCCAGTACTTC	CANGQAMKETQYF	TRBV12-3	TRBJ2-5
TGTGCCAGTAGTAGGGCCTGGGGGTACAATGAGCAGTTCTTC	CASSRAWGYNEQFF	TRBV19	TRBJ2-1
TGTGCCAGCAGTAGACTAGGGCTGCAAGAGACCCAGTACTTC	CASSRLGLQETQYF	TRBV6-1	TRBJ2-5
TGTGCCACCAGTGATCCCACCAGGTTTTTTCCTGGGGCCAACGTCCTGACTTTC	CATSDPTRFFPGANVLTF	TRBV24-1	TRBJ2-6
TGTGCCACCAGTAGTTCACGGGCCCACACTGAAGCTTTCTTT	CATSSSRAHTEAFF	TRBV24-1	TRBJ1-1
TGCAGCGTTGCTCAACCGCGGGCCGGAGAATCCGAGACCTACGAGCAGTACTTC	CSVAQPRAGESETYEQYF	TRBV29-1	TRBJ2-7
TGTGCCAGCAGGGAGGTCCTCGGGACATATAATGAAAAACTGTTTTTT	CASREVLGTYNEKLFF	TRBV11-2	TRBJ1-4
TGTGCCAGCAGTTACAGGTCGAGCAAGCCCCAGCATTTT	CASSYRSSKPQHF	TRBV6-5	TRBJ1-5
TGTGCCAGCAGTGTTTCGCCGGACAGGGCAGTCTACGAGCAGTACTTC	CASSVSPDRAVYEQYF	TRBV12-3	TRBJ2-7
TGCAGTGCTGTATCCACTAGCGGGAGGAACACTGAAGCTTTCTTT	CSAVSTSGRNTEAFF	TRBV20-1	TRBJ1-1
TGTGCCAGCAGCTCCCCCCGTAGGGACACTGAAGCTTTCTTT	CASSSPRRDTEAFF	TRBV7-9	TRBJ1-1
TGTGCCAGCAGCTTATCAGGTAGACATGGCTACACCTTC	CASSLSGRHGYTF	TRBV11-2	TRBJ1-2
TGTGCCAGCAGCACCGGGACTAGGGGGGGAGAGACCCAGTACTTC	CASSTGTRGGETQYF	TRBV14	TRBJ2-5
TGCGCCAGCAGTGAGGTGGGGCGGAATCAGCCCCAGCATTTT	CASSEVGRNQPQHF	TRBV10-2	TRBJ1-5
TGTGCCAGCAGCTTAGCGGGACAGGGAAGGAAAACTGAAGCTTTCTTT	CASSLAGQGRKTEAFF	TRBV11-3	TRBJ1-1
TGCGCCAGCTTGAGGAGGGGACATAATTCACCCCTCCACTTT	CASLRRGHNSPLHF	TRBV5-1	TRBJ1-6
TGTGCCAGCAGAGGACAGGGCCTTAGCTCTGGAAACACCATATATTTT	CASRGQGLSSGNTIYF	TRBV6-3	TRBJ1-3
TGTGCCAGAGGTCCTACACACCCGAGGGGGACTAGCGGAAGTGTTTTGCAGTTCTTC	CARGPTHPRGTSGSVLQFF	TRBV5-6	TRBJ2-1
TGTGCCACCAGCAGAGATCACCGAAACCCGGCGGGTGAAAAACTGTTTTTT	CATSRDHRNPAGEKLFF	TRBV15	TRBJ1-4
TGTGCCAGCAGTTTAGAAAGGGGGGCCCGCACAGATACGCAGTATTTT	CASSLERGARTDTQYF	TRBV28	TRBJ2-3
TGTGCCAGCAGCTACCCGGAAACTTTTGAAAAACTGTTTTTT	CASSYPETFEKLFF	TRBV12-3	TRBJ1-4
TGTGCCAGCAGTGGACAGACCGGGGAGCTGTTTTTT	CASSGQTGELFF	TRBV28	TRBJ2-2
TGTGCCAGCAGCTTGGGGGGGCAGAACACCGGGGAGCTGTTTTTT	CASSLGGQNTGELFF	TRBV5-6	TRBJ2-2
TGTGCCAGCAGTGCCGGTACTCACTATGGCTACACCTTC	CASSAGTHYGYTF	TRBV2	TRBJ1-2
TGTGCCAGCAGCAGCCCGCCCGGGCAGGTAGAGACCCAGTACTTC	CASSSPPGQVETQYF	TRBV13	TRBJ2-5
TGTGCCAGCAGTTACTCTGGGAGACCGGGGGGCTGGCTAGAGACCCAGTACTTC	CASSYSGRPGGWLETQYF	TRBV6-5	TRBJ2-5
TGTGCCAGCAGTAGATCGTCGGAGTCGGGACATAACTATCAGCCCCAGCATTTT	CASSRSSESGHNYQPQHF	TRBV27	TRBJ1-5
TGTGCCAGCAAGCGGAGCCCTAGGGATTCCACGTCTGGAAACACCATATATTTT	CASKRSPRDSTSGNTIYF	TRBV6-6	TRBJ1-3
TGTGCCATCAGGGGGGGGACTAATCGACCCGTTAGCTCCTACGAGCAGTACTTC	CAIRGGTNRPVSSYEQYF	TRBV10-3	TRBJ2-7
TGTGCCAGCAGCAAAGGCAATCGGTACTATGGCTACACCTTC	CASSKGNRYYGYTF	TRBV7-9	TRBJ1-2
TGTGCCAGCTCACCGGCCGGGGACGCCCAGTACTTC	CASSPAGDAQYF	TRBV18	TRBJ2-5
TGTGCCAGCAGCTTAAAGACTACCCCTCCGGGACAGGGGAAGAGAGAGACCCAGTACTTC	CASSLKTTPPGQGKRETQYF	TRBV5-5	TRBJ2-5
TGTGCCAGCAGTACACAGGGGGCGTCCTACGAGCAGTACTTC	CASSTQGASYEQYF	TRBV6-6	TRBJ2-7
TGTGCCTGGAGTGTACGTCGGGCGACAGAGTGTGGCTACACCTTC	CAWSVRRATECGYTF	TRBV30	TRBJ1-2
TGCGCCAGCAGCCTAGACAGGGGGCGCTTAAACACCGGGGAGCTGTTTTTT	CASSLDRGRLNTGELFF	TRBV5-1	TRBJ2-2
TGTGCCAGCATGGAATTTCAGTACGGCAGGGGGGGAGTAGATACGCAGTATTTT	CASMEFQYGRGGVDTQYF	TRBV3-1	TRBJ2-3
TGTGCCAGCAGTTTATCCCTTTTCCAGGACTTTTATGGCTACACCTTC	CASSLSLFQDFYGYTF	TRBV27	TRBJ1-2
TGCGCCAGCAGCTTCCCTGCAGGTATCTGGGCTTTCTTT	CASSFPAGIWAFF	TRBV5-1	TRBJ1-1
TGTGCCAGCAGCTTGGGCACGAGACAGGGAAACACCATATATTTT	CASSLGTRQGNTIYF	TRBV5-8	TRBJ1-3
TGTGCCAGCAGCAAGGGGGGCCCAATGGCCAACGAGCAGTACTTC	CASSKGGPMANEQYF	TRBV27	TRBJ2-7
TGCAGTGAAGGAGGGGAAACTCCGAACACTGAAGCTTTCTTT	CSEGGETPNTEAFF	TRBV20-1	TRBJ1-1
TGTGCCACCAGCAGCCGGGCTGGCGGAAACACCATATATTTT	CATSSRAGGNTIYF	TRBV15	TRBJ1-3
TGCAGCGTACGAGACATCGCCCAAGAGACCCAGTACTTC	CSVRDIAQETQYF	TRBV29-1	TRBJ2-5
TGTGCCAGCAGTTACTCCGGGTGTAGCGGGGCCTACGAGCAGTACTTC	CASSYSGCSGAYEQYF	TRBV6-6	TRBJ2-7
TGTGCCAGCAGTGGATCTGGGGGTGGGGGTTCCTACGAGCAGTACTTC	CASSGSGGGGSYEQYF	TRBV6-1	TRBJ2-7
TGTGCCAGCAGCGGATATTCCCCCCCTCGGGACAGGGCTTTGACTAGCACAGATACGCAGTATTTT	CASSGYSPPRDRALTSTDTQYF	TRBV5-5	TRBJ2-3
TGCGCCAGCAGCTTGTGGTCAAGGGTCCCTGGGGCCAACGTCCTGACTTTC	CASSLWSRVPGANVLTF	TRBV5-1	TRBJ2-6
TGTGCCAGCAGCCTACCGGGACTAGCTGGCGTGGCATACGAGCAGTACTTC	CASSLPGLAGVAYEQYF	TRBV7-4	TRBJ2-7
TGTGCCAGTAGTATGTTGGGACAGGGCCCCGAGCAGTACTTC	CASSMLGQGPEQYF	TRBV19	TRBJ2-7
TGTGCCAGCTCACTCCTTTTCCCCAGGGTCGAGCACTATGGCTACACCTTC	CASSLLFPRVEHYGYTF	TRBV18	TRBJ1-2
