TGTGCCAGCAGCAAACGCTTCTACGAGCAGTACTTC	CASSKRFYEQYF	TRBV7-9	TRBJ2-7
TGTGCCAGCAGGGCCGCGACAGGGTCTAATTCACCCCTCCACTTT	CASRAATGSNSPLHF	TRBV5-6	TRBJ1-6
TGTGCCATTATCAGGGCCGGGGAGCTGTTTTTT	CAIIRAGELFF	TRBV27	TRBJ2-2
TGTGCCAGCAAGAGGGACAGGGTCTACTATGGCTACACCTTC	CASKRDRVYYGYTF	TRBV6-4	TRBJ1-2
TGTGCCAGCAGCCCCCGGAGAGGACCCCCGAACTCTGGGGCCAACGTCCTGACTTTC	CASSPRRGPPNSGANVLTF	TRBV7-4	TRBJ2-6
TGTGCCAGCGTTGGGCCCCTCTCTGGAAACACCATATATTTT	CASVGPLSGNTIYF	TRBV7-3	TRBJ1-3
TGTGCCAGCGGGACTACCTACGAGCAGTACTTC	CASGTTYEQYF	TRBV27	TRBJ2-7
TGTGCCAGCAGTGTAGACACGGTTGGAAACACCATATATTTT	CASSVDTVGNTIYF	TRBV6-4	TRBJ1-3
TGTGCCAGCAACGGGGCGGCTTACGTGGCAGATACGCAGTATTTT	CASNGAAYVADTQYF	TRBV9	TRBJ2-3
TGTGCCAGCAGCCCAACACTTAGGGGCTCTGGAAACACCATATATTTT	CASSPTLRGSGNTIYF	TRBV11-3	TRBJ1-3
TGTGCCAGCAGCCGACAGGGAAATGGCTACACCTTC	CASSRQGNGYTF	TRBV14	TRBJ1-2
TGCAGTGCTAGAGATCGGTCGATGAACACTGAAGCTTTCTTT	CSARDRSMNTEAFF	TRBV20-1	TRBJ1-1
TGTGCCAGTAGTTGGGACGTCAATCAGCCCCAGCATTTT	CASSWDVNQPQHF	TRBV19	TRBJ1-5
TGTGCCAGCAGCTTATTCGCGAACACGAGGGAGCAGTACTTC	CASSLFANTREQYF	TRBV7-2	TRBJ2-7
TGTGCCAGCAGCTTAAGCTACAGATTGCAAAACTATGGCTACACCTTC	CASSLSYRLQNYGYTF	TRBV11-1	TRBJ1-2
TGCAGTGCTAGAGATCTCGCGTTAATCCTAGCGGGGGGCCCCTCTGGGGCCAACGTCCTGACTTTC	CSARDLALILAGGPSGANVLTF	TRBV20-1	TRBJ2-6
TGTGACAGGGGGGGCGAGCAGTACTTC	CDRGGEQYF	TRBV24-1	TRBJ2-7
TGTGCCAGCAGCGCCGGGACTAGGATGTGCACAGATACGCAGTATTTT	CASSAGTRMCTDTQYF	TRBV7-2	TRBJ2-3
TGCAGTGCTAGAGCCTTCTCGGGCAATCAGCCCCAGCATTTT	CSARAFSGNQPQHF	TRBV20-1	TRBJ1-5
TGCGCCAGCAGGCCAAGAGTAACCATTCAGTACTTC	CASRPRVTIQYF	TRBV5-1	TRBJ2-4
TGTGCCAGCAGCCGGGACAGCGTGAACACCGGGGAGCTGTTTTTT	CASSRDSVNTGELFF	TRBV28	TRBJ2-2
TGTGCCAGCAGCGAAATTGACAGGGACGGCTACACCTTC	CASSEIDRDGYTF	TRBV7-3	TRBJ1-2
TGTGCCAGCAGCGAAGGGACAGCCCCGCGAGTCCGCTACGAGCAGTACTTC	CASSEGTAPRVRYEQYF	TRBV13	TRBJ2-7
TGCAGTGCAACCCGGACAGGCCGGGGCTCCTATAATTCACCCCTCCACTTT	CSATRTGRGSYNSPLHF	TRBV20-1	TRBJ1-6
TGCAGCGCCAGTAGACTCGCGGGTTTTCTGCCGGGACTAGGTAGTGGGCAGTACTTC	CSASRLAGFLPGLGSGQYF	TRBV29-1	TRBJ2-7
TGTGCCAGCAGCTGGAACAGGGGGCTGGTCAATCAGCCCCAGCATTTT	CASSWNRGLVNQPQHF	TRBV13	TRBJ1-5
TGTGCCAGCTTGGACAGGGCAGCCGGGCCCCAGCATTTT	CASLDRAAGPQHF	TRBV6-5	TRBJ1-5
TGTGCCAGGCCGGGGTTAAGCAATCAGCCCCAGCATTTT	CARPGLSNQPQHF	TRBV6-8	TRBJ1-5
TGTGCCCCCTTCGGATTGGGTAGATACGAGCAGTACTTC	CAPFGLGRYEQYF	TRBV6-5	TRBJ2-7
TGTGCCAGCAGAAGCGGATTTCCTAAGGAGCTGTTTTTT	CASRSGFPKELFF	TRBV28	TRBJ2-2
TGTGCCACCAGTGATTTGCCCAATTACAACACGTGCTACGAGCAGTACTTC	CATSDLPNYNTCYEQYF	TRBV24-1	TRBJ2-7
TGTGCCAGCAGCTTGGCCTGGCGGGTCACTGAAGCTTTCTTT	CASSLAWRVTEAFF	TRBV5-5	TRBJ1-1
TGCGCCAGCAGCTTGGCCGGGGGAGTGAGGGGCTACACCTTC	CASSLAGGVRGYTF	TRBV5-1	TRBJ1-2
TGTGCCAGCAGCTTAGCCCTGGGGGCCTTTAGGGGGAGGGAGACCTACGAGCAGTACTTC	CASSLALGAFRGRETYEQYF	TRBV11-3	TRBJ2-7
TGCAGTGCTAGAAGAACGGCAGGGGTCCCCCCTGGAAACACCATATATTTT	CSARRTAGVPPGNTIYF	TRBV20-1	TRBJ1-3
TGCGCCAGCAGCTCCGCAAAGTGGACGGCGATCACTAATGAAAAACTGTTTTTT	CASSSAKWTAITNEKLFF	TRBV5-1	TRBJ1-4
TGTGCCAGCAGTCCTCGCTCGGGACAGGGCCGACCTTGGAACACTGAAGCTTTCTTT	CASSPRSGQGRPWNTEAFF	TRBV6-6	TRBJ1-1
TGTGCCAGCAGCAATTGGCCCTCTCACGATACGCAGTATTTT	CASSNWPSHDTQYF	TRBV5-5	TRBJ2-3
TGTGCCAGCAGCTTGCTGGGGACAGGGGGCTGTAAACGATCTGGGGCCAACGTCCTGACTTTC	CASSLLGTGGCKRSGANVLTF	TRBV5-4	TRBJ2-6
TGTGCCAGCAGCTCTTACGAACATCAGCCCCAGCATTTT	CASSSYEHQPQHF	TRBV13	TRBJ1-5
TGTGCCACCAGTGATTTGCATGGGAACGTCGCGAACACCGGGGAGCTGTTTTTT	CATSDLHGNVANTGELFF	TRBV24-1	TRBJ2-2
TGTGCCAGCAGTTTCCCGTCGGGGACTCCGGACGTTAGCTCTGGAAACACCATATATTTT	CASSFPSGTPDVSSGNTIYF	TRBV27	TRBJ1-3
TGTGCCAGCAGCCCCCACGACCGCGGGAGAATCGGCTACACCTTC	CASSPHDRGRIGYTF	TRBV14	TRBJ1-2
TGCGCCAGCAGCCCCCGACAGGGGAGACAGAATAATTCACCCCTCCACTTT	CASSPRQGRQNNSPLHF	TRBV5-1	TRBJ1-6
TGCAGTGCTAGGGTTCTACAGGGAGACCCTCCCTACGAGCAGTACTTC	CSARVLQGDPPYEQYF	TRBV20-1	TRBJ2-7
TGTGCCAGCAGTCCCCGACACACCGGGGAGCTGTTTTTT	CASSPRHTGELFF	TRBV12-3	TRBJ2-2
TGCAGTGCTAGGTGTGCTACTGAAGCTTTCTTT	CSARCATEAFF	TRBV20-1	TRBJ1-1
TGTGCCAGCAGCACAGGGATACCCACTGAAGCTTTCTTT	CASSTGIPTEAFF	TRBV6-4	TRBJ1-1
TGTGAAGTATGGGGCTCGGGCTATGGCTACACCTTC	CEVWGSGYGYTF	TRBV12-3	TRBJ1-2
TGTGCCAGCAGCGAGGGGAAAAACATTCAGTACTTC	CASSEGKNIQYF	TRBV27	TRBJ2-4
TGTGCGACATCGGATGCCTATAATTCACCCCTCCACTTT	CATSDAYNSPLHF	TRBV12-3	TRBJ1-6
TGCGCCAGCATGTCCAAAGACGAGGGAGATAGCAATCAGCCCCAGCATTTT	CASMSKDEGDSNQPQHF	TRBV10-1	TRBJ1-5
TGTGCCCGGAAGCGGACAGGGGGCAGCACTGAAGCTTTCTTT	CARKRTGGSTEAFF	TRBV19	TRBJ1-1
TGTGCCAGCAGCTCCCACGGGGACCCCCAGCTTGGGTTTAATCAGCCCCAGCATTTT	CASSSHGDPQLGFNQPQHF	TRBV25-1	TRBJ1-5
TGTGCCAGCAGTGTCTCCTCCTTGACGACGGGAGCTTTCTTT	CASSVSSLTTGAFF	TRBV6-5	TRBJ1-1
TGCAGCGTTGGCCGCTGTGAGCAGTTCTTC	CSVGRCEQFF	TRBV29-1	TRBJ2-1
TGTGCCAGCAGTGGGGCAACCCAGGGTACGTATAGCAATCAGCCCCAGCATTTT	CASSGATQGTYSNQPQHF	TRBV12-3	TRBJ1-5
TGTGCCAGCAGCTCGTCCAGGATGCACACTGAAGCTTTCTTT	CASSSSRMHTEAFF	TRBV7-8	TRBJ1-1
TGTGCCAGCAGTGGGACTGCAGCGAGTCAGCCCCAGCATTTT	CASSGTAASQPQHF	TRBV27	TRBJ1-5
TGTGCCAGCAGTGGACTAGCGGGAGGGGCCAAAAACATTCAGTACTTC	CASSGLAGGAKNIQYF	TRBV6-1	TRBJ2-4
TGTGCCAGCAGGTGGAACGAGAAGGCCTACGAGCAGTACTTC	CASRWNEKAYEQYF	TRBV6-5	TRBJ2-7
TGTGCCACCAGGTTCGGAGCTGGTCAGCCCCAGCATTTT	CATRFGAGQPQHF	TRBV24-1	TRBJ1-5
TGTGCCAGCAGCATCTCCGGGCAGCTGTTTTTT	CASSISGQLFF	TRBV7-2	TRBJ1-4
TGTGCCAGCAGCCGAAGGGGGTGTGGCTACACCTTC	CASSRRGCGYTF	TRBV11-1	TRBJ1-2
TGTGCCAGTAGTATCCGGGACAGGGAGGACGTCTACGAGCAGTACTTC	CASSIRDREDVYEQYF	TRBV19	TRBJ2-7
TGTGCCAGCAGCAGGAGAGGGGCGTGGTGTAGCAATCAGCCCCAGCATTTT	CASSRRGAWCSNQPQHF	TRBV6-4	TRBJ1-5
TGTGCCAGCAGCTTTGTGACGACAGCGGGACGAGCCACTGAAGCTTTCTTT	CASSFVTTAGRATEAFF	TRBV11-2	TRBJ1-1
TGCAGTGCTACTTGTCAAACGGAGGAGATGGGCTACGAGCAGTACTTC	CSATCQTEEMGYEQYF	TRBV20-1	TRBJ2-7
TGCGCCATAAGCAACTTCCCGGTGGGGGCGCTGGCTAGCACAGATACGCAGTATTTT	CAISNFPVGALASTDTQYF	TRBV5-1	TRBJ2-3
TGTGCCAGCAGCTTAGCGCCGCTTCTGAACACTGAAGCTTTCTTT	CASSLAPLLNTEAFF	TRBV7-8	TRBJ1-1
TGCGCCAGCAGCGGCCAGCCACGGGGGTATTTTAGGAACACTGAAGCTTTCTTT	CASSGQPRGYFRNTEAFF	TRBV5-1	TRBJ1-1
TGTGCCTCAGCGTCCGGAAACACCATATATTTT	CASASGNTIYF	TRBV30	TRBJ1-3
TGTGCCAGCAGCTTACTATCCGGGACTAGCGGGAGCTATCAGACCCAGTACTTC	CASSLLSGTSGSYQTQYF	TRBV7-7	TRBJ2-5
TGCGCCAGCAGCCTAATTCGGAAGAGCTCCTACGAGCAGTACTTC	CASSLIRKSSYEQYF	TRBV4-3	TRBJ2-7
TGCAGTGCTAAGGACAGGGGGCGGATTAGCAATCAGCCCCAGCATTTT	CSAKDRGRISNQPQHF	TRBV20-1	TRBJ1-5
TGTGCCAGCAGCTTAGACGGGAGGACAGGGAGAAAATGGACAAATTCACCCCTCCACTTT	CASSLDGRTGRKWTNSPLHF	TRBV11-3	TRBJ1-6
TGTGCCAGCAGCTTACGGGGGACAGGATCCTACAATGAGCAGTTCTTC	CASSLRGTGSYNEQFF	TRBV5-5	TRBJ2-1
TGTGCCAGTAGTATTAGGACAGAGATGAACACTGAAGCTTTCTTT	CASSIRTEMNTEAFF	TRBV19	TRBJ1-1
TGTGCCAGCAGTTTAACTACGAGGGGTGAAGGATACAATGAGCAGTTCTTC	CASSLTTRGEGYNEQFF	TRBV27	TRBJ2-1
TGTGCCAGCAGCCCAGGGGGCGTCTGGGTTAGGAACTATGGCTACACCTTC	CASSPGGVWVRNYGYTF	TRBV12-4	TRBJ1-2
TGTGCCACCAGCAGGGAGACTTTAGCGTGTTCTAACACCATATATTTT	CATSRETLACSNTIYF	TRBV15	TRBJ1-3
TGTGCCAGCAGCGGGACAATTTCTGAAGCTTTCTTT	CASSGTISEAFF	TRBV9	TRBJ1-1
TGTGCCCTCCACAGGGACAGCACAGATACGCAGTATTTT	CALHRDSTDTQYF	TRBV19	TRBJ2-3
TGTGCCAGCAGTTATCACCCAGCATCCTATCCTTTGCCCTCCTACAATGAGCAGTTCTTC	CASSYHPASYPLPSYNEQFF	TRBV6-9	TRBJ2-1
TGTGCCAGCCTGGGGGTCGGTCACTATGGCTACACCTTC	CASLGVGHYGYTF	TRBV2	TRBJ1-2
TGTGCCAGCACGAAGGGACCTTACGAGCAGTACTTC	CASTKGPYEQYF	TRBV12-4	TRBJ2-7
TGCGCCAGCAGCTCAAGACACGAGCAGTACTTC	CASSSRHEQYF	TRBV5-1	TRBJ2-7
TGTGCCAGACAAAGGGGGGCCCCACCGGGGAACACCGGGGAGCTGTTTTTT	CARQRGAPPGNTGELFF	TRBV2	TRBJ2-2
TGTGCCAGCAGGGCCGGGACAGGGCTCATGAACACTGAAGCTTTCTTT	CASRAGTGLMNTEAFF	TRBV6-4	TRBJ1-1
TGTGCCAGCCGGCGGAGGAGGAATGATACGCAGTATTTT	CASRRRRNDTQYF	TRBV6-5	TRBJ2-3
TGTGCCAGCAGCTCTAGCGGGAGGGCTAACGAGCAGTACTTC	CASSSSGRANEQYF	TRBV7-8	TRBJ2-7
TGTGCCAGCAGCTTAACGGGGGGGCAGAACAATGAGCAGTTCTTC	CASSLTGGQNNEQFF	TRBV11-2	TRBJ2-1
TGTGCCAGCAGCTCCCCCGGGGGGTTAACTAATGAAAAACTGTTTTTT	CASSSPGGLTNEKLFF	TRBV7-4	TRBJ1-4
TGCAGTGCTAGAGATTGGGACAGCAGGGGAAACACCATATATTTT	CSARDWDSRGNTIYF	TRBV20-1	TRBJ1-3
TGTGCCAGCTGTTCCAGGGCCTACACAGATACGCAGTATTTT	CASCSRAYTDTQYF	TRBV6-5	TRBJ2-3
TGTGCCAGCAGTTACCTTCGACAGGCAGAGACCCAGTACTTC	CASSYLRQAETQYF	TRBV6-5	TRBJ2-5
TGCGCCAGCAGCCAAGATCAGGAGGCACCTAACACTGAAGCTTTCTTT	CASSQDQEAPNTEAFF	TRBV4-1	TRBJ1-1
TGTGCCACCAAGCCGGACAGGCACAATGAGCAGTTCTTC	CATKPDRHNEQFF	TRBV24-1	TRBJ2-1
TGTGCTAGCAGCGTGGGACAGGGGAACTCAGACGCTGGGGCCAACGTCCTGACTTTC	CASSVGQGNSDAGANVLTF	TRBV7-7	TRBJ2-6
TGCAGTGCTAGAGATCCTCGTCAAGGGGAGACGGACAATCAGCCCCAGCATTTT	CSARDPRQGETDNQPQHF	TRBV20-1	TRBJ1-5
