TGTGCCAGCAGCACAGGGAGTAAAGGCTACACCTTC	CASSTGSKGYTF	TRBV11-3	TRBJ1-2
TGTGCCAGCAGCGTAGCGCACTTGAAACCCAGCCCAGGGGGACGTGACGAGCAGTACTTC	CASSVAHLKPSPGGRDEQYF	TRBV9	TRBJ2-7
TGCAGTGCTAGCGGACCTCAAGAGACCCAGTACTTC	CSASGPQETQYF	TRBV20-1	TRBJ2-5
TGTGCCAGCAGCGCGTCGGATAGCAATCAGCCCCAGCATTTT	CASSASDSNQPQHF	TRBV7-3	TRBJ1-5
TGTGCCAGCAGTGGTCAAGGACAGGGCCCAGATCTGAATTCACCCCTCCACTTT	CASSGQGQGPDLNSPLHF	TRBV2	TRBJ1-6
TGCGCCAGCAGCTTGGCACCAGGGAATCAAACTGGGGCCAACGTCCTGACTTTC	CASSLAPGNQTGANVLTF	TRBV5-1	TRBJ2-6
TGTGCCAGCAGCTTATATAGTGCAGGGGGCTTACTCTCCATACCTGAAGCTTTCTTT	CASSLYSAGGLLSIPEAFF	TRBV7-9	TRBJ1-1
TGTGCCAGCAGCGGACAGGGCTACGAGCAGTACTTC	CASSGQGYEQYF	TRBV13	TRBJ2-7
TGTGCCAGCAGCTTAGAAAAGAAGGGGCCAGGGGAAGGTTTACTCGGCTGTAATGAAAAACTGTTTTTT	CASSLEKKGPGEGLLGCNEKLFF	TRBV7-7	TRBJ1-4
TGTGCCAGCAGCTGGGCCCAAGAGACCCAGTACTTC	CASSWAQETQYF	TRBV7-4	TRBJ2-5
TGCGCCAGCAGCTTACCCCCCAAAGGACTTAACGCCAAAAACATTCAGTACTTC	CASSLPPKGLNAKNIQYF	TRBV5-1	TRBJ2-4
TGTGCCAGCTCACCACTCACCAGAATTAGCTATAATTCACCCCTCCACTTT	CASSPLTRISYNSPLHF	TRBV18	TRBJ1-6
TGCAGTGCTGTCGACAGGCTTTTAAAACTGTTTTTT	CSAVDRLLKLFF	TRBV20-1	TRBJ1-4
TGTGCCAGGAGCCATGCGGGTGGCTACACCTTC	CARSHAGGYTF	TRBV19	TRBJ1-2
TGCGCCAGTGTACAAGGGTCGCAGCCCCAGCATTTT	CASVQGSQPQHF	TRBV10-1	TRBJ1-5
TGTGCCAGCAGTAGGAGGCGCCAGTACCTAAGGAAAGGGGACCCCTCTGGGGCCAACGTCCTGACTTTC	CASSRRRQYLRKGDPSGANVLTF	TRBV6-6	TRBJ2-6
TGTGCCAGCAGCCAAGCCTATACAGGGTCTGACCCGGGCAATCAGCCCCAGCATTTT	CASSQAYTGSDPGNQPQHF	TRBV4-2	TRBJ1-5
TGTGCCAGCAAAAAGGACAGCCATTACTATGGCTACACCTTC	CASKKDSHYYGYTF	TRBV6-2	TRBJ1-2
TGTGCCAGCTCCCATGGACACGATGGTATAGCAGATACGCAGTATTTT	CASSHGHDGIADTQYF	TRBV18	TRBJ2-3
TGTGCCAGCAGCTTAGGAGGAAGGACACTGGACATTCAGTACTTC	CASSLGGRTLDIQYF	TRBV7-9	TRBJ2-4
TGTGCCACCGGGAGGCAAGGCTACACCTTC	CATGRQGYTF	TRBV24-1	TRBJ1-2
TGTGCCAGCCAACAAAGAAGGGGGGGGGCAAGCTATAGCAATCAGCCCCAGCATTTT	CASQQRRGGASYSNQPQHF	TRBV9	TRBJ1-5
TGTGCCACCACGCGGGAGATTTACTCCTACGAGCAGTACTTC	CATTREIYSYEQYF	TRBV12-4	TRBJ2-7
TGTGCCAGCAGCCGCAGTAGGCACGAGCAGTACTTC	CASSRSRHEQYF	TRBV14	TRBJ2-7
TGCGCCTCAAGCGGGGGAAGGGGGAGCTCCTACAATGAGCAGTTCTTC	CASSGGRGSSYNEQFF	TRBV10-2	TRBJ2-1
TGTGCCAGCAGAGGTGGGGGCCCCAAGCTGGAGTGTAGCGAGCAGTACTTC	CASRGGGPKLECSEQYF	TRBV11-2	TRBJ2-7
TGTGCCAGCAGTTCAGTAGTCAAGACCCAGTACTTC	CASSSVVKTQYF	TRBV6-5	TRBJ2-5
TGTGCCAGCAGCGGTCCGGGACGGCACTACGAGCAGTACTTC	CASSGPGRHYEQYF	TRBV11-2	TRBJ2-7
TGTGCCAGCAGCTTAGGAGGTTTAGCGGTTACCGGGTTTACCCTGGACGACTACAATGAGCAGTTCTTC	CASSLGGLAVTGFTLDDYNEQFF	TRBV7-9	TRBJ2-1
TGTGCCAGCATAACGTTGGGGGGCGGCTACCGGGAGCAGTACTTC	CASITLGGGYREQYF	TRBV28	TRBJ2-7
TGTGCCAGCAGCCAAACCCTCGTGGGGACAGGGGGTGAAGCTTTCTTT	CASSQTLVGTGGEAFF	TRBV14	TRBJ1-1
TGTGCCAGCAATACACCGAAACGCAATCAGCCCCAGCATTTT	CASNTPKRNQPQHF	TRBV6-6	TRBJ1-5
TGTGCCAGCAGTTTTTTTCGACTAGCGGGCAGGAAGGAAGAGACCCAGTACTTC	CASSFFRLAGRKEETQYF	TRBV27	TRBJ2-5
TGCGCCAGCAGCTTCAAGGGGGCGGGCGCATGTCAGCCCCAGCATTTT	CASSFKGAGACQPQHF	TRBV5-1	TRBJ1-5
TGTGCCAGCAGTGGTAGCCGGGGTTTAGAGACCCAGTACTTC	CASSGSRGLETQYF	TRBV6-1	TRBJ2-5
TGCAGTGCTGGTGTGTCACAGGGGCATAATCAGCCCCAGCATTTT	CSAGVSQGHNQPQHF	TRBV20-1	TRBJ1-5
TGTGCCTGGAGTGTAAGGCGTAATCAGCCCCAGCATTTT	CAWSVRRNQPQHF	TRBV30	TRBJ1-5
TGTGCCAGCAGTTACCCTAGCGGGGAGGGGCGGTGCTACGAGCAGTACTTC	CASSYPSGEGRCYEQYF	TRBV6-3	TRBJ2-7
TGTGCCAGTGGGGTCCTTGAGGGGAACGTCTTC	CASGVLEGNVF	TRBV19	TRBJ2-1
TGCGCCAGCAGCTTCCCATGGGGGGGAGGGAGAGCCTACGAGCAGTACTTC	CASSFPWGGGRAYEQYF	TRBV5-1	TRBJ2-7
TGTGCCACCTCAACTAGAGGCACAGATACGCAGTATTTT	CATSTRGTDTQYF	TRBV24-1	TRBJ2-3
TGCGCCAGCACACCTGGGACAGGGGTGGAGCAGCCCCAGCATTTT	CASTPGTGVEQPQHF	TRBV5-1	TRBJ1-5
TGTGCCAGCAGTTACATTCGGGACCCGACAGGCTCCTACGAGCAGTACTTC	CASSYIRDPTGSYEQYF	TRBV6-3	TRBJ2-7
TGTGCCAGCAGTTCGCGGTATCGTGTAACAGTAAACACCGGGGAGCTGTTTTTT	CASSSRYRVTVNTGELFF	TRBV6-5	TRBJ2-2
TGTGCCAGCAGCAACAGGAGGTTCCCAGATACGCAGTATTTT	CASSNRRFPDTQYF	TRBV9	TRBJ2-3
TGTGCCAGCCTCCAAAGGGGGCGACGTCTGCCTGGAAACACCATATATTTT	CASLQRGRRLPGNTIYF	TRBV6-4	TRBJ1-3
TGCAGCGTTGCGGCTCTAGCGGGCGCCTACAATGAGCAGTTCTTC	CSVAALAGAYNEQFF	TRBV29-1	TRBJ2-1
TGCAGCGTTGACATCTCCAACACTGAAGCTTTCTTT	CSVDISNTEAFF	TRBV29-1	TRBJ1-1
TGTGCCAGCAGCCCCTGGCCCTACGGGGTAGGGGACAGCACAGATACGCAGTATTTT	CASSPWPYGVGDSTDTQYF	TRBV13	TRBJ2-3
TGCGCCAGCAGCAGCCGGGACAGGTGCTGCACAGATACGCAGTATTTT	CASSSRDRCCTDTQYF	TRBV5-1	TRBJ2-3
TGCGCCAGCAGCAAGGTTCCTAGCGGGTTGAATGAGCAGTTCTTC	CASSKVPSGLNEQFF	TRBV5-1	TRBJ2-1
TGTGCCATCAGTCCGGGACTGAACACTGAAGCTTTCTTT	CAISPGLNTEAFF	TRBV10-3	TRBJ1-1
TGTGCCCCCCGCGCCTCCCAGAGCTCCTACAATGAGCAGTTCTTC	CAPRASQSSYNEQFF	TRBV10-3	TRBJ2-1
TGTGCCTGGAGTGTCCGACTAGCGGGCGGGACCTACAATGAGCAGTTCTTC	CAWSVRLAGGTYNEQFF	TRBV30	TRBJ2-1
TGTGCCAGCAGTTACGCCCCTAGGGGAAATCAGCCCCAGCATTTT	CASSYAPRGNQPQHF	TRBV6-3	TRBJ1-5
TGTGCCTTTTTCCCCTCACTAGCGGGAGGGCGCGAGCAGTACTTC	CAFFPSLAGGREQYF	TRBV6-6	TRBJ2-7
TGTGCCAGCAGAGCCACAGGGGGCGGGGAGCTGTTTTTT	CASRATGGGELFF	TRBV27	TRBJ2-2
TGTGCCAGCAGCGGGTTAGAGATGAGTTACAATGAGCAGTTCTTC	CASSGLEMSYNEQFF	TRBV6-4	TRBJ2-1
TGTGCCAGCAGCACTAAGGACAGTTGTGATTGCTGCAAGAACACTGAAGCTTTCTTT	CASSTKDSCDCCKNTEAFF	TRBV6-2	TRBJ1-1
TGCGCCAGCAGTATCCTAGCGGGGATTATCTACGAGCAGTACTTC	CASSILAGIIYEQYF	TRBV10-2	TRBJ2-7
TGTGCCAGCAGTGTCGGGGGAGCAATGCAGCCCCAGCATTTT	CASSVGGAMQPQHF	TRBV28	TRBJ1-5
TGTGCCAGCCCCGGCCGGGACAGGGGGTTCATGAACACTGAAGCTTTCTTT	CASPGRDRGFMNTEAFF	TRBV9	TRBJ1-1
TGTGCCAGCAGCCGACAGGCTTACACTGAAGCTTTCTTT	CASSRQAYTEAFF	TRBV13	TRBJ1-1
TGTGCCTGGAGAGGTGACAGGAGGGCCTACGAGCAGTACTTC	CAWRGDRRAYEQYF	TRBV30	TRBJ2-7
TGTGCCAGCAGCCTGCGGGCCGGGCATCAGTACAATGAGCAGTTCTTC	CASSLRAGHQYNEQFF	TRBV7-3	TRBJ2-1
TGCAGTGCTAGAGGGACGGGGGCCCCATACAATGAGCAGTTCTTC	CSARGTGAPYNEQFF	TRBV20-1	TRBJ2-1
TGTGCCAGCAGCTTAGTAATAGGGGAGAGCGGCTACACCTTC	CASSLVIGESGYTF	TRBV7-2	TRBJ1-2
TGTGCCAGCAGCCAGACAGGGGACCAAGAGACCCAGTACTTC	CASSQTGDQETQYF	TRBV6-1	TRBJ2-5
TGTGCCTGGAGTGTACTTTACAGGGACGAGGTTCGCTACGAGCAGTACTTC	CAWSVLYRDEVRYEQYF	TRBV30	TRBJ2-7
TGTGCTAGTGGTTGGCGGGGGGAAAATCAGCCCCAGCATTTT	CASGWRGENQPQHF	TRBV12-5	TRBJ1-5
TGTGCCATCAGTGGTTGGGGGCTTCGTGAGGACTATGGCTACACCTTC	CAISGWGLREDYGYTF	TRBV10-3	TRBJ1-2
TGTGCCAGCAGTGGAATCAACCCTCCGACAGGGAGGACCATCTCCTACGAGCAGTACTTC	CASSGINPPTGRTISYEQYF	TRBV6-4	TRBJ2-7
TGTGCCAGCAGTGAACACCCAGGGGCCAAGGGTAATTCACCCCTCCACTTT	CASSEHPGAKGNSPLHF	TRBV2	TRBJ1-6
TGCAGTGCTAGTAAAGGGAGGGTGGGTATTGGCTACGAGCAGTACTTC	CSASKGRVGIGYEQYF	TRBV20-1	TRBJ2-7
TGTGCCAGCAGCAGGGGGCTAGCGGGACCGGGCTCCTACGAGCAGTACTTC	CASSRGLAGPGSYEQYF	TRBV27	TRBJ2-7
TGTGCCAGCAGCCAAGTCATTCAGGGGGGAAACACCATATATTTT	CASSQVIQGGNTIYF	TRBV14	TRBJ1-3
TGTGCCAGCACCCGTTCGGGAGGGGGCGCTGCAACTAATGAAAAACTGTTTTTT	CASTRSGGGAATNEKLFF	TRBV25-1	TRBJ1-4
TGTGCCAGCAGCTGGGACACGCTCACTGAAGCTTTCTTT	CASSWDTLTEAFF	TRBV7-7	TRBJ1-1
TGTGCCAGCGCCGCCAGGGGCCCCCCCGCTTCAACCTACGAGCAGTACTTC	CASAARGPPASTYEQYF	TRBV6-4	TRBJ2-7
TGTGCCAGCAGCTTAGTGAGGGGGACTGAAGCTTTCTTT	CASSLVRGTEAFF	TRBV7-2	TRBJ1-1
TGTGCCAGCTGCGGGACAGGCAATCAGCCCCAGCATTTT	CASCGTGNQPQHF	TRBV6-4	TRBJ1-5
TGTGCCAGCAGCCAAGACTGGACGGGGGACGAGCAGTACTTC	CASSQDWTGDEQYF	TRBV4-2	TRBJ2-7
TGTGCCAGCAGCTTAGACCTTGGGACAGGGGAAAAACTGTTTTTT	CASSLDLGTGEKLFF	TRBV11-3	TRBJ1-4
TGTGCCAGCAGGTGGAGCGGAGAGACAGCATTATACAATGAGCAGTTCTTC	CASRWSGETALYNEQFF	TRBV3-1	TRBJ2-1
TGTGCCAGCACAGTCGGGTCTGGAAACACCATATATTTT	CASTVGSGNTIYF	TRBV6-2	TRBJ1-3
TGTGCCAGCAGTTACTCGATAGGGGGTGAGACCCAGTACTTC	CASSYSIGGETQYF	TRBV6-5	TRBJ2-5
TGCAGCGTTGAAGCCCCCGCGACACGGACCAATCAGCCCCAGCATTTT	CSVEAPATRTNQPQHF	TRBV29-1	TRBJ1-5
TGTGCCAGCAGCTCCAAGTTCTGGGGACTAGCGGGGAATGAGCAGTTCTTC	CASSSKFWGLAGNEQFF	TRBV13	TRBJ2-1
TGTGCCAGCAGGACAGGGACACTTTACGAGCAGTACTTC	CASRTGTLYEQYF	TRBV2	TRBJ2-7
TGTGCCAGTCCGGGACAGAAGGAAAAACTGTTTTTT	CASPGQKEKLFF	TRBV11-2	TRBJ1-4
TGTGCCAGCAGCCAGCCGCCCCCCCCCTGGGACAGGGGGATACAAGAGACCCAGTACTTC	CASSQPPPPWDRGIQETQYF	TRBV13	TRBJ2-5
TGTGCCAGTAAGGGACCTATCGGGACAGGATACGAGCAGTACTTC	CASKGPIGTGYEQYF	TRBV11-3	TRBJ2-7
TGCGCCAGCAGCTTGCGTGTACAGGGAGTTAGCTACGAGCAGTACTTC	CASSLRVQGVSYEQYF	TRBV5-1	TRBJ2-7
TGCGCCAGCAGCTGGGCCCCAGGGACTGATCAGCCCCAGCATTTT	CASSWAPGTDQPQHF	TRBV5-1	TRBJ1-5
TGTGCCAGCATCCTGGGGGCGGACACTGAAGCTTTCTTT	CASILGADTEAFF	TRBV28	TRBJ1-1
TGCGCCAGCAGCTTGGCCCCGGACAGGGTTAGGGCGAACACCGGGGAGCTGTTTTTT	CASSLAPDRVRANTGELFF	TRBV5-1	TRBJ2-2
TGTGCCAGCAGTAATCCGGGACAGAGTTCTGGAAACACCATATATTTT	CASSNPGQSSGNTIYF	TRBV6-5	TRBJ1-3
TGTGCCAGCAGTGATTCCCTGGGAATCTCACCCCTCCACTTT	CASSDSLGISPLHF	TRBV6-1	TRBJ1-6
TGTGCCAGCAGCCTTGGGAATTCACCCCTCCACTTT	CASSLGNSPLHF	TRBV14	TRBJ1-6
TGTGCTAGTGGTTTGGTAGGGGGCGACAGGGACATCAATCCGGACGAGCAGTACTTC	CASGLVGGDRDINPDEQYF	TRBV12-5	TRBJ2-7
