TGTGCCAGCAGCACCCCCGTGGCCAAAAACATTCAGTACTTC	CASSTPVAKNIQYF	TRBV14	TRBJ2-4
TGCAGTCCAGGGCAGGGATTGAGACGTTACGAGCAGTACTTC	CSPGQGLRRYEQYF	TRBV20-1	TRBJ2-7
TGCGCCAGCATTGACTGGGAGCGGGGTCCCCAGCATTTT	CASIDWERGPQHF	TRBV10-2	TRBJ1-5
TGTGCCAGCAGTGACCCGGCAGGGGCAAGGCGCTCCTACGAGCAGTACTTC	CASSDPAGARRSYEQYF	TRBV6-1	TRBJ2-7
TGCGCCAGCAGCTTGCGTGCTTACTGCCGACTCTCCTACGAGCAGTACTTC	CASSLRAYCRLSYEQYF	TRBV5-1	TRBJ2-7
TGTGCCAGCAGCTTGTGGGGGGAGGATCAGCCCCAGCATTTT	CASSLWGEDQPQHF	TRBV7-6	TRBJ1-5
TGTGCCAGCAGCAATACGTACCTGGGGCAACCATATGAAAAACTGTTTTTT	CASSNTYLGQPYEKLFF	TRBV3-1	TRBJ1-4
TGTGCCAGCAGTGACACGACGTCCGGGGCCTATCAGCCCCAGCATTTT	CASSDTTSGAYQPQHF	TRBV6-4	TRBJ1-5
TGTGCCAGCAGCGTAGATGGGACAGGGGGGGCCCCCGGGGAGCTGTTTTTT	CASSVDGTGGAPGELFF	TRBV9	TRBJ2-2
TGTGCCAGCAGTTACGAAGCTGACAGGTACGAGCAGTACTTC	CASSYEADRYEQYF	TRBV6-5	TRBJ2-7
TGCGCCAGGAAACTAGTGAATCACAATGAGCAGTTCTTC	CARKLVNHNEQFF	TRBV10-1	TRBJ2-1
TGTGCCAGCAGGTGGGGTATTGGAACCTATGGCTACACCTTC	CASRWGIGTYGYTF	TRBV6-1	TRBJ1-2
TGTGCCAGGGAACTAGGGTACAATGAGCAGTTCTTC	CARELGYNEQFF	TRBV19	TRBJ2-1
TGTGCCAGAGGCCCCGAAGGGGAACCCCTAGATGGCACAGATACGCAGTATTTT	CARGPEGEPLDGTDTQYF	TRBV10-3	TRBJ2-3
TGTGCCAGCAGCCAAGATATCCTCCCCCGGAGACAGGGCCATTTGGGCTATGGCTACACCTTC	CASSQDILPRRQGHLGYGYTF	TRBV14	TRBJ1-2
TGTGCCCTCTATAAAGAGACCCAGTACTTC	CALYKETQYF	TRBV27	TRBJ2-5
TGTGCCAGCAGCCCCTGGGGTATCGGGGCAACTAATGAAAAACTGTTTTTT	CASSPWGIGATNEKLFF	TRBV13	TRBJ1-4
TGTGCCAGCAGCCGTAAGACAGCGACTGATGGAAACACCATATATTTT	CASSRKTATDGNTIYF	TRBV7-4	TRBJ1-3
TGCGCCAGCCTTATAGCGGTAGGCGACCAAGCCTACGAGCAGTACTTC	CASLIAVGDQAYEQYF	TRBV10-2	TRBJ2-7
TGTGCCAGCAGCGATCCCCACAGGGAGGACACTGAAGCTTTCTTT	CASSDPHREDTEAFF	TRBV13	TRBJ1-1
TGTGCCACGAAGCCCTTTAGGTGCAATCAGCCCCAGCATTTT	CATKPFRCNQPQHF	TRBV5-5	TRBJ1-5
TGTGCCAGCAGTTCCCAGGGGGGCTACACCTTC	CASSSQGGYTF	TRBV27	TRBJ1-2
TGTGCCAGCAGTCCCTCCTCCCGACTAGCGGGTTTGGAGCAGTACTTC	CASSPSSRLAGLEQYF	TRBV2	TRBJ2-7
TGTGCCAGCAAGTCAGCGCTTTTCTACGAGCAGTACTTC	CASKSALFYEQYF	TRBV6-2	TRBJ2-7
TGCAGCTGCTTAGGACAGGGGGGGGGCGAGCAGTACTTC	CSCLGQGGGEQYF	TRBV29-1	TRBJ2-7
TGTGCCAGCAGCCAAGTTCAGGGCAGTGAAGCTTTCTTT	CASSQVQGSEAFF	TRBV4-2	TRBJ1-1
TGTGCCACCAGTGCCAGGGGGCACCACCTGGACTATGGCTACACCTTC	CATSARGHHLDYGYTF	TRBV24-1	TRBJ1-2
TGCGCCAGCAGCTCCGTGACAGCGAGGACAAACTCTGGGGCCAACGTCCTGACTTTC	CASSSVTARTNSGANVLTF	TRBV5-1	TRBJ2-6
TGTGCCAGCAGTTTCTTAAATTCCCAGGGACCCCACACTGAAGCTTTCTTT	CASSFLNSQGPHTEAFF	TRBV27	TRBJ1-1
TGTGCCACCAGTGATAAGGGGGGGTATAGCAATCAGCCCCAGCATTTT	CATSDKGGYSNQPQHF	TRBV24-1	TRBJ1-5
TGTGCCAGCTCACAATCCCTATTTACAGGGACAGATACGCAGTATTTT	CASSQSLFTGTDTQYF	TRBV18	TRBJ2-3
TGCAGCGTTGGCAAACACGACAAAAACATTCAGTACTTC	CSVGKHDKNIQYF	TRBV29-1	TRBJ2-4
TGTGCCAGCAGCTATGGGAGCGGGATCAACGAGCAGTACTTC	CASSYGSGINEQYF	TRBV7-6	TRBJ2-7
TGTGCCAGCAGCTATCCCAAGGGCACCAGCAATCAGCCCCAGCATTTT	CASSYPKGTSNQPQHF	TRBV9	TRBJ1-5
TGTGCCAGCCCGGGACAGGGGGTGTATAATGAAAAACTGTTTTTT	CASPGQGVYNEKLFF	TRBV6-4	TRBJ1-4
TGTGCTATACCGGGACAAAATGAGATAAAACTGTTTTTT	CAIPGQNEIKLFF	TRBV12-5	TRBJ1-4
TGTGCCAGCACGGAAGGGACTTTCCACTACAATGAGCAGTTCTTC	CASTEGTFHYNEQFF	TRBV28	TRBJ2-1
TGCAGCGTTGAAAAACTCCCTAGCGGGCACTACGAGCAGTACTTC	CSVEKLPSGHYEQYF	TRBV29-1	TRBJ2-7
TGTGCCAGCACTCAGGGTAGGCAGCCCCAGCATTTT	CASTQGRQPQHF	TRBV27	TRBJ1-5
TGTGCCAGCAGTTTTCAGAAGGTTGACACTAGCACCGGGGAGCTGTTTTTT	CASSFQKVDTSTGELFF	TRBV12-4	TRBJ2-2
TGCGGTCCCGAAAAGGAGATCAGCACCGGGGAGCTGTTTTTT	CGPEKEISTGELFF	TRBV6-1	TRBJ2-2
TGCGCCAGCACCCCTAGGAGGGTGGGGGGGAACACTGAAGCTTTCTTT	CASTPRRVGGNTEAFF	TRBV10-1	TRBJ1-1
TGTGCCAAAACCGGGGACTCTGGGGCCAACGTCCTGACTTTC	CAKTGDSGANVLTF	TRBV10-3	TRBJ2-6
TGTGCCAGCAGTCACGGCCGGGACGAGGCCAAAAACATTCAGTACTTC	CASSHGRDEAKNIQYF	TRBV6-1	TRBJ2-4
TGTGCTAGTGGTTACCGGGACAGAAACTACGAGCAGTACTTC	CASGYRDRNYEQYF	TRBV12-5	TRBJ2-7
TGCGCCAGCAGCTTCCCCGAGGCCTATCCTCTAAGCTCCTACGAGCAGTACTTC	CASSFPEAYPLSSYEQYF	TRBV5-1	TRBJ2-7
TGTGCCAGCAGCAGGGGGGATGAAGCTTTCTTT	CASSRGDEAFF	TRBV7-9	TRBJ1-1
TGTGTCCCCGGGGGAGGAGAGCAGTTCTTC	CVPGGGEQFF	TRBV24-1	TRBJ2-1
TGCGCCAGCTTTGGCGGGGGTGGGAGCTCCTACGAGCAGTACTTC	CASFGGGGSSYEQYF	TRBV10-1	TRBJ2-7
TGTGCCAGCAGGACAGGGGACTTCGGCTACACCTTC	CASRTGDFGYTF	TRBV2	TRBJ1-2
TGTGCCAGCAGTGCTGACGGTCAGGCGCGCTATGGCTACACCTTC	CASSADGQARYGYTF	TRBV11-3	TRBJ1-2
TGTGCCAGCAGCTTCCGAGTGCAGCCCCAGCATTTT	CASSFRVQPQHF	TRBV11-2	TRBJ1-5
TGTGCCAGCTCAGGTGCAAGAAAAAGGGGGGCGAACACTGAAGCTTTCTTT	CASSGARKRGANTEAFF	TRBV6-2	TRBJ1-1
TGCAGTGCTAGAGATCCCCGGGGATTCGCCGAAGCTTTCTTT	CSARDPRGFAEAFF	TRBV20-1	TRBJ1-1
TGCGCCAGCAGCTTCGGGTTCGGGCCAAATTTGTTGAACACTGAAGCTTTCTTT	CASSFGFGPNLLNTEAFF	TRBV5-1	TRBJ1-1
TGTGCCAGCAGCCCCCCCGGAATAATGGGGATCGGCAAGGGGGAGACCCAGTACTTC	CASSPPGIMGIGKGETQYF	TRBV7-2	TRBJ2-5
TGTGCCAGCAGCTATTACAGGGGGATTCAGGAAAAACTGTTTTTT	CASSYYRGIQEKLFF	TRBV11-2	TRBJ1-4
TGTGCCAGCAGCTTAGGTGGGACGTGCATTCAGTACTTC	CASSLGGTCIQYF	TRBV7-4	TRBJ2-4
TGTGCCAGCAGCCGTTACCAGGGGGTATTGGCCGGGTACAATGAGCAGTTCTTC	CASSRYQGVLAGYNEQFF	TRBV9	TRBJ2-1
TGTGCCAGCAGTTTAAGCGGTAACAATGAGCAGTTCTTC	CASSLSGNNEQFF	TRBV12-4	TRBJ2-1
TGCAGCGTTGTAGACAGGGGGCCCGAGGCTGGCTACACCTTC	CSVVDRGPEAGYTF	TRBV29-1	TRBJ1-2
TGCGCCAGCAGTGAATGGGAAAAAGGCACCGGGGAGCTGTTTTTT	CASSEWEKGTGELFF	TRBV10-1	TRBJ2-2
TGCAGCCCCCATTCTAAGAAACTAGCTAACTATGGCTACACCTTC	CSPHSKKLANYGYTF	TRBV29-1	TRBJ1-2
TGTGCCAGCAGCCCGTGGTGGGGGGCCCTGATGAATGAGCAGTTCTTC	CASSPWWGALMNEQFF	TRBV11-2	TRBJ2-1
TGTGCCAGCACCCGAGGAGGGGACAGGGGGGGTGATGGTTTACGCGCTGGAAACACCATATATTTT	CASTRGGDRGGDGLRAGNTIYF	TRBV2	TRBJ1-3
TGCGCCATTAGACAGGGGGGCTACTCTGGAAACACCATATATTTT	CAIRQGGYSGNTIYF	TRBV10-1	TRBJ1-3
TGTGCCTTGCAGGGACAGTTAGCGAGCTCCTACGAGCAGTACTTC	CALQGQLASSYEQYF	TRBV24-1	TRBJ2-7
TGCGCCACCGTCGGGGTGTCCTACAATGAGCAGTTCTTC	CATVGVSYNEQFF	TRBV10-1	TRBJ2-1
TGTGCCAGCAGAACCACCCGGAGGCAGAGCCTCGCCTATAATTCACCCCTCCACTTT	CASRTTRRQSLAYNSPLHF	TRBV13	TRBJ1-6
TGTGCCAGCGAGATCCTCTGGACAGGGTGGGCCCCGGGAGAAAAACTGTTTTTT	CASEILWTGWAPGEKLFF	TRBV7-9	TRBJ1-4
TGTGCCTGGAGTGGGTCAACGACCTCTGGAAACACCATATATTTT	CAWSGSTTSGNTIYF	TRBV30	TRBJ1-3
TGTGCCAGCACCCTGGGGGCGATCTCTGGAAACACCATATATTTT	CASTLGAISGNTIYF	TRBV28	TRBJ1-3
TGTGCCACCAGCAGAGATGGACCCTCCCCCCAAGAGACCCAGTACTTC	CATSRDGPSPQETQYF	TRBV15	TRBJ2-5
TGTGCCAGCAGCTTAGAAGCGGGACGGAGGGGGTACGAGCAGTACTTC	CASSLEAGRRGYEQYF	TRBV7-9	TRBJ2-7
TGTGCCAGCAGCCGAGTGGGACCGGAGGCTAGCACAGATACGCAGTATTTT	CASSRVGPEASTDTQYF	TRBV9	TRBJ2-3
TGCGCCAGCAGCTTTACGGACAGGGATGGAAAGTACTACGAGCAGTACTTC	CASSFTDRDGKYYEQYF	TRBV5-1	TRBJ2-7
TGTGCCTGGAGCCGTAGCTTGACCTGTGAGAATGAAAAACTGTTTTTT	CAWSRSLTCENEKLFF	TRBV30	TRBJ1-4
TGTGCCAGCTCACCATCCTCATTTACCTGCGCCAAGCCCCAGCATTTT	CASSPSSFTCAKPQHF	TRBV18	TRBJ1-5
TGTGCCAGCAGCGGGGGGGAGACAGAGACCCAGTACTTC	CASSGGETETQYF	TRBV6-1	TRBJ2-5
TGTGCCAGCAGCCCCCTCACCCCGGGGACAAGCTACTTC	CASSPLTPGTSYF	TRBV7-6	TRBJ2-4
TGCGCCAGCAGTGAGACAGCGCCTAGCGGGGGAACTTGCACAGATACGCAGTATTTT	CASSETAPSGGTCTDTQYF	TRBV10-2	TRBJ2-3
TGTGCCAGCAGCTACGGGGCAGATGCCTACAATGAGCAGTTCTTC	CASSYGADAYNEQFF	TRBV5-4	TRBJ2-1
TGTGCCAGCAGCTCTTTCGGTCCTGACAGCACTGAAGCTTTCTTT	CASSSFGPDSTEAFF	TRBV13	TRBJ1-1
TGTGCCAGCAGCGTCCCTTGGCAGGGGTCAGGAAACACCGGGGAGCTGTTTTTT	CASSVPWQGSGNTGELFF	TRBV7-3	TRBJ2-2
TGTGCCAGCAGCCGAGACCCTTATAATTCACCCCTCCACTTT	CASSRDPYNSPLHF	TRBV6-4	TRBJ1-6
TGTGCCAGCAGATTAGTAGAAGCGGCATCTGGGGCCAACGTCCTGACTTTC	CASRLVEAASGANVLTF	TRBV9	TRBJ2-6
TGTGCCAGCAGTGTGTTTTCGGCTGGATTAACCAGAGCCTACGAGCAGTACTTC	CASSVFSAGLTRAYEQYF	TRBV6-4	TRBJ2-7
TGCGCCAGAAATCCAGGGAATCCTGGAGAAAAACTGTTTTTT	CARNPGNPGEKLFF	TRBV5-1	TRBJ1-4
TGCGCCGTCAAGGAGGCGGATTACAATGAGCAGTTCTTC	CAVKEADYNEQFF	TRBV20-1	TRBJ2-1
TGCGCCAGCAGCTTGCTGGGCGAGCAGTACTTC	CASSLLGEQYF	TRBV5-1	TRBJ2-7
TGTGCCAGCAGCTTAGAAGAGGGCAGGTACGAGCAGTACTTC	CASSLEEGRYEQYF	TRBV11-3	TRBJ2-7
TGCGCCAGCAGCGTCCGGGGGTACACAGATACGCAGTATTTT	CASSVRGYTDTQYF	TRBV5-1	TRBJ2-3
TGTGCCAGCAGCTTTCACAGGGGCAATCAGCCCCAGCATTTT	CASSFHRGNQPQHF	TRBV5-6	TRBJ1-5
TGCGCCAGCAGAATTTCGGGACTAGCGGGTTGCACAGATACGCAGTATTTT	CASRISGLAGCTDTQYF	TRBV5-1	TRBJ2-3
TGTGCCAGCAGCTTAGATTTGCGCCAGTTAGGCGGGGTGTTTCACGAGCAGTACTTC	CASSLDLRQLGGVFHEQYF	TRBV11-3	TRBJ2-7
TGCGCCAGCATTCCCATACAGGGGGTGGAGCAGTACTTC	CASIPIQGVEQYF	TRBV5-1	TRBJ2-7
TGCAGTGCTAGAGCCAGGCCGCAGGGCGGACGGGAGACCGCTAGCGAGTACTTC	CSARARPQGGRETASEYF	TRBV20-1	TRBJ2-4
TGCGCCACGCGGGAGGTCGGGGAGGCTAGCACAGATACGCAGTATTTT	CATREVGEASTDTQYF	TRBV5-1	TRBJ2-3
TGTGCCAGCAGTGCGTGGAGAGGGAGAGATACGCAGTATTTT	CASSAWRGRDTQYF	TRBV6-4	TRBJ2-3
TGTGCCAGCAGTTACTCCAACCGGGGACAAAGGGTTGGGGAGCTGTTTTTT	CASSYSNRGQRVGELFF	TRBV6-5	TRBJ2-2
