TGTGCCAGCAGCTTAGACTTCGTGGGACAGGGTTTGGGTTTACAGCCCCAGCATTTT	CASSLDFVGQGLGLQPQHF	TRBV7-9	TRBJ1-5
TGTGCCAGCAGCATCCGGGGGGGCCCGTCAGGTCGGGAGACCCAGTACTTC	CASSIRGGPSGRETQYF	TRBV11-3	TRBJ2-5
TGTGCCACCAGTGATTCATGGGGGGCAGTCAATGGAAACACCATATATTTT	CATSDSWGAVNGNTIYF	TRBV24-1	TRBJ1-3
TGTGCCAGCAGCGCAAGCTGGGGGCCGTACTTC	CASSASWGPYF	TRBV9	TRBJ2-7
TGCGCCAGCAGACGGACTGAGGAAGATACGCAGTATTTT	CASRRTEEDTQYF	TRBV5-1	TRBJ2-3
TGTGCCAGCAAACCCATAACGCTAGAGCAGTACTTC	CASKPITLEQYF	TRBV6-5	TRBJ2-7
TGTGCCAGCAGAGCGAAGGGCTACGAGCAGTACTTC	CASRAKGYEQYF	TRBV2	TRBJ2-7
TGCGCCAGCAGCCACGACACGGGGGGGGGCCTTGTACCGGCCTACGAGCAGTACTTC	CASSHDTGGGLVPAYEQYF	TRBV4-1	TRBJ2-7
TGCGCCAGCAGCTTGCCCTCCAGGAAAAGAGAAAAACTGTTTTTT	CASSLPSRKREKLFF	TRBV5-1	TRBJ1-4
TGTGCCAGCCAAGGGCAAGGGGAGGACTCTGGAAACACCATATATTTT	CASQGQGEDSGNTIYF	TRBV2	TRBJ1-3
TGCGCCAGCAGCTGGTTAGCACCCGATGAGCAGTTCTTC	CASSWLAPDEQFF	TRBV5-1	TRBJ2-1
TGTGCCAGCAGCCAAGTTCCCGACAGGGTTTCCTACGAGCAGTACTTC	CASSQVPDRVSYEQYF	TRBV7-8	TRBJ2-7
TGTGCCAGCAGCAGCGATAGACTATGCGTTCAGGACACCGGGGAGCTGTTTTTT	CASSSDRLCVQDTGELFF	TRBV5-4	TRBJ2-2
TGCAGTGCTAGGGAAGTATCCTCTGTTCAATACACCGGCCACTATGGCTACACCTTC	CSAREVSSVQYTGHYGYTF	TRBV20-1	TRBJ1-2
TGCGCCAGCAGCCGCCAGTCCCAGACCGCTTTCTTT	CASSRQSQTAFF	TRBV4-3	TRBJ1-1
TGTGCCAGCACACGGGACCGGTATAGGAATGAGCAGTTCTTC	CASTRDRYRNEQFF	TRBV5-6	TRBJ2-1
TGTGCCAGCAGTGAAGCAAACGACAGGGGGAACAATGAGCAGTTCTTC	CASSEANDRGNNEQFF	TRBV6-1	TRBJ2-1
TGCGCCAGCAGCCAACTTCCTGACTCCTACGAGCAGTACTTC	CASSQLPDSYEQYF	TRBV4-3	TRBJ2-7
TGCAGTGGAGGGGACAATCAGCCCCAGCATTTT	CSGGDNQPQHF	TRBV20-1	TRBJ1-5
TGTGCCAGCTCAAGGTCCGGGACAGGGGAAGTGGGCTACACCTTC	CASSRSGTGEVGYTF	TRBV18	TRBJ1-2
TGTGCCAGCAGTGAGAATGGAACAGGGGGGATGAACACTGAAGCTTTCTTT	CASSENGTGGMNTEAFF	TRBV2	TRBJ1-1
TGTGCCAGCAGCCCTAGGACAGGGGATGATACGCAGTATTTT	CASSPRTGDDTQYF	TRBV27	TRBJ2-3
TGTGCCACCAGTGATTCTTGGACAGGGCTACTAGGGTCACCCCTCCACTTT	CATSDSWTGLLGSPLHF	TRBV24-1	TRBJ1-6
TGTGCCAGCAGCCCGTTGGACCCAGAAGCCTACGAGCAGTACTTC	CASSPLDPEAYEQYF	TRBV9	TRBJ2-7
TGTGCCAGTAGACCCCCATCACCGGGACAGCGCAATCAGCCCCAGCATTTT	CASRPPSPGQRNQPQHF	TRBV19	TRBJ1-5
TGTGCCACCAGTGATTTCTATGGACAGGGCCGTCACAGAATGCAGCCCCAGCATTTT	CATSDFYGQGRHRMQPQHF	TRBV24-1	TRBJ1-5
TGTGCTAGCAGCTTAACGGACAGTTATCAGCCCCAGCATTTT	CASSLTDSYQPQHF	TRBV7-7	TRBJ1-5
TGTGCCAGCAGCTTCGGGGGTGACAATGAGCAGTTCTTC	CASSFGGDNEQFF	TRBV13	TRBJ2-1
TGTGCCAGCTCACCTAGGAAGGTAGATACAGATACGCAGTATTTT	CASSPRKVDTDTQYF	TRBV18	TRBJ2-3
TGTGCCAGCAGTTTGTCCACCGGCCTTGGGTCCTACGAGCAGTACTTC	CASSLSTGLGSYEQYF	TRBV28	TRBJ2-7
TGTGCCACCTGGGGGGGGGCAACGACCTACGAGCAGTACTTC	CATWGGATTYEQYF	TRBV7-9	TRBJ2-7
TGCAGCGTTGATCAAGGGAGGGAAAGAGAGACCCAGTACTTC	CSVDQGRERETQYF	TRBV29-1	TRBJ2-5
TGTGCCAGCAGTTTACAGGGCCGGTCTGGAAACACCATATATTTT	CASSLQGRSGNTIYF	TRBV27	TRBJ1-3
TGTGCCAAATGGTCTAGCACAGATACGCAGTATTTT	CAKWSSTDTQYF	TRBV6-4	TRBJ2-3
TGTGCCAGCAGTGAAGAGTCGAAGGACAGGGGATTGCAGCCCCAGCATTTT	CASSEESKDRGLQPQHF	TRBV6-5	TRBJ1-5
TGTGCCAGCAGCCCAGGCCGTCCGCGCCGAGAAAAACTGTTTTTT	CASSPGRPRREKLFF	TRBV7-2	TRBJ1-4
TGTGCCAGCAGCTTAGCGAAAAGGACTAGGGGAACGGATGAGCAGTTCTTC	CASSLAKRTRGTDEQFF	TRBV7-9	TRBJ2-1
TGTGCCAGCACGGTAGGGTACAATGAGCAGTTCTTC	CASTVGYNEQFF	TRBV6-3	TRBJ2-1
TGTGCCAGCAGCCCGGAGGTCTACGAGCAGTACTTC	CASSPEVYEQYF	TRBV3-1	TRBJ2-7
TGTGCCAGCAGTTACGGACAGGGACTAACCTCCTATAATTCACCCCTCCACTTT	CASSYGQGLTSYNSPLHF	TRBV6-2	TRBJ1-6
TGTGCCCTCCCCAGTCGATACGAGCAGTACTTC	CALPSRYEQYF	TRBV19	TRBJ2-7
TGTGCCAGCAGCTCCCGTCCAGGGGGGGGCGGCCCCGGGGAGCTGTTTTTT	CASSSRPGGGGPGELFF	TRBV7-3	TRBJ2-2
TGTGCCAGCAGCTTCCTAGTGACTCCCTCCTACGAGCAGTACTTC	CASSFLVTPSYEQYF	TRBV5-8	TRBJ2-7
TGTGCCAGCAGTTTAGAAGCAAATCGAGGGAGCTCCTATAATTCACCCCTCCACTTT	CASSLEANRGSSYNSPLHF	TRBV12-4	TRBJ1-6
TGTGCCAGTAGTATAGAAGGGGTAGATTCACCCCTCCACTTT	CASSIEGVDSPLHF	TRBV19	TRBJ1-6
TGTGCCAGTAAACAGGGTTTTGACAATCAGCCCCAGCATTTT	CASKQGFDNQPQHF	TRBV19	TRBJ1-5
TGTGCCAGCAGTTTATGGGGGGGCAAACCGCCATCCTATGGCTACACCTTC	CASSLWGGKPPSYGYTF	TRBV27	TRBJ1-2
TGTGCCAGCAGCAGACAGACGGAGGGGAACACTGAAGCTTTCTTT	CASSRQTEGNTEAFF	TRBV5-6	TRBJ1-1
TGCAGTGCTAGTAGTCGGGTGGGTGGCTACACCTTC	CSASSRVGGYTF	TRBV20-1	TRBJ1-2
TGTGCCAGCAGCTTAAACTGGGGGGGGCAGGACGCCAAAAACATTCAGTACTTC	CASSLNWGGQDAKNIQYF	TRBV11-3	TRBJ2-4
TGTGCCAGCAGGGACGAAGAGGACATTCAAGAGACCCAGTACTTC	CASRDEEDIQETQYF	TRBV27	TRBJ2-5
TGTGCCAGCAGCTCCGCCGGAGCTTTCTTT	CASSSAGAFF	TRBV9	TRBJ1-1
TGTGCCAGTAGTATTCTTAGGGACAGTGGGGGCCAAGAGACCCAGTACTTC	CASSILRDSGGQETQYF	TRBV19	TRBJ2-5
TGTGTCTCCACGACAGGTGGGGCAGACTATAATTCACCCCTCCACTTT	CVSTTGGADYNSPLHF	TRBV24-1	TRBJ1-6
TGTGCCAGCAGCCATAGTCTCACAGATACGCAGTATTTT	CASSHSLTDTQYF	TRBV14	TRBJ2-3
TGCGCCAGCCCCTTCGCACAGGGCCCTCAAGTGTATAATTCACCCCTCCACTTT	CASPFAQGPQVYNSPLHF	TRBV10-2	TRBJ1-6
TGTGCCAGCAGCTTGGGTCTGGACAGGGGGGAGGGGACCGGGGAGCTGTTTTTT	CASSLGLDRGEGTGELFF	TRBV7-3	TRBJ2-2
TGTGCCAGCCCCGGAGAGGGCTACAATGAGCAGTTCTTC	CASPGEGYNEQFF	TRBV7-9	TRBJ2-1
TGCAGCTCCCTGAGGACAGGGGTCTACGAGCAGTACTTC	CSSLRTGVYEQYF	TRBV29-1	TRBJ2-7
TGTGCCAGAGCGGCTTCCTATGAGCAGTTCTTC	CARAASYEQFF	TRBV6-4	TRBJ2-1
TGCAGTGCTAGTGGAGACGCCCGGGACGACAATGAGCAGTTCTTC	CSASGDARDDNEQFF	TRBV20-1	TRBJ2-1
TGCGCCAGCAGCTTGGGGGGGGTTGCCTCCTACGAGCAGTACTTC	CASSLGGVASYEQYF	TRBV5-1	TRBJ2-7
TGCAGTGCTAGCGGCCAGGGTATAGGACGTACTAGGGATCAGCCCCAGCATTTT	CSASGQGIGRTRDQPQHF	TRBV20-1	TRBJ1-5
TGTGCCAGCAGCCAAGAAGAAATCAGGTTTGGCTACGAGCAGTACTTC	CASSQEEIRFGYEQYF	TRBV14	TRBJ2-7
TGCGCCAGCAAGAGGACAGAAGCTAATCAGCCCCAGCATTTT	CASKRTEANQPQHF	TRBV5-1	TRBJ1-5
TGTGCCAGCAGCAGAGCAATTAGACTAGCGGGGGGGCAGTACGAGCAGTACTTC	CASSRAIRLAGGQYEQYF	TRBV9	TRBJ2-7
TGCAGTCAAGGCATGGGAGAAGCTTTCTTT	CSQGMGEAFF	TRBV20-1	TRBJ1-1
TGTGCCATTTGGACAGGGCCAGTCGACTTAAGGAAGGAGTATGGCTACACCTTC	CAIWTGPVDLRKEYGYTF	TRBV25-1	TRBJ1-2
TGTGCCAGCATCCCGGGGCAAGCCCATGGCTACACCTTC	CASIPGQAHGYTF	TRBV12-3	TRBJ1-2
TGCGCCAGCCTCACCCTAAAGCGGGTTTGGGGATGGACCTACGAGCAGTACTTC	CASLTLKRVWGWTYEQYF	TRBV5-1	TRBJ2-7
TGTGCCAGCAGCGAGGGTCCAAGCGTCAATCAGCCCCAGCATTTT	CASSEGPSVNQPQHF	TRBV7-4	TRBJ1-5
TGTGCCAGCAGTTTAGAGGAGTGTGGGGACTATGGCTACACCTTC	CASSLEECGDYGYTF	TRBV27	TRBJ1-2
TGTGCCAGCACCCGGATAGGAGCGGGGGTACGCGAGCAGTACTTC	CASTRIGAGVREQYF	TRBV27	TRBJ2-7
TGCGCCAGCAGCTGTTTACAGGGGGCGGAACCTAATGAGCAGTTCTTC	CASSCLQGAEPNEQFF	TRBV5-1	TRBJ2-1
TGTGCCAGCAGGTCCACCAGGTGCGTAACTGAGACCCAGTACTTC	CASRSTRCVTETQYF	TRBV6-1	TRBJ2-5
TGCAGTGCACAGGGGGCAGGGTTCATTAATCAGCCCCAGCATTTT	CSAQGAGFINQPQHF	TRBV20-1	TRBJ1-5
TGTGCCAGCAGCTTAGATCCCGGAGGGGCCAGGAGTAGCAATCAGCCCCAGCATTTT	CASSLDPGGARSSNQPQHF	TRBV11-3	TRBJ1-5
TGTGCCAGCAGAGACCGAGGGGATAACACTGAAGCTTTCTTT	CASRDRGDNTEAFF	TRBV12-3	TRBJ1-1
TGTGCCACCAGTGGAATTGGTATAGCTTTACGTGCAGATACGCAGTATTTT	CATSGIGIALRADTQYF	TRBV24-1	TRBJ2-3
TGTGCCAGCCAGGGACGCTTAAACTATGGCTACACCTTC	CASQGRLNYGYTF	TRBV7-6	TRBJ1-2
TGTGCCACACCCACCAGGGGAAACAATGAGCAGTTCTTC	CATPTRGNNEQFF	TRBV2	TRBJ2-1
TGTGCCAGCAGTGATAGGATGGGGCACTCTGGGGCCAACGTCCTGACTTTC	CASSDRMGHSGANVLTF	TRBV6-1	TRBJ2-6
TGTGCCAGCAGTTACAGGGACGGGTGTAGCATGAACACTGAAGCTTTCTTT	CASSYRDGCSMNTEAFF	TRBV6-5	TRBJ1-1
TGTGCCAGCAGTGACACCCTCGAGGGCGGGGAGCTGTTTTTT	CASSDTLEGGELFF	TRBV6-1	TRBJ2-2
TGCGCCAGCAGCTATAGGGTAAGCAATCAGCCCCAGCATTTT	CASSYRVSNQPQHF	TRBV5-1	TRBJ1-5
TGTGCCAGCAGCTCCTTGGACAGGGGGGGAGCAACTAATGAAAAACTGTTTTTT	CASSSLDRGGATNEKLFF	TRBV11-3	TRBJ1-4
TGCGCCAGCACCCTCGGGCCGGGACAGGGGGCCATTGCGAACACTGAAGCTTTCTTT	CASTLGPGQGAIANTEAFF	TRBV10-1	TRBJ1-1
TGTGCCAGCAGTCGGAGGGGTCCTAATTCACCCCTCCACTTT	CASSRRGPNSPLHF	TRBV27	TRBJ1-6
TGCGCCAGCAGCCACCCAGGAGTCAATGAGCAGTTCTTC	CASSHPGVNEQFF	TRBV4-1	TRBJ2-1
TGTGCCAGCAGCCAACAGGGGTTCCGGATAGGTTCACCCCTCCACTTT	CASSQQGFRIGSPLHF	TRBV5-6	TRBJ1-6
TGTGCTAGCAGCTTAGGTCGCTACCGGTTAACCCAGGGGTCAGGAGGGGCCAACGTCCTGACTTTC	CASSLGRYRLTQGSGGANVLTF	TRBV7-7	TRBJ2-6
TGTGCCAGCAGCTTCGGGACTAGCGGGTTGTTGGGGGACACAGATACGCAGTATTTT	CASSFGTSGLLGDTDTQYF	TRBV5-6	TRBJ2-3
TGTGCCAGCTCGGGAAAAAGGACAGAAGAACGATCAGATACGCAGTATTTT	CASSGKRTEERSDTQYF	TRBV19	TRBJ2-3
TGTGCCAGCAGCAAGATCGCCTTTCACAATGAGCAGTTCTTC	CASSKIAFHNEQFF	TRBV7-3	TRBJ2-1
TGTGCCAGCGCTCTGTCAGGGGGCAATGAGCAGTTCTTC	CASALSGGNEQFF	TRBV5-4	TRBJ2-1
TGCAGTGCGCAAGGTAGGGGGGGGCAAGAGACCCAGTACTTC	CSAQGRGGQETQYF	TRBV20-1	TRBJ2-5
TGTGCCAGCAGCTGGTTGGGGGGCGCCCAAGAGACCCAGTACTTC	CASSWLGGAQETQYF	TRBV7-9	TRBJ2-5
TGTGCCAGAAGGGGCAGCAATGAGCAGTTCTTC	CARRGSNEQFF	TRBV19	TRBJ2-1
TGCAGTGCTAGAATACTGGACCGACATTCACCCCTCCACTTT	CSARILDRHSPLHF	TRBV20-1	TRBJ1-6
TGTGCCAGCAGCGAAACCCCGGGACACGAACACTCTGGGGCCAACGTCCTGACTTTC	CASSETPGHEHSGANVLTF	TRBV13	TRBJ2-6
