TGTGCCAGCAGCGATATAAGGGTGGATCAGCCCCAGCATTTT	CASSDIRVDQPQHF	TRBV13	TRBJ1-5
TGTGCCAGCAACAAGACCAAGAGCGGGACAGGGCGAAGCTCCTACAATGAGCAGTTCTTC	CASNKTKSGTGRSSYNEQFF	TRBV27	TRBJ2-1
TGCAGCGTTGAGTGGGGAAGCCCGGTGAGCACTGAAGCTTTCTTT	CSVEWGSPVSTEAFF	TRBV29-1	TRBJ1-1
TGTGCCAGCAGTATGGGGGGCGGTGGTCAGCCCCAGCATTTT	CASSMGGGGQPQHF	TRBV12-3	TRBJ1-5
TGTGCCAGAGGACAGGGATTGAACAATGAGCAGTTCTTC	CARGQGLNNEQFF	TRBV19	TRBJ2-1
TGTGCCAGCAGCTTAGGCCGGGACAGGGGGGGAGACACCGGGGAGCTGTTTTTT	CASSLGRDRGGDTGELFF	TRBV11-2	TRBJ2-2
TGTGCCAGCAGTTGGAAACCGACAGGACTTAACACTGAAGCTTTCTTT	CASSWKPTGLNTEAFF	TRBV27	TRBJ1-1
TGCGCCAGCAGTGAGCCGGGACCCCATGAGCAGTTCTTC	CASSEPGPHEQFF	TRBV10-1	TRBJ2-1
TGTGCCAGCAGCTTAAGGTCGCTCCGAGCGCACGAGCAGTACTTC	CASSLRSLRAHEQYF	TRBV11-3	TRBJ2-7
TGTGCCAGAGACGGGGGGGTAGTGTACAATGAGCAGTTCTTC	CARDGGVVYNEQFF	TRBV11-3	TRBJ2-1
TGCGCCAGCAGCTTTGGCCGGTTGGATACGCAGTATTTT	CASSFGRLDTQYF	TRBV5-1	TRBJ2-3
TGTGCCAGCAGTAGAGTCAAGCCGGGACAGGTAGACGGCAATGAGCAGTTCTTC	CASSRVKPGQVDGNEQFF	TRBV27	TRBJ2-1
TGCAGCGTGAGGGAACGACGGTTAGGGCTAGCCAAAAACATTCAGTACTTC	CSVRERRLGLAKNIQYF	TRBV29-1	TRBJ2-4
TGCAGCGTCTGGAGGGGGCCGCTTTCTGAAGCTTTCTTT	CSVWRGPLSEAFF	TRBV29-1	TRBJ1-1
TGTGCCAGCAGCCAAGGTAGCAGGACCCGCCCCCCCCTAGCGGGTAGGACTGACGAGCAGTACTTC	CASSQGSRTRPPLAGRTDEQYF	TRBV3-1	TRBJ2-7
TGTGCCAGCAGCCAAGGAAGCGGCATTTCCAGACCCGGCGGGGACTACGAGCAGTACTTC	CASSQGSGISRPGGDYEQYF	TRBV4-2	TRBJ2-7
TGCAGCGTCGTCTCCCGGGGTAAGGGTCAAGAGACCCAGTACTTC	CSVVSRGKGQETQYF	TRBV29-1	TRBJ2-5
TGCGCCAGCGTTACCGGCCGGAAAGCTTTCTTT	CASVTGRKAFF	TRBV10-1	TRBJ1-1
TGTGCCAGCAGCCAAGCGACCCGGTCTTACAATTCACCCCTCCACTTT	CASSQATRSYNSPLHF	TRBV14	TRBJ1-6
TGTGCCAGCAGCCAAGATGCGGGAGACGGCGAGCAGTACTTC	CASSQDAGDGEQYF	TRBV14	TRBJ2-7
TGTGCCAGCAGCTTCACAGGGCCTAGCGCTTTCTTT	CASSFTGPSAFF	TRBV3-1	TRBJ1-1
TGTGCCACGGAGAGGGGTGTGGAGCAGTTCTTC	CATERGVEQFF	TRBV19	TRBJ2-1
TGCAGTGCGGAAGTGCTCATCACCGGGGAGCTGTTTTTT	CSAEVLITGELFF	TRBV20-1	TRBJ2-2
TGTGCCACCAGTGATTCCTTCGGTTGGACAGGGGGTCTCCTCTCCTACAATGAGCAGTTCTTC	CATSDSFGWTGGLLSYNEQFF	TRBV24-1	TRBJ2-1
TGCGCCAGCAGCTTGCGGACAGGTGGGGGGTCCTACGAGCAGTACTTC	CASSLRTGGGSYEQYF	TRBV5-1	TRBJ2-7
TGTGCCAGCAGCTTAGAGAGGGAGAACCTGTTTTTT	CASSLERENLFF	TRBV7-7	TRBJ1-4
TGCGCCAGCAGCCTTCGTCTTATCCGGGACCCGCAAAGCGAGGAAAAACTGTTTTTT	CASSLRLIRDPQSEEKLFF	TRBV5-1	TRBJ1-4
TGTGCCAGTAGTTCACAGGGGAACACTGAAGCTTTCTTT	CASSSQGNTEAFF	TRBV19	TRBJ1-1
TGTGCCAGCAGCCAAGATCGGGGGGTCCGAAAACTGTTTTTT	CASSQDRGVRKLFF	TRBV3-1	TRBJ1-4
TGTGCCAGCAGCGTAGGGGGGGGCCGATGTGGAGATACGCAGTATTTT	CASSVGGGRCGDTQYF	TRBV9	TRBJ2-3
TGTGCCAGCAGTTACAAATCAGGGTTCTACGAGCAGTACTTC	CASSYKSGFYEQYF	TRBV6-9	TRBJ2-7
TGTGCCAGCAGTTTGCCCGATCCAGGGGGGGAGCAGTACTTC	CASSLPDPGGEQYF	TRBV12-3	TRBJ2-7
TGTGCCAGCATCAAGACTTGCCCTGGGGCCAACGTCCTGACTTTC	CASIKTCPGANVLTF	TRBV6-4	TRBJ2-6
TGTGCCAGCAGTTACAACGGGGACAGAAACATTCAGTACTTC	CASSYNGDRNIQYF	TRBV6-5	TRBJ2-4
TGCAGTGCTAGACGCCCCGAACAGGGGTTGAATGGGGGGGGCACTGAAGCTTTCTTT	CSARRPEQGLNGGGTEAFF	TRBV20-1	TRBJ1-1
TGTGCCAGCGACCTACTCGACAGAAACACTGAAGCTTTCTTT	CASDLLDRNTEAFF	TRBV6-4	TRBJ1-1
TGTGCCAGCAGTTCCAGACAGGATCCTGAAGCTTTCTTT	CASSSRQDPEAFF	TRBV12-3	TRBJ1-1
TGTGCCAGCAGCTTAGGACTAGAAGCTAGCTCCTACGAGCAGTACTTC	CASSLGLEASSYEQYF	TRBV7-4	TRBJ2-7
TGTGCCAGCAGTTTATGGATGATGCTGCCCCGGGCAAGTGGTGCAGATACGCAGTATTTT	CASSLWMMLPRASGADTQYF	TRBV28	TRBJ2-3
TGTGCCAGCAGCGCGGGCCTCAATCAGCCCCAGCATTTT	CASSAGLNQPQHF	TRBV7-3	TRBJ1-5
TGTGCCAGCAGCCAAGAGGGTGGGGGGGCCCCTACAGATACGCAGTATTTT	CASSQEGGGAPTDTQYF	TRBV3-1	TRBJ2-3
TGTGCCACCAGTGATTTGGAATGGCCCCAGGGGGCGGGCAGTTGCTACACCTTC	CATSDLEWPQGAGSCYTF	TRBV24-1	TRBJ1-2
TGTGCCAGCAGCGCCGGGACTAGACGCTCCTACGAGCAGTACTTC	CASSAGTRRSYEQYF	TRBV28	TRBJ2-7
TGTGCCAGCAGCTTTCAGAGACTAGCGAAGCAGGCAGATACGCAGTATTTT	CASSFQRLAKQADTQYF	TRBV11-2	TRBJ2-3
TGTGCCAGCAGTTGGGACCAATTCGGGGGAGGGAGCTCCTACGAGCAGTACTTC	CASSWDQFGGGSSYEQYF	TRBV27	TRBJ2-7
TGCGCCAGCACAACAGGGGTCGCGCAGTACTTC	CASTTGVAQYF	TRBV10-1	TRBJ2-7
TGTGCCAGTAGTCCAACCCCGGGACTAGCGGGGGGGCATAGCTACGAGCAGTACTTC	CASSPTPGLAGGHSYEQYF	TRBV19	TRBJ2-7
TGTGCCAGCAGTCCGGTATGTGAGGTGGGGATAGAGAATACTCAACCCTACGAGCAGTACTTC	CASSPVCEVGIENTQPYEQYF	TRBV27	TRBJ2-7
TGTGCCAGCAGTGATAACGGGGGGGAGGGGGCCTACGAGCAGTACTTC	CASSDNGGEGAYEQYF	TRBV6-1	TRBJ2-7
TGTGCCACCAGTGATAAGCCTGGACCCCGCTTGACCTACGAGCAGTACTTC	CATSDKPGPRLTYEQYF	TRBV24-1	TRBJ2-7
TGTGCCAGCAGTGACGATACACTAGCGGCGGGCCCCTACGAGCAGTACTTC	CASSDDTLAAGPYEQYF	TRBV6-4	TRBJ2-7
TGTGCCAGCAGCTTTCTAGGGGCCAAAGAGACCCAGTACTTC	CASSFLGAKETQYF	TRBV5-4	TRBJ2-5
TGTGCCAGCAGCTTAGCGGTTGACAGGAGCACTGAAGCTTTCTTT	CASSLAVDRSTEAFF	TRBV7-2	TRBJ1-1
TGTGCCAGCTCACCATCTCCCTGGGGTCTCTACACCTTC	CASSPSPWGLYTF	TRBV18	TRBJ1-2
TGCGCCAGCAGCCAAGAAACGAGGGATCCTGGGGCCAACGTCCTGACTTTC	CASSQETRDPGANVLTF	TRBV4-1	TRBJ2-6
TGTGCCAGCAGCGTCCGCCCAGCGGCTCAAGAGACCCAGTACTTC	CASSVRPAAQETQYF	TRBV27	TRBJ2-5
TGTGCCAGCAGCGGGCAGGGCCGGACCTATAATTCACCCCTCCACTTT	CASSGQGRTYNSPLHF	TRBV5-6	TRBJ1-6
TGCGCCAGCATCAGGGACCTAGAGACCCAGTACTTC	CASIRDLETQYF	TRBV10-1	TRBJ2-5
TGCGCCAGCAGCCAAGAGGGGTTCGAGCAGTACTTC	CASSQEGFEQYF	TRBV4-3	TRBJ2-7
TGTGCCAGCTCCCCAGAAACGTATCCGGGACTAGCGGGAGTAGGCCGCTCCTATAATTCACCCCTCCACTTT	CASSPETYPGLAGVGRSYNSPLHF	TRBV12-3	TRBJ1-6
TGTGCCAGTAGTCAAAATCCCGATGGGACGTGGGAGTACGAGCAGTACTTC	CASSQNPDGTWEYEQYF	TRBV19	TRBJ2-7
TGTGCCAGCACACACAGGGAACGGCGAAACACCATATATTTT	CASTHRERRNTIYF	TRBV28	TRBJ1-3
TGTGCCGAACAGGGCTACGAGCAGTACTTC	CAEQGYEQYF	TRBV15	TRBJ2-7
TGTGCCAGCAGGTCCGGACAGGCTCGTAATCAGCCCCAGCATTTT	CASRSGQARNQPQHF	TRBV6-5	TRBJ1-5
TGTGCCAGCAGTGATTGGAGGGTGAGTTACTTAATCTCCTACGAGCAGTACTTC	CASSDWRVSYLISYEQYF	TRBV6-4	TRBJ2-7
TGTGCCAGCGTCTCCGGACGGTGTGGCTACACCTTC	CASVSGRCGYTF	TRBV6-4	TRBJ1-2
TGTGCCAGCATCGAGGGGGGGGGCTACACCTTC	CASIEGGGYTF	TRBV6-6	TRBJ1-2
TGTGCCAGCAGCTCCTCAGGGAGTACGAGAGGGGGGGAGACCCAGTACTTC	CASSSSGSTRGGETQYF	TRBV5-5	TRBJ2-5
TGTGCCAGCAGCGTCCCTCGGGCGTGGATCCTACGCTACACCTTC	CASSVPRAWILRYTF	TRBV9	TRBJ1-2
TGTGCCAGCAGCGGCCTCGCCGGGACAGGGGAACAGGATCAGCCCCAGCATTTT	CASSGLAGTGEQDQPQHF	TRBV9	TRBJ1-5
TGTGCCAGCAGTTTAGTAAAGGTACAGAGAAACTATGGCTACACCTTC	CASSLVKVQRNYGYTF	TRBV28	TRBJ1-2
TGTGCCAGCAGTAAACAGGTCATCTACAATGAGCAGTTCTTC	CASSKQVIYNEQFF	TRBV11-2	TRBJ2-1
TGTGCCACCAGTGATTTGGTTCGGACCAGGGCTGAAAAACTGTTTTTT	CATSDLVRTRAEKLFF	TRBV24-1	TRBJ1-4
TGTGCCAGCACTGACGCGGGACATCAGCCCCAGCATTTT	CASTDAGHQPQHF	TRBV2	TRBJ1-5
TGCGCCAGCAGTGAACGGGTGGACTCCTACGAGCAGTACTTC	CASSERVDSYEQYF	TRBV10-1	TRBJ2-7
TGTGCCAGCAGTGACATAGGGACCCTGACAGGGCCCCATGGCTACACCTTC	CASSDIGTLTGPHGYTF	TRBV25-1	TRBJ1-2
TGTGCCAGCAGCCAAGAGTCTAGCGGGCCGGGCGGGGAGCTGTTTTTT	CASSQESSGPGGELFF	TRBV14	TRBJ2-2
TGTGCCACCAGTGACGAACAATCAGGGGGACAGTATGACACTGAAGCTTTCTTT	CATSDEQSGGQYDTEAFF	TRBV24-1	TRBJ1-1
TGTGCCAGCAGCTTAGCAGACAGGGACACTGAAGCTTTCTTT	CASSLADRDTEAFF	TRBV7-4	TRBJ1-1
TGTGCCAGCAGTCCTGGGACTAAAAGGGATACGCAGTATTTT	CASSPGTKRDTQYF	TRBV11-3	TRBJ2-3
TGTGCCAGCAGCTTCGGGACAGGGGTACTGGGTGCCAAAAACATTCAGTACTTC	CASSFGTGVLGAKNIQYF	TRBV11-3	TRBJ2-4
TGTGCCAGCAGGCTTAGCCCCCGCACAGATACGCAGTATTTT	CASRLSPRTDTQYF	TRBV5-5	TRBJ2-3
TGCAGTGCTAGAGTACTAACTCGGGGCGAGCAGTACTTC	CSARVLTRGEQYF	TRBV20-1	TRBJ2-7
TGTGCCAGCAGGGTCACCTCCGGGACAGGGGGCGCGGACTATGGCTACACCTTC	CASRVTSGTGGADYGYTF	TRBV6-5	TRBJ1-2
TGCGCCAGCAGCTGTAGCGACACAGATACGCAGTATTTT	CASSCSDTDTQYF	TRBV5-1	TRBJ2-3
TGTGCCTGGAGTGCGGGGGGACTAGCGGGAAGACACTTCTCCTACGAGCAGTACTTC	CAWSAGGLAGRHFSYEQYF	TRBV30	TRBJ2-7
TGTGCCAGCAAGTCACTAGCGGGAGGGCATAGTTCCTACGAGCAGTACTTC	CASKSLAGGHSSYEQYF	TRBV9	TRBJ2-7
TGTGCCAGCAGCAGAGGATATCAGCCCGGGACTAGCGGGCGCTCCTACAATGAGCAGTTCTTC	CASSRGYQPGTSGRSYNEQFF	TRBV7-4	TRBJ2-1
TGTGCCAGGCGGGCTGGGTCCTACAATGAGCAGTTCTTC	CARRAGSYNEQFF	TRBV7-9	TRBJ2-1
TGTGCCAGCAGCTTAGCGTTTCCCATCTTCAGCTATGGCTACACCTTC	CASSLAFPIFSYGYTF	TRBV7-9	TRBJ1-2
TGCAGTGCTAGAGATCCGGGGGAGCTTGGCTACACCTTC	CSARDPGELGYTF	TRBV20-1	TRBJ1-2
TGTGCCAGCACTGGGGATTGCACCTACGAGCAGTACTTC	CASTGDCTYEQYF	TRBV25-1	TRBJ2-7
TGCAGTGCAAGGACTAGCTTCGAGCAGTACTTC	CSARTSFEQYF	TRBV20-1	TRBJ2-7
TGTGCCACCAGTGATTCTTGTGTAGGGAATTACACAGATACGCAGTATTTT	CATSDSCVGNYTDTQYF	TRBV24-1	TRBJ2-3
TGTGCCAGCAGCAGTACTAAGGCGGGTGAGACCCAGTACTTC	CASSSTKAGETQYF	TRBV13	TRBJ2-5
TGTGCCAGCAGCCTATATTATCGGATCAAGCCTAGCGGGGTCACCGGGGAGCTGTTTTTT	CASSLYYRIKPSGVTGELFF	TRBV4-2	TRBJ2-2
TGTGCCAGCAGCCACCAGGGGAAGGCCTACGAGCAGTACTTC	CASSHQGKAYEQYF	TRBV11-3	TRBJ2-7
TGTGCCAGCAGCTTGCCTCCACGACAGGGCTATTGGTCTGAAGCTTTCTTT	CASSLPPRQGYWSEAFF	TRBV5-4	TRBJ1-1
TGTGCCAGCAGCTTATCTCCCCGCCGACCAGATACGCAGTATTTT	CASSLSPRRPDTQYF	TRBV7-3	TRBJ2-3
TGTGCCAGCAGCGCCGCCGGCAGCGACTATGGCTACACCTTC	CASSAAGSDYGYTF	TRBV9	TRBJ1-2
