TGCGCCAGCAGCGCTCCACAGGGTAAGTATGGCTACACCTTC	CASSAPQGKYGYTF	TRBV5-1	TRBJ1-2
TGTGCCATCAGTGCTAGTCCCACAGATACGCAGTATTTT	CAISASPTDTQYF	TRBV10-3	TRBJ2-3
TGTGCCAGCAGCCAATACCTGACTAGCGGGGGGGCAGAGGAAGATACGCAGTATTTT	CASSQYLTSGGAEEDTQYF	TRBV3-1	TRBJ2-3
TGCGCCAGCAGCCAACAGGGGAACACTGAAGCTTTCTTT	CASSQQGNTEAFF	TRBV4-1	TRBJ1-1
TGTGCCAGCAGCCATCATCGCCGGGACACAGCACCTGAAGCTTTCTTT	CASSHHRRDTAPEAFF	TRBV14	TRBJ1-1
TGTGCCAGCAGCACCTCGGACAGGGTGTCTAGCGGGGCCTATGGCTACACCTTC	CASSTSDRVSSGAYGYTF	TRBV7-4	TRBJ1-2
TGTGCCAGCAGTAACAGGGTTTCACCCCTCCACTTT	CASSNRVSPLHF	TRBV27	TRBJ1-6
TGTGTAGCGGGACACTACGAGCAGTACTTC	CVAGHYEQYF	TRBV2	TRBJ2-7
TGTGCCAGCACCGGCAGCCTTCTGGCTGAGCCCCAGCATTTT	CASTGSLLAEPQHF	TRBV7-8	TRBJ1-5
TGTGCCAGCAGCCAAGGACTTGGGTCCTACGAGCAGTACTTC	CASSQGLGSYEQYF	TRBV3-1	TRBJ2-7
TGTGCCAGCAGCCAAAGCCGGGACAATGAAAAACTGTTTTTT	CASSQSRDNEKLFF	TRBV3-1	TRBJ1-4
TGTGCACCTGGCGAGGTCCAAGAGACCCAGTACTTC	CAPGEVQETQYF	TRBV6-6	TRBJ2-5
TGTGCCAGCAGCAACCTGTCCGCTCTAGCGCTAAGCTACAATGAGCAGTTCTTC	CASSNLSALALSYNEQFF	TRBV7-3	TRBJ2-1
TGCAGTGCTACAAGACGCATTTTCTCTGAGCAGTACTTC	CSATRRIFSEQYF	TRBV20-1	TRBJ2-7
TGCGCCAGCAGCTTCTGGGGGGGGCGGACTAAAAGGGCCTACGAGCAGTACTTC	CASSFWGGRTKRAYEQYF	TRBV5-1	TRBJ2-7
TGTGCCAGCAGCGAGTATGGCCGGAGAGGGACAGGCTACACTGAAGCTTTCTTT	CASSEYGRRGTGYTEAFF	TRBV27	TRBJ1-1
TGTGCCAGCAGCAGGGTTGGCCACACTGAAGCTTTCTTT	CASSRVGHTEAFF	TRBV27	TRBJ1-1
TGTGCCAGTAGTAAGGATTACTCGAAAGCTTTCTTT	CASSKDYSKAFF	TRBV19	TRBJ1-1
TGCGCCAGCAGCCGGGGGGGCTACGAGCAGTACTTC	CASSRGGYEQYF	TRBV4-1	TRBJ2-7
TGCGCCAGCAGCAGGCGTATGTTGGGACTGAGCCCGAATGAGCAGTTCTTC	CASSRRMLGLSPNEQFF	TRBV10-1	TRBJ2-1
TGTGCCAGCTCACCTCCTCCGGTGGGGCTTAAAGCCCAGCATTTT	CASSPPPVGLKAQHF	TRBV18	TRBJ1-5
TGTGCCAGCAGTTACACCGGAGGACCGAGGGCCAACGTCCTGACTTTC	CASSYTGGPRANVLTF	TRBV27	TRBJ2-6
TGTGCCAGCAGTATCAAAATGGGGGTAAGTAATGGCTACACCTTC	CASSIKMGVSNGYTF	TRBV6-5	TRBJ1-2
TGTGCCAGCAGTCAAGTCACAGGAAGTTACTATGGCTACACCTTC	CASSQVTGSYYGYTF	TRBV28	TRBJ1-2
TGTGCCAGCAGTGCGCCTCCCGCGGACGGACAAGAGTCTAGCACAGATACGCAGTATTTT	CASSAPPADGQESSTDTQYF	TRBV6-1	TRBJ2-3
TGCGCCAGCTCCGCTGACACGGGGCCTGAAGCTTTCTTT	CASSADTGPEAFF	TRBV10-1	TRBJ1-1
TGCAGTGCTAGAGATTCTCGCGGGAGGCACGAGCAGTACTTC	CSARDSRGRHEQYF	TRBV20-1	TRBJ2-7
TGTGCCAGCAGTTTCCGGGGCATCGAAAAACTGTTTTTT	CASSFRGIEKLFF	TRBV27	TRBJ1-4
TGTGCCAGCAGCGGCGGGGGGGGGCCCCGGGGCACCGGGGAGCTGTTTTTT	CASSGGGGPRGTGELFF	TRBV9	TRBJ2-2
TGTGCCAGCAGCGGAAGGAGGGCAGAAGAGACCCAGTACTTC	CASSGRRAEETQYF	TRBV7-3	TRBJ2-5
TGTGCCAGCACCCGTACTTGTGGGACGTACGAGCAGTACTTC	CASTRTCGTYEQYF	TRBV5-4	TRBJ2-7
TGTGCCAGCAGTTCCCCGTCCAGGGGGCGGAGGCAAGAGACCCAGTACTTC	CASSSPSRGRRQETQYF	TRBV28	TRBJ2-5
TGCGCCAGCAGCCAAGATTTAAGGACTAGCGGGCCGCGCGGGGAGCTGTTTTTT	CASSQDLRTSGPRGELFF	TRBV4-1	TRBJ2-2
TGTGCCAGCAGTCCGGGGGTGGGGGGGAGGTATAGCAATCAGCCCCAGCATTTT	CASSPGVGGRYSNQPQHF	TRBV6-3	TRBJ1-5
TGTGCCAGCAGCGGCCGACAGGGGAGGAAAAATGAGACCCAGTACTTC	CASSGRQGRKNETQYF	TRBV6-4	TRBJ2-5
TGTGCCACACGGGATACTAGCACAGATACGCAGTATTTT	CATRDTSTDTQYF	TRBV10-3	TRBJ2-3
TGTGCCAGCAGCTTGGTAGCGGGATCGAACACCGGGGAGCTGTTTTTT	CASSLVAGSNTGELFF	TRBV11-1	TRBJ2-2
TGTGCCAGGGGGGGGGGCTTTACCGGGGAGCTGTTTTTT	CARGGGFTGELFF	TRBV12-3	TRBJ2-2
TGCAGTGCAACCCTAGCGGGAGATACGCAGTATTTT	CSATLAGDTQYF	TRBV20-1	TRBJ2-3
TGTGCCAGCAGCCGATGGGGCAATAATGAAAAACTGTTTTTT	CASSRWGNNEKLFF	TRBV11-2	TRBJ1-4
TGTGCCAGCAGAACCTTATTCCGGGGTGTTTCACCCCTCCACTTT	CASRTLFRGVSPLHF	TRBV6-2	TRBJ1-6
TGTGCCAGCAGCCCCCCGGGACAGAACTACGAGCAGTACTTC	CASSPPGQNYEQYF	TRBV7-2	TRBJ2-7
TGTGCCAGGCATGGGTGGACAGGGCGACATCAGCCCCAGCATTTT	CARHGWTGRHQPQHF	TRBV25-1	TRBJ1-5
TGTGCCAGCGCGAGGGGGGGATATAGCAATCAGCCCCAGCATTTT	CASARGGYSNQPQHF	TRBV7-9	TRBJ1-5
TGCAGTAACTTCGACAGGGTACTTGAAAAACTGTTTTTT	CSNFDRVLEKLFF	TRBV20-1	TRBJ1-4
TGTGCCAGCAGCGGCCCCGGGACAGATCGGAGCACTGAAGCTTTCTTT	CASSGPGTDRSTEAFF	TRBV7-3	TRBJ1-1
TGCAGTGCTAGAGGACAGGGTACCGGGGAGCTGTTTTTT	CSARGQGTGELFF	TRBV20-1	TRBJ2-2
TGCAGTGCTAGAGTCCCATCCGGGACGGTTTTCAATTCACCCCTCCACTTT	CSARVPSGTVFNSPLHF	TRBV20-1	TRBJ1-6
TGTGCCAGCAGTTACCACATGGACAGGGGGCGGCAGCCCCAGCATTTT	CASSYHMDRGRQPQHF	TRBV6-5	TRBJ1-5
TGTGCCACCAGTGATTTCCGGACAGAACAAGAGACCCAGTACTTC	CATSDFRTEQETQYF	TRBV24-1	TRBJ2-5
TGCGCCGCTCACCCAGAGTCTGGAAACACCATATATTTT	CAAHPESGNTIYF	TRBV10-1	TRBJ1-3
TGTGCCAGCAGGAGACCGGGCGAAAAACTGTTTTTT	CASRRPGEKLFF	TRBV6-1	TRBJ1-4
TGTGCCAGCAAATGGGACAGTAATGAAAAACTGTTTTTT	CASKWDSNEKLFF	TRBV11-3	TRBJ1-4
TGTGCCAGCAGTTGGTCCGGGACAGTTGCTTATCAGCCCCAGCATTTT	CASSWSGTVAYQPQHF	TRBV6-1	TRBJ1-5
TGTGCCTGGAGCGGGACAGTAGAACAAGAGACCCAGTACTTC	CAWSGTVEQETQYF	TRBV30	TRBJ2-5
TGTGCCAGCAGCAAAGGAAGTCAACCGGGACAGGGGAGCTCTGGAAACACCATATATTTT	CASSKGSQPGQGSSGNTIYF	TRBV11-2	TRBJ1-3
TGTGCCAGCAGCCCTCAGGGGGTTTGTCGGACCCAGTACTTC	CASSPQGVCRTQYF	TRBV13	TRBJ2-5
TGTGCCAGCAGCACCGGGAAAAGTGGGCCCCACACAGATACGCAGTATTTT	CASSTGKSGPHTDTQYF	TRBV5-4	TRBJ2-3
TGCAGCGTTAGCCCGGGACACGACTATGGCTACACCTTC	CSVSPGHDYGYTF	TRBV29-1	TRBJ1-2
TGCGCCAGCAGCTTGAAAGACCGGGACAGAAGACAGCCCCAGCATTTT	CASSLKDRDRRQPQHF	TRBV5-1	TRBJ1-5
TGCAGTGCTAGTTGGGACAGACTGAGCTCCTACGAGCAGTACTTC	CSASWDRLSSYEQYF	TRBV20-1	TRBJ2-7
TGTGCCAGCATCCCAGTAGGCCCAACAAGGGGTTATGGCTACACCTTC	CASIPVGPTRGYGYTF	TRBV27	TRBJ1-2
TGTGCCAGCAGTTTACCAATGTTGGACAGGGTTCTGCAGCCCCAGCATTTT	CASSLPMLDRVLQPQHF	TRBV27	TRBJ1-5
TGTGCCAGCAGGCCCAGGGGCCCGCCTTGTTTGAGCTCCTACGAGCAGTACTTC	CASRPRGPPCLSSYEQYF	TRBV12-3	TRBJ2-7
TGTGCCAGCAGCGGGGGACAGGCAGACAATCAGCCCCAGCATTTT	CASSGGQADNQPQHF	TRBV14	TRBJ1-5
TGTGCCAGCAGTCAAAGGGGACAGGGGGCACAATCGTACAATGAGCAGTTCTTC	CASSQRGQGAQSYNEQFF	TRBV27	TRBJ2-1
TGCGCCAGCAGCTTTCCAACTAGCGGGAGGAGGGCGTCAACAGATACGCAGTATTTT	CASSFPTSGRRASTDTQYF	TRBV5-1	TRBJ2-3
TGTGCCAGCAGCTTAGTGTTGGGACAGCAGGTGAGTTCGGCTGAAGCTTTCTTT	CASSLVLGQQVSSAEAFF	TRBV11-3	TRBJ1-1
TGTGCCTGGAGTGTGGTGGGCCGGATGAACACTGAAGCTTTCTTT	CAWSVVGRMNTEAFF	TRBV30	TRBJ1-1
TGTGCCAGCAGTTTAGGGCCCGGGGGCGAGACCTATGGCTACACCTTC	CASSLGPGGETYGYTF	TRBV27	TRBJ1-2
TGTGCCAGCAGCTCAGGACCCGGGGGGGGGGAGACCAAAAACATTCAGTACTTC	CASSSGPGGGETKNIQYF	TRBV9	TRBJ2-4
TGCAGTGCTAGAGATACCTGCATTCCGGGACAGAGCTCCTATAATTCACCCCTCCACTTT	CSARDTCIPGQSSYNSPLHF	TRBV20-1	TRBJ1-6
TGTGCCAGCAGACAGGGCTACGAGCAGTACTTC	CASRQGYEQYF	TRBV6-1	TRBJ2-7
TGCGCCAGCAGTGAGGTCGGGCCGTGCCCTAACGGCGGTGGGAATCAGCCCCAGCATTTT	CASSEVGPCPNGGGNQPQHF	TRBV10-1	TRBJ1-5
TGTGCCAGCAGCGTCCCGACCGGGGCCGCGAACACCGGGGAGCTGTTTTTT	CASSVPTGAANTGELFF	TRBV5-4	TRBJ2-2
TGTGCCAGCAGGCCCCCGGGGGGAGGACAAGAATACACCTTC	CASRPPGGGQEYTF	TRBV7-2	TRBJ1-2
TGCGCCAGCAGTTTTATCTCTAGCACAGATACGCAGTATTTT	CASSFISSTDTQYF	TRBV10-2	TRBJ2-3
TGTGCCAGAGAAAGTGTGAGGGACTACACCGGGGAGCTGTTTTTT	CARESVRDYTGELFF	TRBV27	TRBJ2-2
TGCAGTGCTAGAGGAAGGACTAGCGGGACGGAGGTTACGCAGTATTTT	CSARGRTSGTEVTQYF	TRBV20-1	TRBJ2-3
TGTGCCATGGTTGGGTCGGTTACTGTTAATGAAAAACTGTTTTTT	CAMVGSVTVNEKLFF	TRBV25-1	TRBJ1-4
TGCGCCAGCAGCGGGTTTAGCGGGTTGAGCTCCTACGAGCAGTACTTC	CASSGFSGLSSYEQYF	TRBV5-1	TRBJ2-7
TGTGCCAGCAGCTTAGTCCGGACAGAGTTTAGTAACTATGGCTACACCTTC	CASSLVRTEFSNYGYTF	TRBV7-9	TRBJ1-2
TGTGCCAGCAGTGACTCGAGGGGTTACAGCAATCAGCCCCAGCATTTT	CASSDSRGYSNQPQHF	TRBV6-4	TRBJ1-5
TGTGAATACAGACGACTGTACGAGCAGTACTTC	CEYRRLYEQYF	TRBV11-3	TRBJ2-7
TGCAGTGCGGTCCTCCCTAGGGCCGGGAACACTGAAGCTTTCTTT	CSAVLPRAGNTEAFF	TRBV20-1	TRBJ1-1
TGTGCCAGCAGCAAAATTGGGAGCATTTCCGAGCAGTACTTC	CASSKIGSISEQYF	TRBV7-9	TRBJ2-7
TGTGCTAGCAGCTGTTTGGGACAGGGGGGTATGAACACTGAAGCTTTCTTT	CASSCLGQGGMNTEAFF	TRBV7-7	TRBJ1-1
TGTGCCAGCAGCCCTGACAGGGTCAGTTTCCTCTCCTACGAGCAGTACTTC	CASSPDRVSFLSYEQYF	TRBV28	TRBJ2-7
TGCGCCAGCAGCTTTGGGCACGGGGGGACCCAGTACTTC	CASSFGHGGTQYF	TRBV5-1	TRBJ2-5
TGTGCCAGCAGTTACCGAAAAGCTCCAAGTCCAGGGACTGAAGCTTTCTTT	CASSYRKAPSPGTEAFF	TRBV6-6	TRBJ1-1
TGTGCCAGCAGCCCCCCGATCAGGGATGAGGGTAATTCACCCCTCCACTTT	CASSPPIRDEGNSPLHF	TRBV7-2	TRBJ1-6
TGCAGTGCTAGAGATTGCGGTGATAACACTGAAGCTTTCTTT	CSARDCGDNTEAFF	TRBV20-1	TRBJ1-1
TGTGCCAGCAGATACTATCCAACGTGCCCAGGGACAGGGGTCCCCCAGCATTTT	CASRYYPTCPGTGVPQHF	TRBV12-4	TRBJ1-5
TGTGCCAGCAGTTATCGGCCGCGCACAGATACGCAGTATTTT	CASSYRPRTDTQYF	TRBV6-2	TRBJ2-3
TGTGCCAGTCCTAGGCGGGGCTCCTACGAGCAGTACTTC	CASPRRGSYEQYF	TRBV19	TRBJ2-7
TGTGCCACGCAGGGACAGCGGGTAGATACGCAGTATTTT	CATQGQRVDTQYF	TRBV24-1	TRBJ2-3
TGTGCCATCCGGGACAGGAGGGCGAACACCGGGGAGCTGTTTTTT	CAIRDRRANTGELFF	TRBV10-3	TRBJ2-2
TGTGCCAGCAGCGGGCCTGAAGCTTTCTTT	CASSGPEAFF	TRBV13	TRBJ1-1
TGTGCCAGCAGCGGCCCATTTACCTGGGGGGGGGTACCCGCTAGCTACGAGCAGTACTTC	CASSGPFTWGGVPASYEQYF	TRBV13	TRBJ2-7
TGCAGCGTTGAATATTTCGGGGAGGTTTCCTGTGACGAAAAACTGTTTTTT	CSVEYFGEVSCDEKLFF	TRBV29-1	TRBJ1-4
