TGTGCCAGCAGCTTAAGGGGGACCTATAGCAATCAGCCCCAGCATTTT	CASSLRGTYSNQPQHF	TRBV7-9	TRBJ1-5
TGCGCCCCACTATGGGCCCCAAAGGGGGACTCCTACGAGCAGTACTTC	CAPLWAPKGDSYEQYF	TRBV5-1	TRBJ2-7
TGTGCCATCAGCACTCAGAGTCAAGCTTTCTTT	CAISTQSQAFF	TRBV2	TRBJ1-1
TGTGCCAGCAGTAGGACAACCCCCGTCTCCTACTACGAGCAGTACTTC	CASSRTTPVSYYEQYF	TRBV13	TRBJ2-7
TGCAATAGGACGCCTGGTGGCTACACCTTC	CNRTPGGYTF	TRBV20-1	TRBJ1-2
TGTGCCAGCAGTTTACGGGGGGGGGCCTACGAGCAGTACTTC	CASSLRGGAYEQYF	TRBV28	TRBJ2-7
TGTGCCACCAGCAGCCGCAGTCAGCCCCAGCATTTT	CATSSRSQPQHF	TRBV15	TRBJ1-5
TGCCCACCGCGACTAGCGGTTGAGAACCAAGAGACCCAGTACTTC	CPPRLAVENQETQYF	TRBV20-1	TRBJ2-5
TGCAGTGCTCTGGAGGATGGTGGGGACTACGAGCAGTACTTC	CSALEDGGDYEQYF	TRBV20-1	TRBJ2-7
TGTGCCAGCAGCCTAGCGGGACCCAATGAGCAGTTCTTC	CASSLAGPNEQFF	TRBV14	TRBJ2-1
TGTGCTATCAGGGGGACTGAAGCTTTCTTT	CAIRGTEAFF	TRBV7-7	TRBJ1-1
TGTGCCAGCTCACCGCCAGGAGGGGGGAGAAAGAACACTGAAGCTTTCTTT	CASSPPGGGRKNTEAFF	TRBV18	TRBJ1-1
TGTGCCAGCCTAGGACAGACTAACTATGGCTACACCTTC	CASLGQTNYGYTF	TRBV6-5	TRBJ1-2
TGTGCCTGGAGTCCTGTCCAGGGCAGGGGTATTAAGGCTGGGGCCAACGTCCTGACTTTC	CAWSPVQGRGIKAGANVLTF	TRBV30	TRBJ2-6
TGCGCCAGCAGCTTGCATTCGGGATCCTACGAGCAGTACTTC	CASSLHSGSYEQYF	TRBV5-1	TRBJ2-7
TGTGCCAGCAGTTCAATGCCCTACCAGAGGGGCAATCAGCCCCAGCATTTT	CASSSMPYQRGNQPQHF	TRBV27	TRBJ1-5
TGTGCCATGCCGGACAGGCCCGAAGCTTTCTTT	CAMPDRPEAFF	TRBV9	TRBJ1-1
TGTGCCAGCATTAGGTTACCGGGGTCGTCGAACACCGGGGAGCTGTTTTTT	CASIRLPGSSNTGELFF	TRBV12-4	TRBJ2-2
TGTGCCAGCAGCGTAGGGGTTCCGGGGTGCCAAGATACGCAGTATTTT	CASSVGVPGCQDTQYF	TRBV9	TRBJ2-3
TGTGCCAGCAGCTTAGTTCGATCTGAGGATACGCAGTATTTT	CASSLVRSEDTQYF	TRBV7-3	TRBJ2-3
TGTGCCAGCAACCCGGGACTAGAGCTTGGCCCCTACGAGCAGTACTTC	CASNPGLELGPYEQYF	TRBV9	TRBJ2-7
TGCGCCAGCAGCTTGGTGAGGGGGGGGGATCCATCGTTTAGCTCCTACAATGAGCAGTTCTTC	CASSLVRGGDPSFSSYNEQFF	TRBV5-1	TRBJ2-1
TGTGTCGTCCGGACGGGGCCCCAAGAGACCCAGTACTTC	CVVRTGPQETQYF	TRBV11-3	TRBJ2-5
TGCAGTGCTCGACTAGCGGGAGACAGGCTAGCCAAAAACATTCAGTACTTC	CSARLAGDRLAKNIQYF	TRBV20-1	TRBJ2-4
TGTGCCACCAGCAGGCCAAGGCAGGGGATCCGCCACCACTACGAGCAGTACTTC	CATSRPRQGIRHHYEQYF	TRBV15	TRBJ2-7
TGCGCCAGGGAGGAACGTGATGGCTACACCTTC	CAREERDGYTF	TRBV10-1	TRBJ1-2
TGTGCCAGCAGTGCCGGCTTCGGTCACTACGAGCAGTACTTC	CASSAGFGHYEQYF	TRBV12-3	TRBJ2-7
TGTGCCACCAGTGATTCTCCGGAGACAGGGAGGTCAGATACGCAGTATTTT	CATSDSPETGRSDTQYF	TRBV24-1	TRBJ2-3
TGTGCCTGGAGTGAAAGACAGGGGGGGACTGGGCTGTTTTTT	CAWSERQGGTGLFF	TRBV30	TRBJ1-4
TGCGCCATTCAGGGCGGGGGGGACAACACTGAAGCTTTCTTT	CAIQGGGDNTEAFF	TRBV10-2	TRBJ1-1
TGTGCCAGCCCGGGGGGGGTATGGCAGTACTTC	CASPGGVWQYF	TRBV5-6	TRBJ2-5
TGTGCCAGCAGCTCGGCAGAGGGTGAAAAACTGTTTTTT	CASSSAEGEKLFF	TRBV5-4	TRBJ1-4
TGTGCCAGCAGCTTACCTCATAGCGGGACTGGAGAGACCCAGTACTTC	CASSLPHSGTGETQYF	TRBV7-7	TRBJ2-5
TGTGCCAGCATGATCGAGAAACTAGCGGATGAGGGGATCTACGAGCAGTACTTC	CASMIEKLADEGIYEQYF	TRBV2	TRBJ2-7
TGTGCCACCGACGGCAGGGGGCTCCGGGCCTACGAGCAGTACTTC	CATDGRGLRAYEQYF	TRBV10-3	TRBJ2-7
TGTGCCAGCAGCTTCAACGGGGCACGGGGCACAGATACGCAGTATTTT	CASSFNGARGTDTQYF	TRBV7-3	TRBJ2-3
TGTGCCAGCAGCTGGGGGGAGAATCAGCCCCAGCATTTT	CASSWGENQPQHF	TRBV7-3	TRBJ1-5
TGTGCCAGCAGCTTCGGGGGGCCCCCAAAGGCCTACGAGCAGTACTTC	CASSFGGPPKAYEQYF	TRBV7-8	TRBJ2-7
TGTGCCTGGAGTGTAATGAACCTTCCGGGACAGCCAAGAACCCCTAAGGACTCTGGAAACACCATATATTTT	CAWSVMNLPGQPRTPKDSGNTIYF	TRBV30	TRBJ1-3
TGTGCCAGCAGCGACGTCCGACATCTGCCCCAGCATTTT	CASSDVRHLPQHF	TRBV6-5	TRBJ1-5
TGCAAGAATGCCGGGGGGGTGCCATACAATGAGCAGTTCTTC	CKNAGGVPYNEQFF	TRBV20-1	TRBJ2-1
TGTGCCAGTAGTCCCGCGGGAGCGCGAGTGAACTCCTACGAGCAGTACTTC	CASSPAGARVNSYEQYF	TRBV19	TRBJ2-7
TGTGCCAGCAGTGACTGTGTAGGGAGGGCAGAAACCGGGGAGCTGTTTTTT	CASSDCVGRAETGELFF	TRBV27	TRBJ2-2
TGTGCCAGTACAGACAGGGAAGGTGAAGAGCCCCAGCATTTT	CASTDREGEEPQHF	TRBV19	TRBJ1-5
TGCAGTGCTAGAGAAGGAACCAGTCCCTGGACTAGCGGGACAGTTTTAAGGTACGAGCAGTACTTC	CSAREGTSPWTSGTVLRYEQYF	TRBV20-1	TRBJ2-7
TGTGCCAGCAGCCAAGGCAACAAGGGACAGGGACGGGACCCTAACTATGGCTACACCTTC	CASSQGNKGQGRDPNYGYTF	TRBV4-2	TRBJ1-2
TGTGCCAGCAGTTTAAGAAAGTGGACAGGGGGCTTGACCCGCTACAATGAGCAGTTCTTC	CASSLRKWTGGLTRYNEQFF	TRBV28	TRBJ2-1
TGTGCCAGCCCAAACGGGGGGCCCGAGCAGTACTTC	CASPNGGPEQYF	TRBV6-4	TRBJ2-7
TGTGCCAGCACAGGCTTCACTGGGGCCAACGTCCTGACTTTC	CASTGFTGANVLTF	TRBV6-4	TRBJ2-6
TGTGCCAGATATAGACGGCGCACTTTCGACCAAGAGACCCAGTACTTC	CARYRRRTFDQETQYF	TRBV18	TRBJ2-5
TGTGCCAGCAGCTTCCCGCGGCTATACAATGAGCAGTTCTTC	CASSFPRLYNEQFF	TRBV7-3	TRBJ2-1
TGTGCCAGCAGAGGATCGGGGGGACAGGGGGCAAACACTGAAGCTTTCTTT	CASRGSGGQGANTEAFF	TRBV12-4	TRBJ1-1
TGCAGTGCTAGAGAAACAGGGTGTTCGCCTTCACCCCTCCACTTT	CSARETGCSPSPLHF	TRBV20-1	TRBJ1-6
TGCAGTGCTGACCCGACAGGGGGGGAGGCCGGGGAGCTGTTTTTT	CSADPTGGEAGELFF	TRBV20-1	TRBJ2-2
TGTGCCACCAGTGCCAACTTGCTAGCGTGGGACATTCAGTACTTC	CATSANLLAWDIQYF	TRBV24-1	TRBJ2-4
TGTGCCAGCCTACAGAGAGGGCTTGAGTACAATGAGCAGTTCTTC	CASLQRGLEYNEQFF	TRBV9	TRBJ2-1
TGTGCCAGCAGCGGCGTAGGCCAGGGGGCTTACGAGCAGTACTTC	CASSGVGQGAYEQYF	TRBV9	TRBJ2-7
TGTGCCAGCAGCCCATTGACTAGCGGCGCGGGAGAGACCCAGTACTTC	CASSPLTSGAGETQYF	TRBV13	TRBJ2-5
TGTGCCAGCAGTTTATACATAGGAGGGGGGCGAGGACCCTATGGCTACACCTTC	CASSLYIGGGRGPYGYTF	TRBV27	TRBJ1-2
TGTGCCAGTACTGCCACGGATAGGGGCAATCAGCCCCAGCATTTT	CASTATDRGNQPQHF	TRBV6-5	TRBJ1-5
TGTGCCACCAGCAGAGACGGACAGGGTGGGACCCAGTACTTC	CATSRDGQGGTQYF	TRBV15	TRBJ2-5
TGTGCCAGCAGTGAACGGCATTTTCTTGAAAAACTGTTTTTT	CASSERHFLEKLFF	TRBV2	TRBJ1-4
TGTGCCAGCAGCTCGGGGTCGGTGGGGTTTATGGGAAATGAAAAACTGTTTTTT	CASSSGSVGFMGNEKLFF	TRBV7-4	TRBJ1-4
TGTGCCAGCAGCTACCGGGACAGTCGAGAAAAACTGTTTTTT	CASSYRDSREKLFF	TRBV6-1	TRBJ1-4
TGCGCCAGCAGCGCCCCCCCTCTGGCCCTCGAAAAACTGTTTTTT	CASSAPPLALEKLFF	TRBV5-1	TRBJ1-4
TGTGCCAGCAGACATTGGTCGGACAGAGCCACTGAAGCTTTCTTT	CASRHWSDRATEAFF	TRBV28	TRBJ1-1
TGTGCCAGCAGCCAAGCCCAGCGGGATCCCGGCTACACCTTC	CASSQAQRDPGYTF	TRBV14	TRBJ1-2
TGTGCCAGCATAATTCGCGGGAGCAGGTACAATGAGCAGTTCTTC	CASIIRGSRYNEQFF	TRBV27	TRBJ2-1
TGTGCCATCAGTGAGTCGTTAGCGGGACTAGGGAGCAACGAGCAGTACTTC	CAISESLAGLGSNEQYF	TRBV10-3	TRBJ2-7
TGTGCCACCGGGAGCCGGGACAGAATAAATCAGCCCCAGCATTTT	CATGSRDRINQPQHF	TRBV24-1	TRBJ1-5
TGCAGTGCTAGGGGGGGGAGGGTCCTAATGGATACGCAGTATTTT	CSARGGRVLMDTQYF	TRBV20-1	TRBJ2-3
TGTGCCAGCAGTGGACGGGGATTTGAGACCCAGTACTTC	CASSGRGFETQYF	TRBV6-8	TRBJ2-5
TGTGCCAGCCTTGGGACTAGCGGGGACTACGAGCAGTACTTC	CASLGTSGDYEQYF	TRBV6-5	TRBJ2-7
TGTGCCAGCAGATTTACAGGGCTTGGAGAGGAGACCCAGTACTTC	CASRFTGLGEETQYF	TRBV6-5	TRBJ2-5
TGTGCCAGCAGTATCCCCAGGGGGGGGAACTACGAGCAGTACTTC	CASSIPRGGNYEQYF	TRBV6-2	TRBJ2-7
TGTGCCAGCAGCCAAGCGAAAAGACAGGGTATCTCCTACGAGCAGTACTTC	CASSQAKRQGISYEQYF	TRBV14	TRBJ2-7
TGTGCCACCAGCCGATGTTCGGGGAACACCATATATTTT	CATSRCSGNTIYF	TRBV24-1	TRBJ1-3
TGCAGTGCTAACTCCCCCCCGGACCCCAACACCGGGGAGCTGTTTTTT	CSANSPPDPNTGELFF	TRBV20-1	TRBJ2-2
TGTGCCAGCAGTTACTCGGGGCTTCAGCCCCAGCATTTT	CASSYSGLQPQHF	TRBV6-6	TRBJ1-5
TGTGCCAGCAGTGCTATCCCTAAGACAGAAGACACCAAGCCCCAGCATTTT	CASSAIPKTEDTKPQHF	TRBV6-1	TRBJ1-5
TGCATTAACGACAGTGAGACGAACACCGGGGAGCTGTTTTTT	CINDSETNTGELFF	TRBV20-1	TRBJ2-2
TGTGCCAGCAGTTACAAGCTCCAAGAGACCCAGTACTTC	CASSYKLQETQYF	TRBV6-2	TRBJ2-5
TGTGCCAGCTTCGCCGCCGGGACAAGATCCTATAATTCACCCCTCCACTTT	CASFAAGTRSYNSPLHF	TRBV11-2	TRBJ1-6
TGCAGTGCTGACGGACAGGGATGGCAGTTCTTC	CSADGQGWQFF	TRBV20-1	TRBJ2-1
TGTGCCGGAGCCAAAGACAGGGTGGGAAGCACAGATACGCAGTATTTT	CAGAKDRVGSTDTQYF	TRBV28	TRBJ2-3
TGTGCCAGCAGCGCGGACAGGGCAGATACGCAGTATTTT	CASSADRADTQYF	TRBV5-5	TRBJ2-3
TGTGCCAGCAGCGTAGGGCTGCTCGCTTTGCGAGAGACCCAGTACTTC	CASSVGLLALRETQYF	TRBV9	TRBJ2-5
TGTGCCAGCAGCCCTCGCGGGTATAGCACAGATACGCAGTATTTT	CASSPRGYSTDTQYF	TRBV3-1	TRBJ2-3
TGTGCCAGCAGTTACTCGACCCAAGAGGCGCCAGGGACATCCGATTCCTACGAGCAGTACTTC	CASSYSTQEAPGTSDSYEQYF	TRBV6-8	TRBJ2-7
TGTGCCAGCAGCTTAACCCTGATCAGTGGTAATGAGCAGTTCTTC	CASSLTLISGNEQFF	TRBV11-3	TRBJ2-1
TGTGCCAGCAGCGTAGCATCATGGGAAAGGACTAGAAGCACAGATACGCAGTATTTT	CASSVASWERTRSTDTQYF	TRBV9	TRBJ2-3
TGCAGCGTTGAACCACAGGCAGATACGCAGTATTTT	CSVEPQADTQYF	TRBV29-1	TRBJ2-3
TGTGCCTGGAGTGTACGGGGGAGGGATAGCACTGAAGCTTTCTTT	CAWSVRGRDSTEAFF	TRBV30	TRBJ1-1
TGTGCCAGCAGCTTAGAGTGGACAAGGAACACTGAAGCTTTCTTT	CASSLEWTRNTEAFF	TRBV7-9	TRBJ1-1
TGTGCCAGCAGTGATTGGGCTGAAAAACTGTTTTTT	CASSDWAEKLFF	TRBV6-2	TRBJ1-4
TGTGCTAGTGGTTTAGGCTTACGAAATCAGCCCCAGCATTTT	CASGLGLRNQPQHF	TRBV12-5	TRBJ1-5
TGTGCCAGCAGTTTATCCGGAGGCGGGACAGGGCGGGGTACGCATTTT	CASSLSGGGTGRGTHF	TRBV27	TRBJ1-5
TGTGCCAGCAGTTACCTATTGGGACTAGCGGGTAGGAAAGAGACCCAGTACTTC	CASSYLLGLAGRKETQYF	TRBV6-5	TRBJ2-5
TGTGCCAGCAGCTTATGCGAGACCCCGGGGTACGAGCAGTACTTC	CASSLCETPGYEQYF	TRBV7-2	TRBJ2-7
TGTGCCAGCAGCGTAGGCGGTCGGGCGAGGGGGGCCTACGGTCGGTGCACAGATACGCAGTATTTT	CASSVGGRARGAYGRCTDTQYF	TRBV9	TRBJ2-3
