TGTGCCAGCAGTGTTCTCCCGGGGGAGGAGGGCGGGGAGCTGTTTTTT	CASSVLPGEEGGELFF	TRBV6-4	TRBJ2-2
TGCAGCGAGTCCGCGGGAGGACAGCCCCAGCATTTT	CSESAGGQPQHF	TRBV20-1	TRBJ1-5
TGTGCCAGCAGCACTAGCGGGAGCTCATTCTCCTACAATGAGCAGTTCTTC	CASSTSGSSFSYNEQFF	TRBV13	TRBJ2-1
TGTGCCAGCAGCTTAGGGGGGGGGAGGTACGAGCAGTACTTC	CASSLGGGRYEQYF	TRBV7-4	TRBJ2-7
TGTGCCTGGAGTGTACTGCAACTTTCCAGGACCTACAATCAGCCCCAGCATTTT	CAWSVLQLSRTYNQPQHF	TRBV30	TRBJ1-5
TGCAGTGCTAGATTTCTAATTAATCAGCCCCAGCATTTT	CSARFLINQPQHF	TRBV20-1	TRBJ1-5
TGTGCCAGTAGTACCCAACACTTCTACACCGGGACATTAGCCTATGGCTACACCTTC	CASSTQHFYTGTLAYGYTF	TRBV19	TRBJ1-2
TGTGCCAGCAGCGATACCGCCAAAAACATTCAGTACTTC	CASSDTAKNIQYF	TRBV7-2	TRBJ2-4
TGTGCCAGCAGTTTAAATGGACCAGACACCGGGGAGCTGTTTTTT	CASSLNGPDTGELFF	TRBV12-3	TRBJ2-2
TGTGCCAGCAGCATGGGGGGCGAGACTGAAAAACTGTTTTTT	CASSMGGETEKLFF	TRBV7-3	TRBJ1-4
TGTGCCAGGGGTTGCCTCTACGAGCAGTACTTC	CARGCLYEQYF	TRBV2	TRBJ2-7
TGCAGCGTTGCCGATGCCAAAGGCGGGAGTTTCTACGAGCAGTACTTC	CSVADAKGGSFYEQYF	TRBV29-1	TRBJ2-7
TGTGCCAGCCGACGTTTGGAAATGTACAATGAGCAGTTCTTC	CASRRLEMYNEQFF	TRBV2	TRBJ2-1
TGTGCCACCAGTGATTTGCCCTCCGGGTGCGGTGGCTACACCTTC	CATSDLPSGCGGYTF	TRBV24-1	TRBJ1-2
TGTGCTAGTGGTTTTCATGTCGCTTCCCCCCGGGGCATCGAGCAGTACTTC	CASGFHVASPRGIEQYF	TRBV12-5	TRBJ2-7
TGTGCCAGCAGCGACGACTCCTACAATGAGCAGTTCTTC	CASSDDSYNEQFF	TRBV9	TRBJ2-1
TGCGCCAGCAGGGGGAGGGACGATTGCACAGATACGCAGTATTTT	CASRGRDDCTDTQYF	TRBV10-1	TRBJ2-3
TGTGCCAGCAGAGACGGGCGCAACTACGAGCAGTACTTC	CASRDGRNYEQYF	TRBV6-5	TRBJ2-7
TGTGCCAGCAGCTTTTTTGGGGGCGGTGGGAGAAGAGAGCAGTACTTC	CASSFFGGGGRREQYF	TRBV7-8	TRBJ2-7
TGTGCCACCAGTGATAATAGCTTCCGGGCCAGACTATACAAGCCGTACGAGCAGTACTTC	CATSDNSFRARLYKPYEQYF	TRBV24-1	TRBJ2-7
TGCGCCAGCCGATCAGAATATCAGCCCCAGCATTTT	CASRSEYQPQHF	TRBV5-1	TRBJ1-5
TGTGCCAGCCCGGGACAGGGGGGGGAGTCCGGGGAGCTGTTTTTT	CASPGQGGESGELFF	TRBV6-5	TRBJ2-2
TGTGCCACCAGCAGAGATCTCCAAAAGGACAGGGTTCCAAATGAGCAGTTCTTC	CATSRDLQKDRVPNEQFF	TRBV15	TRBJ2-1
TGTGCCAGCAGTGGTAGCTGCCACAATGAGCAGTTCTTC	CASSGSCHNEQFF	TRBV14	TRBJ2-1
TGTGCCACCAGTGCGGGACCCTACCTTGGAAACACCATATATTTT	CATSAGPYLGNTIYF	TRBV24-1	TRBJ1-3
TGTGCCAGCAGTACCGGGGTTCCGCCCAATGAGCAGTTCTTC	CASSTGVPPNEQFF	TRBV27	TRBJ2-1
TGTGCCAGTAGTATCCAAGGCACCTTTTCCTATGGCTACACCTTC	CASSIQGTFSYGYTF	TRBV19	TRBJ1-2
TGTGCCAGCAGAGGCGGGAGACAAAAGTACAATGAGCAGTTCTTC	CASRGGRQKYNEQFF	TRBV6-5	TRBJ2-1
TGTGCCAGCAGTATGACCAAGCGGGACGGTGTAAACACTGGAAACACCATATATTTT	CASSMTKRDGVNTGNTIYF	TRBV28	TRBJ1-3
TGCGCCAGCAGCTTGTTACAGGGTAGTGAAAAACTGTTTTTT	CASSLLQGSEKLFF	TRBV5-1	TRBJ1-4
TGTGCCAGCAGCTTCCGGACATCGGAGATGCCACCCTACGAGCAGTACTTC	CASSFRTSEMPPYEQYF	TRBV7-3	TRBJ2-7
TGTGCCAGCAGTGACAGCAGGACGAATAATTCACCCCTCCACTTT	CASSDSRTNNSPLHF	TRBV2	TRBJ1-6
TGTGCCAGCAGCCGGATCCCGGGACGAGGTGGATTTTACGAGCAGTACTTC	CASSRIPGRGGFYEQYF	TRBV11-3	TRBJ2-7
TGTGCCTGGAAAGGGGGGGGACGCACCGGGGAGCTGTTTTTT	CAWKGGGRTGELFF	TRBV30	TRBJ2-2
TGTGCCATGCGGGGACTCCACCTCGAAAATCAGCCCCAGCATTTT	CAMRGLHLENQPQHF	TRBV2	TRBJ1-5
TGTGCCAGCAGCCCCGGGACAGGTCTCTTGAACACTGAAGCTTTCTTT	CASSPGTGLLNTEAFF	TRBV7-2	TRBJ1-1
TGTGCCAGTAGTATAGTTACCCTTTCAGCGAACCCCTCCTACAATGAGCAGTTCTTC	CASSIVTLSANPSYNEQFF	TRBV19	TRBJ2-1
TGTGCCAGCTCACTACAGGGGCCCCAATACACTGAAGCTTTCTTT	CASSLQGPQYTEAFF	TRBV18	TRBJ1-1
TGTGCCAGCAGCCTGGTGAGGACGTCGAAACTGTTTTTT	CASSLVRTSKLFF	TRBV13	TRBJ1-4
TGCGCCAGCAGCCAATTACGACAGCCCTCCTACGAGCAGTACTTC	CASSQLRQPSYEQYF	TRBV4-1	TRBJ2-7
TGCGCCAGCAGCCAAGGATCCGTATCTCGTTTTGAGCAGTTCTTC	CASSQGSVSRFEQFF	TRBV4-3	TRBJ2-1
TGTGCCAGCAGCGCGGCTACAAGCCCCCGGGACAGCTTTACTTCCCACGAGCAGTACTTC	CASSAATSPRDSFTSHEQYF	TRBV9	TRBJ2-7
TGTGCCAGCGCGCGACGGGCCGGGACGAACACCGGGGAGCTGTTTTTT	CASARRAGTNTGELFF	TRBV6-1	TRBJ2-2
TGTGCCAGCAGGTCAGGGGAAATTTCACCCCTCCACTTT	CASRSGEISPLHF	TRBV28	TRBJ1-6
TGTGCCAGCGCCCAAAGCTATTGCTACGAGCAGTACTTC	CASAQSYCYEQYF	TRBV25-1	TRBJ2-7
TGTGCCAGCACCCCCGTACAGGGTTTCCTCGTGCGAAAACTGTTTTTT	CASTPVQGFLVRKLFF	TRBV6-5	TRBJ1-4
TGCAGTGCTAGAGCCTTAGGACTAGGGGGGCCGAGGTCCACCGGGGAGCTGTTTTTT	CSARALGLGGPRSTGELFF	TRBV20-1	TRBJ2-2
TGTGCCAGCAGTTTCTGGTTGGGACAGTATCAGCCCCAGCATTTT	CASSFWLGQYQPQHF	TRBV27	TRBJ1-5
TGTGCCAGCAGTTACACCGACAGGGGGTTTTCTGGCTACACCTTC	CASSYTDRGFSGYTF	TRBV6-6	TRBJ1-2
TGTGCCAGTATAACAGACAGGGAGAAGGGTCCCACCTACGAGCAGTACTTC	CASITDREKGPTYEQYF	TRBV19	TRBJ2-7
TGTGCCAGCAGTTTGGACAGGGGCTATGGCTACACCTTC	CASSLDRGYGYTF	TRBV27	TRBJ1-2
TGTGCCAGCAGCTTACATACTAGCGGCACAGATACGCAGTATTTT	CASSLHTSGTDTQYF	TRBV5-4	TRBJ2-3
TGTGCCAGCAGACTAGGGCGGGTCTCTGGAAACACCATATATTTT	CASRLGRVSGNTIYF	TRBV6-5	TRBJ1-3
TGTGCCAGCAGCCCCCGGAGAGGGACAGGGACCGGGGAGCTGTTTTTT	CASSPRRGTGTGELFF	TRBV5-4	TRBJ2-2
TGTGCCAGCAGCCAAGCCGGGACAGGGGTGAACACTGAAGCTTTCTTT	CASSQAGTGVNTEAFF	TRBV3-1	TRBJ1-1
TGTGCCAGCAGTGATCCAATGACAGGGGAGCTGTTTTTT	CASSDPMTGELFF	TRBV6-1	TRBJ2-2
TGTGCCATCAGTGAGCCCCGACAGCTGCCTCTTTCTGACGAGCAGTACTTC	CAISEPRQLPLSDEQYF	TRBV10-3	TRBJ2-7
TGTGCCAGCAGCTTAGACCGGGACAGGGGTGGAATCCGCACAGATACGCAGTATTTT	CASSLDRDRGGIRTDTQYF	TRBV11-3	TRBJ2-3
TGTGCCAGCTTAACCCATACAGGGGAGTATAGCAATCAGCCCCAGCATTTT	CASLTHTGEYSNQPQHF	TRBV2	TRBJ1-5
TGTGCCAGCAGTGAATGGACAGGGACCACACTGAACACTGAAGCTTTCTTT	CASSEWTGTTLNTEAFF	TRBV25-1	TRBJ1-1
TGTGCCAGCACCATGGGGCGCCGAGATTCACCCCTCCACTTT	CASTMGRRDSPLHF	TRBV28	TRBJ1-6
TGCGCCAGCAGCCACTTCACTAGCGGGAGGGCTTTCTTT	CASSHFTSGRAFF	TRBV4-3	TRBJ1-1
TGTGCCAGTGACCCCATGGACAGGGGGGGGACTCAGCCCCAGCATTTT	CASDPMDRGGTQPQHF	TRBV13	TRBJ1-5
TGTGCCAGCAGTTTAGCGCGACGGGGGAATGAAAAACTGTTTTTT	CASSLARRGNEKLFF	TRBV12-4	TRBJ1-4
TGTGCCAAAGAGGCCTCGCGGGGGGACAGGGGAGATTCCTATAATTCACCCCTCCACTTT	CAKEASRGDRGDSYNSPLHF	TRBV12-3	TRBJ1-6
TGTGCCAGCAGTTTTTGTATATCTTCACGACCGTACCAAGAGACCCAGTACTTC	CASSFCISSRPYQETQYF	TRBV27	TRBJ2-5
TGTGCCAGCAGCTTGGGGGGCCCCTACGAGCAGTACTTC	CASSLGGPYEQYF	TRBV6-4	TRBJ2-7
TGTGCCAGCAGCCCCCCCACAGGGGGGACCGAAAAACTGTTTTTT	CASSPPTGGTEKLFF	TRBV6-1	TRBJ1-4
TGCAGTGCTGTGGGTGAGGGACAGGGATGGAACACCGGGGAGCTGTTTTTT	CSAVGEGQGWNTGELFF	TRBV20-1	TRBJ2-2
TGTGCCAGCAGAAGACCTCTAACTTTCACCGGGGAGCTGTTTTTT	CASRRPLTFTGELFF	TRBV7-4	TRBJ2-2
TGCAGTGTAAAAGGGCCGGGCCCGCCCTACGAGCAGTACTTC	CSVKGPGPPYEQYF	TRBV20-1	TRBJ2-7
TGTGCCAGTAGTCCGCGCGGGGGGCCCGGGGAGCTGTTTTTT	CASSPRGGPGELFF	TRBV19	TRBJ2-2
TGTGCCAGCAGCTTCTTTAAGGGGCGGTACAATCAGCCCCAGCATTTT	CASSFFKGRYNQPQHF	TRBV13	TRBJ1-5
TGTGCCAGCAGCGAGGGGACTAACACTGAAGCTTTCTTT	CASSEGTNTEAFF	TRBV5-6	TRBJ1-1
TGTGCCAGCAGTTTGCCCACTAGCGGGAGGGCGCAACTGTTTTTT	CASSLPTSGRAQLFF	TRBV6-5	TRBJ1-4
TGTGCCAGCAGCCAAGATTACAGGGGGTCCTACGAGCAGTACTTC	CASSQDYRGSYEQYF	TRBV4-2	TRBJ2-7
TGCGCCAGCAGTGGGGACAGGGATGTATTTAATTCACCCCTCCACTTT	CASSGDRDVFNSPLHF	TRBV10-1	TRBJ1-6
TGTGCCAGCAGCCAAGCCTACGAGCAGTACTTC	CASSQAYEQYF	TRBV4-2	TRBJ2-7
TGTGCCAGTAGTTTAGGGGGGGGATTCCAAGAGACCCAGTACTTC	CASSLGGGFQETQYF	TRBV19	TRBJ2-5
TGCGCCAGCAGCGGCCCGGGGGGCAGGAACACTGAAGCTTTCTTT	CASSGPGGRNTEAFF	TRBV5-1	TRBJ1-1
TGTGCCAGCAGTTCAGGGCAGGGGGGGAATGGCTACACCTTC	CASSSGQGGNGYTF	TRBV6-5	TRBJ1-2
TGTGCCAGCAGCAGCGGGAGTAGCAATCAGCCCCAGCATTTT	CASSSGSSNQPQHF	TRBV7-9	TRBJ1-5
TGTGCCAGCAGCTCGCCCCCGGGACAGGGGGCGGTTTACGAGCAGTACTTC	CASSSPPGQGAVYEQYF	TRBV6-4	TRBJ2-7
TGCGCCAGCAGTTTGGACGGCAACCTCCAATACGAGCAGTACTTC	CASSLDGNLQYEQYF	TRBV10-1	TRBJ2-7
TGCAGCGTCATATGGCCCCGGGACAGCTGCACTGAAGCTTTCTTT	CSVIWPRDSCTEAFF	TRBV29-1	TRBJ1-1
TGTGCCAGCAGTTTAAAGAGGACTAGCGCCCGAGTAGGAGGTACTGAGACCCAGTACTTC	CASSLKRTSARVGGTETQYF	TRBV12-3	TRBJ2-5
TGTGCCAGCAGCGAAAGCGGGAGGAGGCGCACAGATACGCAGTATTTT	CASSESGRRRTDTQYF	TRBV13	TRBJ2-3
TGTGCCAGCAGTTTAAGCAATCCCGGGGGGGGATTCGACAATGAGCAGTTCTTC	CASSLSNPGGGFDNEQFF	TRBV28	TRBJ2-1
TGCGCCAGCAGCTTGATGAACACACTAGCGGGAGTGGTATTCACTGAAGCTTTCTTT	CASSLMNTLAGVVFTEAFF	TRBV5-1	TRBJ1-1
TGTGCCAGCCCAGCAGCGTTGGAGCAGTACTTC	CASPAALEQYF	TRBV18	TRBJ2-7
TGTGCTAGTGGTTTGGTACTTCCGGACGGTAGCTCCTACGAGCAGTACTTC	CASGLVLPDGSSYEQYF	TRBV12-5	TRBJ2-7
TGCAGCGCCCAGGGGGGACTAGCGGGTTCCTACGAGCAGTACTTC	CSAQGGLAGSYEQYF	TRBV29-1	TRBJ2-7
TGTGCCAGCAGGGTATACGGGACACAGAGGCGGGAGTTGACCGGGGAGCTGTTTTTT	CASRVYGTQRRELTGELFF	TRBV13	TRBJ2-2
TGTGCCAGCAGAGCGCCGACGGACACTGAAGCTTTCTTT	CASRAPTDTEAFF	TRBV12-3	TRBJ1-1
TGTGCCAGCAGCGGAGGTGGTACAGGGGGCATACAGAGCTCCTACAATGAGCAGTTCTTC	CASSGGGTGGIQSSYNEQFF	TRBV7-2	TRBJ2-1
TGCAGCGTTGAACGGACAGGTTTGGGCTACACCTTC	CSVERTGLGYTF	TRBV29-1	TRBJ1-2
TGTGCCTGGAGTGTGGTCGTCTACGAGCAGTACTTC	CAWSVVVYEQYF	TRBV30	TRBJ2-7
TGTGCCAGCAGCTTGGGGACAGACTACGAGCAGTACTTC	CASSLGTDYEQYF	TRBV11-3	TRBJ2-7
TGCGCCAGCAGCTTGGGTGGGAAGTTCTTAGCGGACAGCGCTGGCTACACCTTC	CASSLGGKFLADSAGYTF	TRBV5-1	TRBJ1-2
TGTGCCAGCAGCCTAGTCCCTTCAGGCTACGAGCAGTACTTC	CASSLVPSGYEQYF	TRBV9	TRBJ2-7
