TGTGCCAGCGTGGACTTGCCAGGGTACGAGCAGTACTTC	CASVDLPGYEQYF	TRBV6-4	TRBJ2-7
TGTGCCACCAGTGGGGGGGCCTCATCATGGGGGGAGCTGTTTTTT	CATSGGASSWGELFF	TRBV24-1	TRBJ2-2
TGTGCCACCAGTGCCACCATGCCGGAGGGCGGCTCCTACGAGCAGTACTTC	CATSATMPEGGSYEQYF	TRBV24-1	TRBJ2-7
TGCGCCAGCAGCTTGGACAGGGGACACTACGAGCAGTACTTC	CASSLDRGHYEQYF	TRBV5-1	TRBJ2-7
TGTGCCAGCAGCCAAGATAACCCCCTAGAGAGATTGAACACTGAAGCTTTCTTT	CASSQDNPLERLNTEAFF	TRBV14	TRBJ1-1
TGTGCCAGCAGTGAGGGCGAAATCACAGATACGCAGTATTTT	CASSEGEITDTQYF	TRBV6-1	TRBJ2-3
TGTGCCAGCAGTTTGGGACAGGGGTGGGACAATTCACCCCTCCACTTT	CASSLGQGWDNSPLHF	TRBV28	TRBJ1-6
TGCGCCAGCAGCCAAGTGACAGGGTCTCACTCTGGCTACACCTTC	CASSQVTGSHSGYTF	TRBV4-1	TRBJ1-2
TGCAGTGCTAGAGACAACTCACGGGACAGGGCGAGTCCTGAGTTCTATAGCAATCAGCCCCAGCATTTT	CSARDNSRDRASPEFYSNQPQHF	TRBV20-1	TRBJ1-5
TGTGCCAGCAGCGGAAGGAGCAATCAGCCCCAGCATTTT	CASSGRSNQPQHF	TRBV6-1	TRBJ1-5
TGCGCCAGCAGCAAAGAGACAGGCACTGAAGCTTTCTTT	CASSKETGTEAFF	TRBV5-1	TRBJ1-1
TGTGACGGACAGGGGGGGGGAGAAGCGTATAGCAATCAGCCCCAGCATTTT	CDGQGGGEAYSNQPQHF	TRBV28	TRBJ1-5
TGTGCCAGCCGGGACACTTTCGATACGCAGTATTTT	CASRDTFDTQYF	TRBV7-6	TRBJ2-3
TGTGCCAGCAGTTTATGGACACGGGGGCCCTACGAGCAGTACTTC	CASSLWTRGPYEQYF	TRBV28	TRBJ2-7
TGTGCCAGCAGCTCGCAGGGCGAGCAGTACTTC	CASSSQGEQYF	TRBV12-3	TRBJ2-7
TGTGCCAGCAGTTTACCCAGGACAGGGACCCGTCACGAGCAGTACTTC	CASSLPRTGTRHEQYF	TRBV12-3	TRBJ2-7
TGTGCCAGCAGAAAGCGCTACACCGGGGAGCTGTTTTTT	CASRKRYTGELFF	TRBV6-4	TRBJ2-2
TGTGCCAGCAGCCGGACGACCGACGAGCAGTACTTC	CASSRTTDEQYF	TRBV14	TRBJ2-7
TGTGCCAGCAGGGATCCCTGGCTGAACAATCAGCCCCAGCATTTT	CASRDPWLNNQPQHF	TRBV28	TRBJ1-5
TGCAGTGCTAGACCACAGGGGAAGGGCGAGCAGTACTTC	CSARPQGKGEQYF	TRBV20-1	TRBJ2-7
TGTGCCAGCAGCCCGGGGTTCGTAGACACTGAAGCTTTCTTT	CASSPGFVDTEAFF	TRBV7-9	TRBJ1-1
TGTGCCAGCAGTTATTCCGGGACGTATGGGTATGGCTACACCTTC	CASSYSGTYGYGYTF	TRBV6-1	TRBJ1-2
TGCAGTGCGGGGGCACCTGCAACTAATGAAAAACTGTTTTTT	CSAGAPATNEKLFF	TRBV20-1	TRBJ1-4
TGTGCCAGCAGCGGAGGGGGCCCGCTGAATGAGCAGTTCTTC	CASSGGGPLNEQFF	TRBV7-9	TRBJ2-1
TGTGCCAGCAGCTCACGAAGCTCCTACAATGAGCAGTTCTTC	CASSSRSSYNEQFF	TRBV11-2	TRBJ2-1
TGCGCCAGCAGCCGCGGAGTGAGAAGCTCCTATAATTCACCCCTCCACTTT	CASSRGVRSSYNSPLHF	TRBV5-1	TRBJ1-6
TGTGCCCCGAGAGCGACTCAATTAAATGGCTACACCTTC	CAPRATQLNGYTF	TRBV19	TRBJ1-2
TGTGCCAGCACAAGTTGGGGACAGGGGGCTAGGGCCTACGAGCAGTACTTC	CASTSWGQGARAYEQYF	TRBV28	TRBJ2-7
TGTGCCAGCAGCCCAGGGGGCGGTGAAAAACTGTTTTTT	CASSPGGGEKLFF	TRBV11-2	TRBJ1-4
TGTGCCAGCAGCTTTCTTGGCCGGGGGCCCCTCTCCTACGAGCAGTACTTC	CASSFLGRGPLSYEQYF	TRBV5-4	TRBJ2-7
TGTGCCAGCAGTGAAGCTCCGCGAGCTGATCATTACAATGAGCAGTTCTTC	CASSEAPRADHYNEQFF	TRBV6-1	TRBJ2-1
TGTGCCAGCAGCTCCGGGACAGTCATAGCTTTCTTT	CASSSGTVIAFF	TRBV5-4	TRBJ1-1
TGCGCCAGCAGCTTTCTTGACAGGGGGGATTACTGCGAGCAGTACTTC	CASSFLDRGDYCEQYF	TRBV5-1	TRBJ2-7
TGTGCCAGCAGCTTAGCCGTTTCCGTCGGAAGTTATGAGCAGTTCTTC	CASSLAVSVGSYEQFF	TRBV7-9	TRBJ2-1
TGTGCCAGCAAAAGGAGGTTGAGCAATCAGCCCCAGCATTTT	CASKRRLSNQPQHF	TRBV28	TRBJ1-5
TGTGCCAGCCTAGGACAGGGACAACATCAGCCCCAGCATTTT	CASLGQGQHQPQHF	TRBV6-5	TRBJ1-5
TGTGCCAGCAGAGAAGCCCGGGACAGTCCGGATGAGCAGTTCTTC	CASREARDSPDEQFF	TRBV11-2	TRBJ2-1
TGCGCCAGCAGCTTGGATCCCGGGACAGGGGATTATCATACAGATACGCAGTATTTT	CASSLDPGTGDYHTDTQYF	TRBV5-1	TRBJ2-3
TGTGCCACTCGTAGCGGGAGTTATCAGCCCCAGCATTTT	CATRSGSYQPQHF	TRBV7-7	TRBJ1-5
TGTGCCAGCAGGAATCTCAGGGGGGCCCAAGAGACCCAGTACTTC	CASRNLRGAQETQYF	TRBV6-4	TRBJ2-5
TGTGCCAGCAGCTTAGAAGGTCTCCCGGGACATGCCAATGAAAAACTGTTTTTT	CASSLEGLPGHANEKLFF	TRBV11-3	TRBJ1-4
TGTGCCAGCAGTGGGAATGAAGACAGGGGGCGCTCCTATAATTCACCCCTCCACTTT	CASSGNEDRGRSYNSPLHF	TRBV25-1	TRBJ1-6
TGCGCCGGCAGGCAGTTCTTC	CAGRQFF	TRBV10-1	TRBJ2-1
TGCGCCAGCAGCTTGATCAGACAGGGGGGCTATGGCTACACCTTC	CASSLIRQGGYGYTF	TRBV5-1	TRBJ1-2
TGCGCCAGCCTAAACCGGACCGAGCAGTACTTC	CASLNRTEQYF	TRBV5-1	TRBJ2-7
TGTAGGGGGGAGGACTTTGAGCAGTACTTC	CRGEDFEQYF	TRBV7-9	TRBJ2-7
TGTGCCAGCAGTGACCTTAAACATCTCGGACAGCTTGAAAAACTGTTTTTT	CASSDLKHLGQLEKLFF	TRBV6-4	TRBJ1-4
TGTGCCAGCAGTTTTCGTGACCAGGGGATCAACGAGCAGTACTTC	CASSFRDQGINEQYF	TRBV12-3	TRBJ2-7
TGTGCCAGCAGCCAAACAACTAGACCACGACAGGGCAGATCTTCGGGGGGCAATGAGCAGTTCTTC	CASSQTTRPRQGRSSGGNEQFF	TRBV3-1	TRBJ2-1
TGTGCCAGCAGCCAACCCGGACTCGGTAGCAATCAGCCCCAGCATTTT	CASSQPGLGSNQPQHF	TRBV3-1	TRBJ1-5
TGTGCCAGCAGTTACGATTGCGACCCTAACTATGGCTACACCTTC	CASSYDCDPNYGYTF	TRBV6-2	TRBJ1-2
TGTGCCAGCATTGCCGGGCCCCTTGAATTCTTT	CASIAGPLEFF	TRBV9	TRBJ1-1
TGTGCCAGCGAGACAGGGGGATACAATGAGCAGTTCTTC	CASETGGYNEQFF	TRBV9	TRBJ2-1
TGCAGTGCTAGTTCCCCGCGGCTACCAGATACGCAGTATTTT	CSASSPRLPDTQYF	TRBV20-1	TRBJ2-3
TGTGCCAGCAGCAAGGAGGGCGACAAGGTTCGAGCCAAAAACATTCAGTACTTC	CASSKEGDKVRAKNIQYF	TRBV7-4	TRBJ2-4
TGTGCCAGCAGCGGGTGGGAAGACTTC	CASSGWEDF	TRBV13	TRBJ1-2
TGCGCCAGCAGAGGGACAGGGGCTTTGAGGAACACCGGGGAGCTGTTTTTT	CASRGTGALRNTGELFF	TRBV10-1	TRBJ2-2
TGCGCCAGCACGTGGGGGGGCCTACTGGCCTACGAGCAGTACTTC	CASTWGGLLAYEQYF	TRBV5-1	TRBJ2-7
TGTGCCACCAGTGATTGCGCGGGTGTTTGGGACGAGCAGTACTTC	CATSDCAGVWDEQYF	TRBV24-1	TRBJ2-7
TGCAGTGCTTGGGTAGGGGGCGGTAAGCAGTACTTC	CSAWVGGGKQYF	TRBV20-1	TRBJ2-7
TGTGCCAGCAGTGACGGACAGGGGTTCCAGCATTTT	CASSDGQGFQHF	TRBV6-4	TRBJ1-5
TGTGCCAGCAGCGCAGGGGGGGATGGCTACACCTTC	CASSAGGDGYTF	TRBV11-3	TRBJ1-2
TGTGCCAGTAGTCACCCTAGCCGACAGGGTCATAGCTCCTACGAGCAGTACTTC	CASSHPSRQGHSSYEQYF	TRBV19	TRBJ2-7
TGTGCCAGCAGCGGACAGGGGGCGCCCTACGAGCAGTACTTC	CASSGQGAPYEQYF	TRBV7-9	TRBJ2-7
TGTGCCAGCAGTGAACAAGGGGGCCCAAACGAGCAGTACTTC	CASSEQGGPNEQYF	TRBV6-1	TRBJ2-7
TGCGCCAGCAGCTTTTACTACGAGCAGTACTTC	CASSFYYEQYF	TRBV5-1	TRBJ2-7
TGTGCCAGCACGTCCGTTTCCGGGACTAGGTCTTACAATGAGCAGTTCTTC	CASTSVSGTRSYNEQFF	TRBV27	TRBJ2-1
TGCGCCAGCAGGTCGGGACAGCCACCGGTGGGTAACTATGGCTACACCTTC	CASRSGQPPVGNYGYTF	TRBV10-1	TRBJ1-2
TGTGCCAGCAGCTTGGGCTCCTGCCTCAGGGAGTCGTACACCATATATTTT	CASSLGSCLRESYTIYF	TRBV5-6	TRBJ1-3
TGTGCCAGCAGCACGAGGGACCCTGGACCGAACACCGGGGAGCTGTTTTTT	CASSTRDPGPNTGELFF	TRBV7-9	TRBJ2-2
TGCGCCAGCCCGACAGGTAGGGATCAGCCCCAGCATTTT	CASPTGRDQPQHF	TRBV5-1	TRBJ1-5
TGTGCCAGCATGTGCGGGGGTTCCGAAGAGACCCAGTACTTC	CASMCGGSEETQYF	TRBV7-9	TRBJ2-5
TGTGCCAGCAGCTCTTACGTCCTGGACAGGGCGGGCTACAATGAGCAGTTCTTC	CASSSYVLDRAGYNEQFF	TRBV7-2	TRBJ2-1
TGTGCCAGTCCCCGGGGGGGGGAAAATTCCCGCACAGATACGCAGTATTTT	CASPRGGENSRTDTQYF	TRBV28	TRBJ2-3
TGTGCCAGCAGCCACTACAGGGCGACTGAAGCTTTCTTT	CASSHYRATEAFF	TRBV14	TRBJ1-1
TGTGCCAGCAGCCGCAGGGCGAAAGAGACCCAGTACTTC	CASSRRAKETQYF	TRBV11-3	TRBJ2-5
TGTGCCAGCAGCCAAGATGGGGAACTTTTACAGCGGGAGGGGGTCTATGGCTACACCTTC	CASSQDGELLQREGVYGYTF	TRBV3-1	TRBJ1-2
TGTGCTAGCAGCTTAGGTCCGCCGGGACTAGGGAAGAGGTTGAACGAGCAGTACTTC	CASSLGPPGLGKRLNEQYF	TRBV7-7	TRBJ2-7
TGCAGTGCTGGGAAAACAGGGTGGGTTCCTGGGGCCAACGTCCTGACTTTC	CSAGKTGWVPGANVLTF	TRBV20-1	TRBJ2-6
TGCGCCAGCAGCTCGGAACAGGGTGGGGAAATGTATTTT	CASSSEQGGEMYF	TRBV5-1	TRBJ1-3
TGTGCCAGCAGCTCCGCCGTAAGGGGAGCCCACTCCTACGAGCAGTACTTC	CASSSAVRGAHSYEQYF	TRBV5-4	TRBJ2-7
TGTGCCAGCATGCGGCGGGAGGATCCCACAGATACGCAGTATTTT	CASMRREDPTDTQYF	TRBV6-4	TRBJ2-3
TGCGCCAGCAGCCAAGGGCGTAATCTCGGGACGGGGTACGAGCAGTACTTC	CASSQGRNLGTGYEQYF	TRBV4-3	TRBJ2-7
TGCAGTGCTAGAGAGTTCTTCCGGGGCTCCGACCAAGAGACCCAGTACTTC	CSAREFFRGSDQETQYF	TRBV20-1	TRBJ2-5
TGTGCCAGCAGGGGCCACCGGGACAGGGGGAGGCACTACGAGCAGTACTTC	CASRGHRDRGRHYEQYF	TRBV11-2	TRBJ2-7
TGTGCCAGAAACCCTCCCGGGCCCGCAACCACAGATACGCAGTATTTT	CARNPPGPATTDTQYF	TRBV6-5	TRBJ2-3
TGTGCCAGCAGCTTAGAGGCGTCCCTCAGGGGGCATGAAAAACTGTTTTTT	CASSLEASLRGHEKLFF	TRBV7-8	TRBJ1-4
TGTGCCACCCTGGTTTATCGGTGGAAGCGAGTGGACACCGGGGAGCTGTTTTTT	CATLVYRWKRVDTGELFF	TRBV24-1	TRBJ2-2
TGTGCCTGGACCGAGGCGTGGGTTGACTACGAGCAGTACTTC	CAWTEAWVDYEQYF	TRBV30	TRBJ2-7
TGTGCCAGCTCACCGGTCGTGCCCGCGCCCAGGTCCTACAATGAGCAGTTCTTC	CASSPVVPAPRSYNEQFF	TRBV18	TRBJ2-1
TGTGCCAGCAGCGGACTGGACCTCAATGAGCAGTTCTTC	CASSGLDLNEQFF	TRBV7-3	TRBJ2-1
TGTGCCAGCAGCGGGGGTGACAGGAGTAATCAGCCCCAGCATTTT	CASSGGDRSNQPQHF	TRBV7-9	TRBJ1-5
TGTGCCAGCAGGCGGGGTCGCAGCAGGGGGCGGAACACTGAAGCTTTCTTT	CASRRGRSRGRNTEAFF	TRBV6-4	TRBJ1-1
TGTGCCAGCAGCGGCTTTTTCTCAAATGAAAAACTGTTTTTT	CASSGFFSNEKLFF	TRBV13	TRBJ1-4
TGTGCCAGCAGTTACGGGGGGAACCGGCATGGCTACACCTTC	CASSYGGNRHGYTF	TRBV6-5	TRBJ1-2
TGTGCCAGCAGTACCTCCCCTAGCCACCCCCCGAACACCGGGGAGCTGTTTTTT	CASSTSPSHPPNTGELFF	TRBV6-1	TRBJ2-2
TGTGCCAGCAGTGGATCCCCGCGAAGGGTGAACACTGAAGCTTTCTTT	CASSGSPRRVNTEAFF	TRBV12-3	TRBJ1-1
TGTGCCAGCAGTCTTAGACTAGCGGGAGCCAAGGGCTACACCTTC	CASSLRLAGAKGYTF	TRBV18	TRBJ1-2
TGTGCCCTCCAGGGTCGGGTGAACACTGAAGCTTTCTTT	CALQGRVNTEAFF	TRBV6-5	TRBJ1-1
TGTGCCAGCAAGTTAGGGGGTTTTTATCAGCCCCAGCATTTT	CASKLGGFYQPQHF	TRBV28	TRBJ1-5
