TGTGCCTGGAGTGTTCCGGGAGGTAATGAAAAACTGTTTTTT	CAWSVPGGNEKLFF	TRBV30	TRBJ1-4
TGTGCCAGCAGACGGACTAGCGGGCGGAGGGAGCTGTTTTTT	CASRRTSGRRELFF	TRBV28	TRBJ2-2
TGCAGTGCTAGAACAGCCCAAGAGACCCAGTACTTC	CSARTAQETQYF	TRBV20-1	TRBJ2-5
TGTGCCAGTGGGACAGGAACGGAAGGGGCCTACGAGCAGTACTTC	CASGTGTEGAYEQYF	TRBV6-4	TRBJ2-7
TGTGCCATCAATACCTCGAGAGGGAATTGGTATAGCAATCAGCCCCAGCATTTT	CAINTSRGNWYSNQPQHF	TRBV10-3	TRBJ1-5
TGTAGGAGACTAGGGAACACTGAAGCTTTCTTT	CRRLGNTEAFF	TRBV27	TRBJ1-1
TGTGCCAGCAGCAGGGTCCTAGGACAGGGTTGTCCCTCTGGAAACACCATATATTTT	CASSRVLGQGCPSGNTIYF	TRBV9	TRBJ1-3
TGTGCCAGCAGCAGAGTGGGCACCGGGGAGCTGTTTTTT	CASSRVGTGELFF	TRBV11-2	TRBJ2-2
TGTGCCAGCTGTGATATGAACACTGAAGCTTTCTTT	CASCDMNTEAFF	TRBV11-3	TRBJ1-1
TGTGCCAGCAAAAGTGGACAGAAAAATAACACTGAAGCTTTCTTT	CASKSGQKNNTEAFF	TRBV7-3	TRBJ1-1
TGCAGTGAGTACAGGGGTCCCCGTTCACCCCTCCACTTT	CSEYRGPRSPLHF	TRBV20-1	TRBJ1-6
TGTGCCAGCAAAAGGGGGGGCCTGTACAATGAGCAGTTCTTC	CASKRGGLYNEQFF	TRBV6-6	TRBJ2-1
TGTGCCAGCAGTTCCCCGGGACATGAAAAACTGTTTTTT	CASSSPGHEKLFF	TRBV27	TRBJ1-4
TGTGCAGATTATAATAGGCGGTCCGACGAGCAGTACTTC	CADYNRRSDEQYF	TRBV11-3	TRBJ2-7
TGTGCCAGCAGCGTCCAGCCCTCCTACGAGCAGTACTTC	CASSVQPSYEQYF	TRBV13	TRBJ2-7
TGCGCCAGCAGCTTGGAACCGGCTGACGAGCAGTACTTC	CASSLEPADEQYF	TRBV5-1	TRBJ2-7
TGTGCTAGTGATGTGGACAGGCATTCACCCCTCCACTTT	CASDVDRHSPLHF	TRBV12-5	TRBJ1-6
TGTGCCAGCAGTTTAGCCGAGGATAACCACGAAAAACTGTTTTTT	CASSLAEDNHEKLFF	TRBV12-4	TRBJ1-4
TGTGCCAGCAGTGACTCGCAGGGTCCGACAGATACGCAGTATTTT	CASSDSQGPTDTQYF	TRBV6-4	TRBJ2-3
TGCGCCAGCAGTGAGTCGGCCTCGCTTGCGACTAACTATGGCTACACCTTC	CASSESASLATNYGYTF	TRBV10-1	TRBJ1-2
TGTGCCAGCAGTGACGGGGGGGGACAGAGTCCCGGGGCCAACGTCCTGACTTTC	CASSDGGGQSPGANVLTF	TRBV6-4	TRBJ2-6
TGCGCCAGCAGCTTGGATTGCGGAGGCACAGATACGCAGTATTTT	CASSLDCGGTDTQYF	TRBV5-1	TRBJ2-3
TGTGCCAGCAGCATACACACGAATTTCCCCGAAGCTTTCTTT	CASSIHTNFPEAFF	TRBV13	TRBJ1-1
TGTGCCCCGGGTCTCGATGAGCAGTTCTTC	CAPGLDEQFF	TRBV6-5	TRBJ2-1
TGCGCCAGCCTACCCCCCACCCGCATGAACACTGAAGCTTTCTTT	CASLPPTRMNTEAFF	TRBV5-1	TRBJ1-1
TGCAGTGCTAGGGCGACCAGAAAAGAGCAGTACTTC	CSARATRKEQYF	TRBV20-1	TRBJ2-7
TGTGCCAGCAGTTACAACGGACAGATACCGAACACCGGGGAGCTGTTTTTT	CASSYNGQIPNTGELFF	TRBV6-5	TRBJ2-2
TGTGCCAGCAGTAGTGAGGGGATCCCTCTGAACACCGGGGAGCTGTTTTTT	CASSSEGIPLNTGELFF	TRBV11-3	TRBJ2-2
TGTGCCAGCTCGCCCAGCCTGGGACCAGGGAAATCTTTATACACCGGGGAGCTGTTTTTT	CASSPSLGPGKSLYTGELFF	TRBV18	TRBJ2-2
TGCAGTGCTAGGATAAGCTCTGGGGCCAACGTCCTGACTTTC	CSARISSGANVLTF	TRBV20-1	TRBJ2-6
TGCAGTGCTCCACAGGGTAGGGCTACCGGGGAGCTGTTTTTT	CSAPQGRATGELFF	TRBV20-1	TRBJ2-2
TGTGCCAGCTCACCCGCCTTGACCCTGTGGGACGAGCAGTACTTC	CASSPALTLWDEQYF	TRBV18	TRBJ2-7
TGCGCCAGCAGCTCCCAGGCGTCCGATGGCTACACCTTC	CASSSQASDGYTF	TRBV5-1	TRBJ1-2
TGTGCCAGCAGCCAGGGGGCTAATATATCTCTCAACGAGCAGTACTTC	CASSQGANISLNEQYF	TRBV9	TRBJ2-7
TGTGCCAGCACCGGCGGAGCTAGTCCCCAGCCCCAGCATTTT	CASTGGASPQPQHF	TRBV28	TRBJ1-5
TGTGCCAGCAGCGGGGGGACAGGGAGGAGGGTAGGTAACATTCAGTACTTC	CASSGGTGRRVGNIQYF	TRBV13	TRBJ2-4
TGTGCCAGCAGCTTAGTGACAGGGGATTCCCAGCATTTT	CASSLVTGDSQHF	TRBV7-3	TRBJ1-5
TGCGCCAGCAGCTTGGCTAAGGTCTACCTCGAGGGCCACTATGGCTACACCTTC	CASSLAKVYLEGHYGYTF	TRBV5-1	TRBJ1-2
TGTGCCAAAAAAACCGACAGGGGGTCTGGGGCCAACGTCCTGACTTTC	CAKKTDRGSGANVLTF	TRBV28	TRBJ2-6
TGTGCCAGCAATCCCGGGACCGGACGCCGGAACACTGAAGCTTTCTTT	CASNPGTGRRNTEAFF	TRBV27	TRBJ1-1
TGTGCCAGCAGTGCATGGACTGAAGCTTTCTTT	CASSAWTEAFF	TRBV14	TRBJ1-1
TGCAGTGCTAGACCAAGGGGCGAGCAGTACTTC	CSARPRGEQYF	TRBV20-1	TRBJ2-7
TGTGCCAGCAGCTTAGAAGGTACGGGAGGGCTGAATTCACCCCTCCACTTT	CASSLEGTGGLNSPLHF	TRBV7-6	TRBJ1-6
TGTGCTAGTGGTTTGGGAGTAGCGGGAGAGTCCTTC	CASGLGVAGESF	TRBV12-5	TRBJ1-2
TGTGCCAGCACCGGGGCGAGGGAGAGCTCTGGGGCCAACGTCCTGACTTTC	CASTGARESSGANVLTF	TRBV5-4	TRBJ2-6
TGTGCCAGCAGCCGTCCTAGCACCGACAGGAACCCTGTCTACGAGCAGTACTTC	CASSRPSTDRNPVYEQYF	TRBV3-1	TRBJ2-7
TGTGCCACCAGTGATTTACGAGCTGGCTACACCTTC	CATSDLRAGYTF	TRBV24-1	TRBJ1-2
TGTGCCAGCTTCAGAGCGGCGGGCACTGAAGCTTTCTTT	CASFRAAGTEAFF	TRBV12-4	TRBJ1-1
TGTGCCAGCAGTTTAACAGACAGGGTGGAGACCCAGTACTTC	CASSLTDRVETQYF	TRBV27	TRBJ2-5
TGTGCCAGACCAGAGACCCAGTACTTC	CARPETQYF	TRBV10-3	TRBJ2-5
TGCGCCAGCAGCTTGGAGAGGGAGGGTAACTATGGCTACACCTTC	CASSLEREGNYGYTF	TRBV5-1	TRBJ1-2
TGCGCCAGCAGCCAAGATGGCAGGGGGGAAGGGGGCTACGAGCAGTACTTC	CASSQDGRGEGGYEQYF	TRBV4-1	TRBJ2-7
TGTGCCAGCAGCTGGGGCGGCAGGGAAATCTACGAGCAGTACTTC	CASSWGGREIYEQYF	TRBV11-3	TRBJ2-7
TGTGCCATCAGTCGCCTGATCTGCCCTCGAGGGTGTGAAGCTTTCTTT	CAISRLICPRGCEAFF	TRBV10-3	TRBJ1-1
TGTGCCACCAGTGAAAACGGGACATCCAGCACAGATACGCAGTATTTT	CATSENGTSSTDTQYF	TRBV24-1	TRBJ2-3
TGTGCCAGCAGCGGCACGGCGGGACTTCTTAAGGTTGAGCAGTTCTTC	CASSGTAGLLKVEQFF	TRBV12-3	TRBJ2-1
TGCAGCGTTGAGGAAGAAATGGCGGGGGACATCGGCTACAATGAGCAGTTCTTC	CSVEEEMAGDIGYNEQFF	TRBV29-1	TRBJ2-1
TGTGCCAGCAGTCGAGATATACCCATGGCAGGCTACGAGCAGTACTTC	CASSRDIPMAGYEQYF	TRBV6-5	TRBJ2-7
TGTGCCAGCAGCAGGGGGCGGCATAGCAATCAGCCCCAGCATTTT	CASSRGRHSNQPQHF	TRBV9	TRBJ1-5
TGTGCCGTGACAGGGACGTACCCCGGGTTAAAAGCTTTCTTT	CAVTGTYPGLKAFF	TRBV7-2	TRBJ1-1
TGTGCCAGCAGTCAACGTCCCGGCTCCTACGAGCAGTACTTC	CASSQRPGSYEQYF	TRBV12-3	TRBJ2-7
TGCGCCAGCAGCCAAGACCCGGGGGGGTCCGAAAAACTGTTTTTT	CASSQDPGGSEKLFF	TRBV4-1	TRBJ1-4
TGCGCCAGCAGCCAAGACACAGGTTCAAATGGCTACACCTTC	CASSQDTGSNGYTF	TRBV4-1	TRBJ1-2
TGTGCCAGCAGTGAAGAAACAGGGAACACTGAAGCTTTCTTT	CASSEETGNTEAFF	TRBV6-1	TRBJ1-1
TGTGCCAGCAGTCAAGACAGGGGGGATCAGCCCCAGCATTTT	CASSQDRGDQPQHF	TRBV6-1	TRBJ1-5
TGTGCCAGCACAAACGAGCAGTACTTC	CASTNEQYF	TRBV14	TRBJ2-7
TGTGCCAGCAGCCTCGACAATGAGCAGTTCTTC	CASSLDNEQFF	TRBV12-4	TRBJ2-1
TGCAGTGCTAGCATAACAACCGGGACAGGGGAAGTCGGGCAGTTCTTC	CSASITTGTGEVGQFF	TRBV20-1	TRBJ2-1
TGCGCCAGCAGCTGCCGGGCTTTCGGATCCTACGAGCAGTACTTC	CASSCRAFGSYEQYF	TRBV5-1	TRBJ2-7
TGCAGTGCCCACGGGAAAACAAATGAGCAGTTCTTC	CSAHGKTNEQFF	TRBV20-1	TRBJ2-1
TGTGCTAGTGGTTCAGTAGTCGTAATGGCCCCGACCGAGAAACCGACAACTAATGAAAAACTGTTTTTT	CASGSVVVMAPTEKPTTNEKLFF	TRBV12-5	TRBJ1-4
TGTGCCAGCAGCCCCGACAGGGTCGATTTTCCCAGGAATCAGCCCCAGCATTTT	CASSPDRVDFPRNQPQHF	TRBV11-3	TRBJ1-5
TGTGCCAGCAGTGGGGGGGTCTACAATGAGCAGTTCTTC	CASSGGVYNEQFF	TRBV6-1	TRBJ2-1
TGTGCCAGCAGCGTTCCAGGGGATGGGGAGCAGTACTTC	CASSVPGDGEQYF	TRBV13	TRBJ2-7
TGTGCCAGCTCACCACTACCAGCCCCGGGACAGTTATTTGGGCCTGAAGCTTTCTTT	CASSPLPAPGQLFGPEAFF	TRBV18	TRBJ1-1
TGCGCCAGCACAGCCCCCCTGGGGAACTCCTACAATGAGCAGTTCTTC	CASTAPLGNSYNEQFF	TRBV10-1	TRBJ2-1
TGTGCCAGCAGCCTATGGACAGGGGCCGCGGGGAATGAGCAGTTCTTC	CASSLWTGAAGNEQFF	TRBV13	TRBJ2-1
TGTGCCAGCAGCGGACTTCAACGCTACGAGCAGTACTTC	CASSGLQRYEQYF	TRBV13	TRBJ2-7
TGCAGTGCTAGCGAATCCCGGCGAGACACTGAAGCTTTCTTT	CSASESRRDTEAFF	TRBV20-1	TRBJ1-1
TGTGCCAGCAGCAAATTGCCTGAGGGGACAGAACCCTACGAGCAGTACTTC	CASSKLPEGTEPYEQYF	TRBV7-3	TRBJ2-7
TGTGCCAGCAGCTGGGGGCTGGGGTTGAACACTGAAGCTTTCTTT	CASSWGLGLNTEAFF	TRBV9	TRBJ1-1
TGTGCCAGCAGCCAAGGTAGCGCAGGGATTCGGGCGGGCAAGAACTATGGCTACACCTTC	CASSQGSAGIRAGKNYGYTF	TRBV3-1	TRBJ1-2
TGTGCCAGCAGCTACGGAGGCCGGGACAGGACTCTGAACTATGGCTACACCTTC	CASSYGGRDRTLNYGYTF	TRBV5-6	TRBJ1-2
TGCAGTGCTAGAGATCTATCCGGGGAGTATGGCTACACCTTC	CSARDLSGEYGYTF	TRBV20-1	TRBJ1-2
TGTGCCAGCAGCTCTAAACATAGGAGCTCCTACAATGAGCAGTTCTTC	CASSSKHRSSYNEQFF	TRBV7-2	TRBJ2-1
TGTGCCAGGAGGGACTACTACAATGAGCAGTTCTTC	CARRDYYNEQFF	TRBV24-1	TRBJ2-1
TGTGCCAGCATCAAAACCAGTGGGTTTAGCCAAGAGACCCAGTACTTC	CASIKTSGFSQETQYF	TRBV6-6	TRBJ2-5
TGTGCCAGCAGCTCTTCAGTTCAGACCCAGTACTTC	CASSSSVQTQYF	TRBV13	TRBJ2-5
TGTGCTAGTGGGGGGGGGGGGGATGAGCAGTTCTTC	CASGGGGDEQFF	TRBV12-5	TRBJ2-1
TGCGCCAGCAAACCCCCAAAAAGACAGGGAGATGCTGGGGCCAACGTCCTGACTTTC	CASKPPKRQGDAGANVLTF	TRBV10-1	TRBJ2-6
TGTGCCAGCAGCACTCGTCCCTGCTGGGCAGATACGCAGTATTTT	CASSTRPCWADTQYF	TRBV5-4	TRBJ2-3
TGTGCCAGCAGTTTATTCCCCCGGGACAGAGGTTACGAGCAGTACTTC	CASSLFPRDRGYEQYF	TRBV27	TRBJ2-7
TGCGCCAGCAGCTTTGGAAAATGGGACTTCTTTCGCAGCTCCTACAATGAGCAGTTCTTC	CASSFGKWDFFRSSYNEQFF	TRBV5-1	TRBJ2-1
TGTGCCACGCAGAAAAAGACGGGACTAGCGGGTCTTCACGAGCAGTACTTC	CATQKKTGLAGLHEQYF	TRBV15	TRBJ2-7
TGTGCCAGCAGCAGTGTTTCCGGGACCGATGAGCAGTTCTTC	CASSSVSGTDEQFF	TRBV11-3	TRBJ2-1
TGTGCCAGCAGCTTGGCATGGGCCCTGGCTAGCACAGATACGCAGTATTTT	CASSLAWALASTDTQYF	TRBV5-6	TRBJ2-3
TGTGCGTGGGATCCTCATGGGGTGGAGACTGAAGCTTTCTTT	CAWDPHGVETEAFF	TRBV30	TRBJ1-1
TGTGCCAGCAGCGAAAACTCGGCTAGGCCCGGCCGCAACACCGGGGAGCTGTTTTTT	CASSENSARPGRNTGELFF	TRBV7-3	TRBJ2-2
TGTGCCAGCAAGCCACAATTACTAGCGGGGGGGCCGTTATACGAGCAGTACTTC	CASKPQLLAGGPLYEQYF	TRBV12-4	TRBJ2-7
TGTGCCAGCAGCCGGCCTCGGGGGCGCCGCACAGATACGCAGTATTTT	CASSRPRGRRTDTQYF	TRBV7-9	TRBJ2-3
