TGTGCCAGCAGCTTCCAGGCTAACCGGGACAGGGGGCTAAGCTACACCTTC	CASSFQANRDRGLSYTF	TRBV13	TRBJ1-2
TGCAGTGCCAATAGCCGGGGCGCTGGGGCCAACGTCCTGACTTTC	CSANSRGAGANVLTF	TRBV20-1	TRBJ2-6
TGTGCCAGCAGCCACCTGGGACCTAAATACTCCTACAATGAGCAGTTCTTC	CASSHLGPKYSYNEQFF	TRBV7-2	TRBJ2-1
TGTGCCAGCAGCCGGACTAGCGCTACTAGAAGCTCCTACGAGCAGTACTTC	CASSRTSATRSSYEQYF	TRBV6-1	TRBJ2-7
TGTGCCAGCAGTGCAGACAGGGGCAGGAGGACCCAGTACTTC	CASSADRGRRTQYF	TRBV25-1	TRBJ2-5
TGTGCCAGCAGCGTTCCGGAAGAGGGGGGGTACGAGCAGTACTTC	CASSVPEEGGYEQYF	TRBV9	TRBJ2-7
TGTGCCAGCAGTGTGGGGATCTTTCGGTACGAGCAGTACTTC	CASSVGIFRYEQYF	TRBV12-3	TRBJ2-7
TGTGCCAGCAGTTTGGACAGGGGGCAGCGAAACACCATATATTTT	CASSLDRGQRNTIYF	TRBV28	TRBJ1-3
TGTGCCACCAGTGAGGTGGGCGCCTACGAGCAGTACTTC	CATSEVGAYEQYF	TRBV24-1	TRBJ2-7
TGCGCCAGCAGAGGCGGGAGCCCGGATTCACCCCTCCACTTT	CASRGGSPDSPLHF	TRBV10-2	TRBJ1-6
TGTGCCATGATGGGGGGCTACGAGCAGTACTTC	CAMMGGYEQYF	TRBV18	TRBJ2-7
TGTGCCAGCCGGCCTAGCATCCGATCCTACAATGAGCAGTTCTTC	CASRPSIRSYNEQFF	TRBV5-6	TRBJ2-1
TGTGCCAGCGTCGGACAGGGGATAAACTCCTACGAGCAGTACTTC	CASVGQGINSYEQYF	TRBV27	TRBJ2-7
TGTGCCAGTACGGGAAATGAGCAGTTCTTC	CASTGNEQFF	TRBV5-4	TRBJ2-1
TGTGCCAGCAGCTCGGTCGGGGCGGGAATCAATCAGCCCCAGCATTTT	CASSSVGAGINQPQHF	TRBV9	TRBJ1-5
TGCGCCAGCAGGGGTAGACTAGCGGGAGATGTTGCTGGGGCCAACGTCCTGACTTTC	CASRGRLAGDVAGANVLTF	TRBV5-1	TRBJ2-6
TGTGCCAGCTCACCAGGGAATAGCTACAATGAGCAGTTCTTC	CASSPGNSYNEQFF	TRBV18	TRBJ2-1
TGTGCCAGCAGCGTGTGCCCCTGGACAGGGGACTCTGAAGCTTTCTTT	CASSVCPWTGDSEAFF	TRBV9	TRBJ1-1
TGTGCCAGTAACATCTACAGGGTTAAGACCCCGAACACCGGGGAGCTGTTTTTT	CASNIYRVKTPNTGELFF	TRBV19	TRBJ2-2
TGTGCCAGAATCAGTACGGGGCACGCAGGCGACAATCAGCCCCAGCATTTT	CARISTGHAGDNQPQHF	TRBV6-5	TRBJ1-5
TGTGCCAGCAGCTTCCAGGGGCAAAATCAGCCCCAGCATTTT	CASSFQGQNQPQHF	TRBV5-5	TRBJ1-5
TGTGCCACCAGCTTCCGGAGGGGTTGCAACACCGGGGAGCTGTTTTTT	CATSFRRGCNTGELFF	TRBV24-1	TRBJ2-2
TGCAGTGCTAAGGGGGACATTCAGTACTTC	CSAKGDIQYF	TRBV20-1	TRBJ2-4
TGTGCCAGCAGCTATCCCTCGGGGGAGGCCCAGCATTTT	CASSYPSGEAQHF	TRBV5-6	TRBJ1-5
TGCGCCACGGGAAACGGACAGGGGGGGGCAGATACGCAGTATTTT	CATGNGQGGADTQYF	TRBV10-2	TRBJ2-3
TGTGCCCGGGGGGTAACGGGAGCTAACTATGGCTACACCTTC	CARGVTGANYGYTF	TRBV6-5	TRBJ1-2
TGCACCCGGGGCCATAGCAATCAGCCCCAGCATTTT	CTRGHSNQPQHF	TRBV20-1	TRBJ1-5
TGTGCCAGCAGGAGACTAGCGGGGGTAGATCAAGAGACCCAGTACTTC	CASRRLAGVDQETQYF	TRBV6-6	TRBJ2-5
TGTGCCACCAGTGTCCGAGGGGGGCCGGACCCCTACAATGAGCAGTTCTTC	CATSVRGGPDPYNEQFF	TRBV24-1	TRBJ2-1
TGTGCCAGCAGCTCCACTAGCGGGAGGGGAAGCACAGATACGCAGTATTTT	CASSSTSGRGSTDTQYF	TRBV7-2	TRBJ2-3
TGTGCCAGCAGCCACACCCCAGGGCTGCAGCTACCCTACGAGCAGTACTTC	CASSHTPGLQLPYEQYF	TRBV14	TRBJ2-7
TGCGCCAGCAGCTTCCCCTCTGAGTGGGCGAACACCGGGGAGCTGTTTTTT	CASSFPSEWANTGELFF	TRBV4-3	TRBJ2-2
TGTGCCAGCAGAGGACGAGGAGGAAATGAGCAGTTCTTC	CASRGRGGNEQFF	TRBV6-4	TRBJ2-1
TGTGCGGTGATTCCGGGACTAGTGCGGGGTAATGAGCAGTTCTTC	CAVIPGLVRGNEQFF	TRBV6-5	TRBJ2-1
TGTGCCAGCAGTACCCGACTAGGCGCCTACGAGCAGTACTTC	CASSTRLGAYEQYF	TRBV28	TRBJ2-7
TGTGCCAGCAGCTTAGCGGGGTACCGCTCTGGAAACACCATATATTTT	CASSLAGYRSGNTIYF	TRBV11-3	TRBJ1-3
TGTGCCAGCAGCTTGGCACCAAACAGGGGCCGGCCCTACGAGCAGTACTTC	CASSLAPNRGRPYEQYF	TRBV5-5	TRBJ2-7
TGTGCCAGCAGTCGCAGGCCGGGGATTCAAGAGACCCAGTACTTC	CASSRRPGIQETQYF	TRBV6-5	TRBJ2-5
TGTGCCACCAGCAGAGTAACCGGGACGCGAACTAATGAAAAACTGTTTTTT	CATSRVTGTRTNEKLFF	TRBV15	TRBJ1-4
TGTGCCAGCTCACCACAAAAGGAAAGGGTGACCGGGGAGCTGTTTTTT	CASSPQKERVTGELFF	TRBV18	TRBJ2-2
TGTGCCAGCAGCTCAAAAGGCGTCGGACGTACTGAAGCTTTCTTT	CASSSKGVGRTEAFF	TRBV7-3	TRBJ1-1
TGTGCCAGCCCGAACAAACTTTTTAGCAATCAGCCCCAGCATTTT	CASPNKLFSNQPQHF	TRBV4-2	TRBJ1-5
TGTGCCACCAGTCCGAACCACGGGGGCGGCACTGAAGCTTTCTTT	CATSPNHGGGTEAFF	TRBV24-1	TRBJ1-1
TGTGCCAGCAGCCAAGATCTCGAAGGGGGCTGCTCTGGGGCCAACGTCCTGACTTTC	CASSQDLEGGCSGANVLTF	TRBV4-2	TRBJ2-6
TGCAGTGCCCAGGGGGCAAGGACGTACCAAGAGACCCAGTACTTC	CSAQGARTYQETQYF	TRBV20-1	TRBJ2-5
TGTGCCGTTGACAGGGAGGACCCCTACGAGCAGTACTTC	CAVDREDPYEQYF	TRBV28	TRBJ2-7
TGTGGATCCGGACAGTCCTATAATTCACCCCTCCACTTT	CGSGQSYNSPLHF	TRBV2	TRBJ1-6
TGTGCCAGCAGTTATCTTTTTCCCGGGGGGGGACCGCGCACAGATACGCAGTATTTT	CASSYLFPGGGPRTDTQYF	TRBV27	TRBJ2-3
TGCGCCAGCAGTGAGGACAGGGATGTGAACACTGAAGCTTTCTTT	CASSEDRDVNTEAFF	TRBV10-2	TRBJ1-1
TGTGCCAGCTCACACCGGGTAACCTACGAGCAGTACTTC	CASSHRVTYEQYF	TRBV18	TRBJ2-7
TGTGCCAGCAGAACTCCAGGTGACGAGCAGTACTTC	CASRTPGDEQYF	TRBV6-5	TRBJ2-7
TGTGCCACCAGCTTTCCGGGGTCTGGCTACACCTTC	CATSFPGSGYTF	TRBV24-1	TRBJ1-2
TGTGCCAGCAGCGGGAAAGGGGCATCTCAGCCCCAGCATTTT	CASSGKGASQPQHF	TRBV7-3	TRBJ1-5
TGTGCCACCAGCAGAGTCGGCCGCTTGGATACGCAGTATTTT	CATSRVGRLDTQYF	TRBV15	TRBJ2-3
TGTGCCAGCAGTTTAGACAGGGGGCGCCCTAATCAGCCCCAGCATTTT	CASSLDRGRPNQPQHF	TRBV27	TRBJ1-5
TGTGAGAAGGGGGGCTCTGGAAACACCATATATTTT	CEKGGSGNTIYF	TRBV28	TRBJ1-3
TGCGCCAGCCCTCGGGGGGGGATCCGCGAGCAGTACTTC	CASPRGGIREQYF	TRBV10-1	TRBJ2-7
TGCGCCAGCAGCCAAGATAGAACAAGGTTTTGTCAGCCCCAGCATTTT	CASSQDRTRFCQPQHF	TRBV4-1	TRBJ1-5
TGTGCTAGCAGCTTAGGGGTTGATTCTCCCAGCAATCAGCCCCAGCATTTT	CASSLGVDSPSNQPQHF	TRBV7-7	TRBJ1-5
TGTGCCAGCAGTGAACTAGGGGACACAGATACGCAGTATTTT	CASSELGDTDTQYF	TRBV25-1	TRBJ2-3
TGCGCCAGCAGTGAGTCTCCCCGGGACTATACCCAGCCCCAGCATTTT	CASSESPRDYTQPQHF	TRBV10-1	TRBJ1-5
TGCGCCAGCAGCTTAGGGAGGACAGGGTTGAACACTGAAGCTTTCTTT	CASSLGRTGLNTEAFF	TRBV5-1	TRBJ1-1
TGTGCCAGCAGCCAAGCGGTGGACGACGAGCAGTACTTC	CASSQAVDDEQYF	TRBV14	TRBJ2-7
TGTGCCAGTAGTGGCGTGCAGGGGACACTCTACACCGAGACCCAGTACTTC	CASSGVQGTLYTETQYF	TRBV19	TRBJ2-5
TGTGCCAGCAGAACAGGGGGCAATGGCTACACCTTC	CASRTGGNGYTF	TRBV27	TRBJ1-2
TGTGCCAGCAGCCAAGTCAAATACGAGCAGTACTTC	CASSQVKYEQYF	TRBV4-2	TRBJ2-7
TGTGCCAGCTCGAGCGAGGCAGGGGGGCAGCCCCAGCATTTT	CASSSEAGGQPQHF	TRBV18	TRBJ1-5
TGCGCCAGCAGATCCCCCCAGGGCCCACAAGGTATGGGCTACACCTTC	CASRSPQGPQGMGYTF	TRBV5-1	TRBJ1-2
TGTGCCAGCAGCTGGGCCCTCCGGGGCACTCGGAGAGATACGCAGTATTTT	CASSWALRGTRRDTQYF	TRBV7-3	TRBJ2-3
TGTGCCAGCAGCGGCCATAGGGACGGGGGAGGGAATCAGCCCCAGCATTTT	CASSGHRDGGGNQPQHF	TRBV5-6	TRBJ1-5
TGTGCCAGCGACAGGGGCCACTCTGGAAACACCATATATTTT	CASDRGHSGNTIYF	TRBV9	TRBJ1-3
TGTGCCACCAGTGTCCCTGGGGGGGTTGGGGTTCAAGAGACCCAGTACTTC	CATSVPGGVGVQETQYF	TRBV24-1	TRBJ2-5
TGTGCCAGCAGTTTCCAGCGGGACAGGGGGAATAGCAATCAGCCCCAGCATTTT	CASSFQRDRGNSNQPQHF	TRBV27	TRBJ1-5
TGTGCCAGCAGAACCCGGGACAGGGAACGGGCTTTCTTT	CASRTRDRERAFF	TRBV2	TRBJ1-1
TGTGCTAGTGGTTTGGTAACCGGACAGGGCTCTGGAAACACCATATATTTT	CASGLVTGQGSGNTIYF	TRBV12-5	TRBJ1-3
TGTGCCAGCAGCGCTGAGCCCGGGGGTTTCGGGGAGACGGAGCAGTACTTC	CASSAEPGGFGETEQYF	TRBV7-3	TRBJ2-7
TGTGCCAGCAGCCAGAAAGAGGGATTGTCCTACGAGCAGTACTTC	CASSQKEGLSYEQYF	TRBV7-3	TRBJ2-7
TGTGCCACCAGGGGGGACAGGGGTGAGGGCTACACCTTC	CATRGDRGEGYTF	TRBV24-1	TRBJ1-2
TGTGCCAGCAGTGGGGACAGGGGCATTGGCTCTGGGGCCAACGTCCTGACTTTC	CASSGDRGIGSGANVLTF	TRBV6-2	TRBJ2-6
TGTGCCATCAGCCAGCAGGGACTTACACATCAGCCCCAGCATTTT	CAISQQGLTHQPQHF	TRBV10-3	TRBJ1-5
TGTGCCAGCAGCGGAGGGGCCCCGGGAGAGACCCAGTACTTC	CASSGGAPGETQYF	TRBV6-4	TRBJ2-5
TGCGCCAGCAGCTTGGGTTGGCTAGGCCTAGCTTTCTTT	CASSLGWLGLAFF	TRBV5-1	TRBJ1-1
TGCAGTGATGAAGGACGAGTTCTGAAAAGCTCCTACGAGCAGTACTTC	CSDEGRVLKSSYEQYF	TRBV20-1	TRBJ2-7
TGTGCCAGCAGTGCGTGTAGGGGGCCCCACACTGAAGCTTTCTTT	CASSACRGPHTEAFF	TRBV6-4	TRBJ1-1
TGTGCCAGCAGCATTCCCCCGGGACAGTGTAGGCCTAATGAAAAACTGTTTTTT	CASSIPPGQCRPNEKLFF	TRBV9	TRBJ1-4
TGTGCCAGCAGCTTGGGCGTGGATGGCTCCTACGAGCAGTACTTC	CASSLGVDGSYEQYF	TRBV7-9	TRBJ2-7
TGCGCCAGCAGCCCGTGGGACAGGGCGAACCGCGAGCAGTACTTC	CASSPWDRANREQYF	TRBV5-1	TRBJ2-7
TGCAGTGCTAGAACAGGGCTCCTTGCCAAGAGCTCTGGAAACACCATATATTTT	CSARTGLLAKSSGNTIYF	TRBV20-1	TRBJ1-3
TGTGCCAGCCCATCGACAGGAGGTAGCAATCAGCCCCAGCATTTT	CASPSTGGSNQPQHF	TRBV2	TRBJ1-5
TGTGCCAGCCTAGGTTGGGTTTTCGCTTTCTTT	CASLGWVFAFF	TRBV27	TRBJ1-1
TGTGCCAGCAGCTTATCGTCTCTTGGACCGAGAAGGTGCGGCACAGATACGCAGTATTTT	CASSLSSLGPRRCGTDTQYF	TRBV7-6	TRBJ2-3
TGTGCCAGCAAGGGGCGGCCGGAAACCGGGGAGCTGTTTTTT	CASKGRPETGELFF	TRBV5-4	TRBJ2-2
TGTGCCACCCCTAGCGGGAGGTCCCCCTACAATGAGCAGTTCTTC	CATPSGRSPYNEQFF	TRBV24-1	TRBJ2-1
TGCGCCAGCAAACTACGGACCAGCTCCTATAATTCACCCCTCCACTTT	CASKLRTSSYNSPLHF	TRBV10-1	TRBJ1-6
TGTGCCAGCAGCCACTTCGATGCACGAGACGAGCAGTACTTC	CASSHFDARDEQYF	TRBV3-1	TRBJ2-7
TGTGCCAGCACATCCCGGGACAGGGGAAGCTATGGCTACACCTTC	CASTSRDRGSYGYTF	TRBV27	TRBJ1-2
TGTGCCAGCAGCGAGAGGGGAGGTAATGAAAAACTGTTTTTT	CASSERGGNEKLFF	TRBV9	TRBJ1-4
TGTGCCAGCAGCTTAGAGGGTTCGAAGCCGGGTATCCTCGGGACAGGGGACCCTTACGAGCAGTACTTC	CASSLEGSKPGILGTGDPYEQYF	TRBV11-3	TRBJ2-7
TGTGCCAGGCCTTACAAGCAAGAGACCCAGTACTTC	CARPYKQETQYF	TRBV27	TRBJ2-5
TGTGCCACCAGTGGCGTCCACAGGGGGGAAGTTGGCACTGAAGCTTTCTTT	CATSGVHRGEVGTEAFF	TRBV24-1	TRBJ1-1
