TGTGCCAGCAGTTACATCCCCTACAGAGTATCGGCTGAAGCTTTCTTT	CASSYIPYRVSAEAFF	TRBV6-3	TRBJ1-1
TGTGCCAGCGAATGGGGACAGGGAAATCAGCCCCAGCATTTT	CASEWGQGNQPQHF	TRBV12-3	TRBJ1-5
TGTGCCAGCAGCTCCCTCCGGGACAGCAGCGAGCAGTACTTC	CASSSLRDSSEQYF	TRBV7-3	TRBJ2-7
TGCGCCAGCAGCTCCGGACAGGGCGAGACCCATCAGCCCCAGCATTTT	CASSSGQGETHQPQHF	TRBV5-1	TRBJ1-5
TGTGCCACCAGTTTGTTTTCGGTGCATGAGCAGTTCTTC	CATSLFSVHEQFF	TRBV24-1	TRBJ2-1
TGTGCCAGCCCCCTAGAGATTGCAAAAAACATTCAGTACTTC	CASPLEIAKNIQYF	TRBV12-3	TRBJ2-4
TGTGCCAGCAGCCGGGGGTCACCCCTCCACTTT	CASSRGSPLHF	TRBV5-6	TRBJ1-6
TGCAGTGCTAGCGGTAGGGGAGAAGAGACCCAGTACTTC	CSASGRGEETQYF	TRBV20-1	TRBJ2-5
TGCGCCAGCAGCTTGGACTTATGGATACTGTCCAGCACTTTCAGTGAAAAACTGTTTTTT	CASSLDLWILSSTFSEKLFF	TRBV5-1	TRBJ1-4
TGTGCCAGCGACTGGGAACAGCCCCAGCATTTT	CASDWEQPQHF	TRBV7-3	TRBJ1-5
TGCAGTGCTAGGGGGGGGCCTCAAGCCACCGGGGAGCTGTTTTTT	CSARGGPQATGELFF	TRBV20-1	TRBJ2-2
TGTGCCAGCAGCCGGGAGTACGAGCAGTACTTC	CASSREYEQYF	TRBV7-2	TRBJ2-7
TGTGCCAGCAGCTTATACGGGACAGGGGGCTACGAGCAGTACTTC	CASSLYGTGGYEQYF	TRBV7-2	TRBJ2-7
TGTGCCAGCAGCTTAGCCAATAGGTCTAGCAATCAGCCCCAGCATTTT	CASSLANRSSNQPQHF	TRBV7-4	TRBJ1-5
TGCAGTGCTAGAGCTCCCAATACTCACGAGCAGTACTTC	CSARAPNTHEQYF	TRBV20-1	TRBJ2-7
TGTGCCTGGAGCGTTACTAGTTCATACACCGGGGAGCTGTTTTTT	CAWSVTSSYTGELFF	TRBV30	TRBJ2-2
TGTGCCAGCAGTGAAGGCAACCGCCGGGACAGGGGAAACTACGAGCAGTACTTC	CASSEGNRRDRGNYEQYF	TRBV6-4	TRBJ2-7
TGTGCCAGCAGCTTACTGGGGGGGCCCCCTTCGGATGAGCAGTTCTTC	CASSLLGGPPSDEQFF	TRBV7-2	TRBJ2-1
TGCAGTGCGATACGGGGGATCTCCTACGAGCAGTACTTC	CSAIRGISYEQYF	TRBV20-1	TRBJ2-7
TGCAGCGTTGACCAACTAGTCCGTCACGTGTTAGCGAACACCGGGGAGCTGTTTTTT	CSVDQLVRHVLANTGELFF	TRBV29-1	TRBJ2-2
TGTGCCAGCAGCTCAAACTTGGCCACTGAAGCTTTCTTT	CASSSNLATEAFF	TRBV7-6	TRBJ1-1
TGTGCCAGCATAACGTGGGTCGAGGAAGAGACCCAGTACTTC	CASITWVEEETQYF	TRBV28	TRBJ2-5
TGTGCCAGCAGGGCACTAGCGGGAGGGCGCAGCTCCTACGAGCAGTACTTC	CASRALAGGRSSYEQYF	TRBV12-4	TRBJ2-7
TGTGCCAGCAGCCCTCTAGCGGGAGATACGCAGTATTTT	CASSPLAGDTQYF	TRBV2	TRBJ2-3
TGTGCTAGCAGCTTAGACAGGAGGGCTGGAAACACCATATATTTT	CASSLDRRAGNTIYF	TRBV7-7	TRBJ1-3
TGTGCCAGCAGGGGGGGACGCGAGCAGTACTTC	CASRGGREQYF	TRBV25-1	TRBJ2-7
TGTGCCAGCAGTGAGGCTGGCACCGTGAGGACGCGGGCATCCTACGAGCAGTACTTC	CASSEAGTVRTRASYEQYF	TRBV6-4	TRBJ2-7
TGTGCCAGCAGCTCGTCAGCGCGGGAGGGGACTGAAGCTTTCTTT	CASSSSAREGTEAFF	TRBV7-3	TRBJ1-1
TGTGCCAGCAGCCATGGACAGAGGTTAAACACTGAAGCTTTCTTT	CASSHGQRLNTEAFF	TRBV5-6	TRBJ1-1
TGTGCCACTCTACCGGGACGTTATAATTCACCCCTCCACTTT	CATLPGRYNSPLHF	TRBV6-2	TRBJ1-6
TGTGCCTGGAGTGCGATAACTCTAGTGTGCACAGATACGCAGTATTTT	CAWSAITLVCTDTQYF	TRBV30	TRBJ2-3
TGCTGGGGGGAAGCTAACTATGGCTACACCTTC	CWGEANYGYTF	TRBV20-1	TRBJ1-2
TGTGCCAGCAGCCAAGATCGAAAGGCGACTAGACCCCTTTCCACTGAAGCTTTCTTT	CASSQDRKATRPLSTEAFF	TRBV14	TRBJ1-1
TGCGCCAGCGGTGCTCGAGGGACTAGCGATAGACATGTTGGAGAGACCCAGTACTTC	CASGARGTSDRHVGETQYF	TRBV5-1	TRBJ2-5
TGTGCCAGCAAATGCAGGACCGCGGAGCAGTACTTC	CASKCRTAEQYF	TRBV6-3	TRBJ2-7
TGTGCCAGCACCCCGGCCCGAAGGACAGATACGCAGTATTTT	CASTPARRTDTQYF	TRBV6-5	TRBJ2-3
TGTGCCACCAGTGATGCACCCCTTACCCAACTCTTC	CATSDAPLTQLF	TRBV24-1	TRBJ2-1
TGTGCCAGCTCACCGCAAAGCGGGGGGGCCCAACCTGAGCAGTTCTTC	CASSPQSGGAQPEQFF	TRBV18	TRBJ2-1
TGTGCCACCATACGAAGCTCTTCTTACAATGAGCAGTTCTTC	CATIRSSSYNEQFF	TRBV24-1	TRBJ2-1
TGTGCCAGCAGTAAGGGGGGCGAGGATTCCTACGAGCAGTACTTC	CASSKGGEDSYEQYF	TRBV6-5	TRBJ2-7
TGTGCCAGTAGTTCAGGGCCCTTGGGAAGCTCCTACAATGAGCAGTTCTTC	CASSSGPLGSSYNEQFF	TRBV19	TRBJ2-1
TGTGCCACCAGTGGAAAGGTGCGCCGGGACACCTACGCCGGCTACTATGGCTACACCTTC	CATSGKVRRDTYAGYYGYTF	TRBV24-1	TRBJ1-2
TGTGCCAGCAGTAGGGGGGGGAATGAGCAGTTCTTC	CASSRGGNEQFF	TRBV27	TRBJ2-1
TGTGCCAGCAGTGAGAAGAAGGGAGGAATCAGTCCGGCAACTAATGAAAAACTGTTTTTT	CASSEKKGGISPATNEKLFF	TRBV25-1	TRBJ1-4
TGTGCCAGCAGTTACTCGATCCCCACAGGGCCATCAGATACGCAGTATTTT	CASSYSIPTGPSDTQYF	TRBV6-6	TRBJ2-3
TGTGCCAGCGAAAAACTCGGTGGGGGGGGGCCGGAGGACTCCTACAATGAGCAGTTCTTC	CASEKLGGGGPEDSYNEQFF	TRBV25-1	TRBJ2-1
TGTGCCATTCGGGGGTATCGAGGACACCAAGAGACCCAGTACTTC	CAIRGYRGHQETQYF	TRBV19	TRBJ2-5
TGTGCCAGCAGTTTATTTGCAAGGGCCGGACAAGAGACCCAGTACTTC	CASSLFARAGQETQYF	TRBV27	TRBJ2-5
TGTGCCAGTAGTACCGGGGAGCAAGAGACCCAGTACTTC	CASSTGEQETQYF	TRBV19	TRBJ2-5
TGTGCCATCAGTGAGCCCTATCAGGGGGCCTCTATGGGCACTGAAGCTTTCTTT	CAISEPYQGASMGTEAFF	TRBV10-3	TRBJ1-1
TGCATCGAGACAGGGTCGGGAAACACCATATATTTT	CIETGSGNTIYF	TRBV20-1	TRBJ1-3
TGCAGTGCTAGCCAGGAAACACCCCTATCCGACAGTAGCCACAATGAGCAGTTCTTC	CSASQETPLSDSSHNEQFF	TRBV20-1	TRBJ2-1
TGTGCCAGCACGGGGGGGGGCCCCATGAACACTGAAGCTTTCTTT	CASTGGGPMNTEAFF	TRBV6-4	TRBJ1-1
TGCGCCAGCAGCCGTGAGGGTACACAACTGAGTTCACCCCTCCACTTT	CASSREGTQLSSPLHF	TRBV4-3	TRBJ1-6
TGTGCCAGCAGTTACTCGACCCCCAGGGTCCAAGAGACCCAGTACTTC	CASSYSTPRVQETQYF	TRBV6-5	TRBJ2-5
TGTGCCAGCAGCTTACCTTCTAGCGGGGGGACCGGGGAGCTGTTTTTT	CASSLPSSGGTGELFF	TRBV7-2	TRBJ2-2
TGTGCCACCAGCCTCTATGATCGGGACAGAGGGGCCAAAAACATTCAGTACTTC	CATSLYDRDRGAKNIQYF	TRBV15	TRBJ2-4
TGTGCCAGCAGTGACCGGGGTGAGCAGTACTTC	CASSDRGEQYF	TRBV6-4	TRBJ2-7
TGTGCCACCCAAGGACAGCTTAGCAATCAGCCCCAGCATTTT	CATQGQLSNQPQHF	TRBV24-1	TRBJ1-5
TGTGCCAGCAGTTTGGGGTCAGGGGGCGAGCAGTACTTC	CASSLGSGGEQYF	TRBV3-1	TRBJ2-7
TGCAGTGCTCGTAGCTGCAAAGCTTCCTACAATGAGCAGTTCTTC	CSARSCKASYNEQFF	TRBV20-1	TRBJ2-1
TGTGCCAGCAGCTTAGTTCGGGCGGGAGGGACAGGGCTGAACACTGAAGCTTTCTTT	CASSLVRAGGTGLNTEAFF	TRBV11-2	TRBJ1-1
TGTGCCAGCTCACCCCCCAGAAGGGCAAAAACCGGGGAGCTGTTTTTT	CASSPPRRAKTGELFF	TRBV18	TRBJ2-2
TGTGCCAGCAGCTCGTGGGTCTACCAAGGGGACGATACGCAGTATTTT	CASSSWVYQGDDTQYF	TRBV5-6	TRBJ2-3
TGCGCCAGCAGCCGCATGGGACAGGGCACAGATACGCAGTATTTT	CASSRMGQGTDTQYF	TRBV4-1	TRBJ2-3
TGTGCCAGCAGTATTTCTCAGGGGCCTCCCTCTGGAAACACCATATATTTT	CASSISQGPPSGNTIYF	TRBV6-1	TRBJ1-3
TGTGCCAGCAGTTACTCGGAGGGGCGAGCTTTCTTT	CASSYSEGRAFF	TRBV6-5	TRBJ1-1
TGTGCCCAACCGGGACTAGTTTGGCCCTACGAGCAGTACTTC	CAQPGLVWPYEQYF	TRBV6-1	TRBJ2-7
TGTGCCACCCAAGGGGGGGTGGCAGATACGCAGTATTTT	CATQGGVADTQYF	TRBV24-1	TRBJ2-3
TGTGCCAGCAGACTAGCGGGAGCCTACGAGCAGTACTTC	CASRLAGAYEQYF	TRBV4-2	TRBJ2-7
TGTGCCAGAGACAGCTCCTACGAGCAGTACTTC	CARDSSYEQYF	TRBV19	TRBJ2-7
TGCGCCAGCAGCTTCGTGGGACAGGGGGCATACTCCTACGAGCAGTACTTC	CASSFVGQGAYSYEQYF	TRBV5-1	TRBJ2-7
TGTGCCAGCAGCGGCTGGGAATTATCTGAGCAGTTCTTC	CASSGWELSEQFF	TRBV28	TRBJ2-1
TGTGCCAGCAGCGTCAATCTAGCGGGGGGTGAGACCCAGTACTTC	CASSVNLAGGETQYF	TRBV9	TRBJ2-5
TGCGCCAGCAGCCAAGACTTTGGAATAGGGAAATGTGGGGCCAACGTCCTGACTTTC	CASSQDFGIGKCGANVLTF	TRBV4-1	TRBJ2-6
TGTGCCAGTTACAGGGGCAACGGTTCCGAGACCCAGTACTTC	CASYRGNGSETQYF	TRBV6-4	TRBJ2-5
TGTGCCAGCAGCGGTTGCGGACAGGGGCTGGTCTACGAGCAGTACTTC	CASSGCGQGLVYEQYF	TRBV3-1	TRBJ2-7
TGTGCCAGCAGTGCCACTAGCTCCTACGAGCAGTACTTC	CASSATSSYEQYF	TRBV6-4	TRBJ2-7
TGTGCCAGCAGCTTAAGGGTACAGGGGGCTCGCTCTGGGGCCAACGTCCTGACTTTC	CASSLRVQGARSGANVLTF	TRBV7-9	TRBJ2-6
TGCGCCAGCAGCCAAGACCCTATACCGGATCGGGGGTCCTACAATGAGCAGTTCTTC	CASSQDPIPDRGSYNEQFF	TRBV4-3	TRBJ2-1
TGCATTGACAGGGGGGCGGAAGGCTACACCTTC	CIDRGAEGYTF	TRBV20-1	TRBJ1-2
TGCGCCAGCCCCATAGAGGGGGAAGCAGACCCTGCAGATACGCAGTATTTT	CASPIEGEADPADTQYF	TRBV4-1	TRBJ2-3
TGTGCCACCAGTGATTTGGGACATCGTACTGAAGCTTTCTTT	CATSDLGHRTEAFF	TRBV24-1	TRBJ1-1
TGTGCCAGCAGCCCCTTCAGGGTTGTCTATGGCTACACCTTC	CASSPFRVVYGYTF	TRBV7-4	TRBJ1-2
TGTGCCAGCAGTGACTCGCATTGGGGCCTTGGCAATCAGCCCCAGCATTTT	CASSDSHWGLGNQPQHF	TRBV6-4	TRBJ1-5
TGTGCCAGCAGTTCTTCAGGAGGGTATGTAAAAGAGACCCAGTACTTC	CASSSSGGYVKETQYF	TRBV27	TRBJ2-5
TGTGCCAGCAGTGGGTACACTAGCGGGAGGGCGGAGATAGAGACCCAGTACTTC	CASSGYTSGRAEIETQYF	TRBV27	TRBJ2-5
TGTGCCAGCAGCTTGGGGAAAGATCAGCCCCAGCATTTT	CASSLGKDQPQHF	TRBV5-4	TRBJ1-5
TGTGCCAGCAGCTTACCGTCCCCTGGGGACAGTCAAAGAAAACTGTTTTTT	CASSLPSPGDSQRKLFF	TRBV11-3	TRBJ1-4
TGTGCCAGCAGTGATCTGACAGGCCGCTACGAGCAGTACTTC	CASSDLTGRYEQYF	TRBV6-4	TRBJ2-7
TGCAGTGCTAGGGTGACAGGGGGGTTCTTC	CSARVTGGFF	TRBV20-1	TRBJ1-2
TGTGCCAGCAGGGTCGGAGACGACCGCACAGATACGCAGTATTTT	CASRVGDDRTDTQYF	TRBV28	TRBJ2-3
TGTGCCAGCAGTTATAAGGATGGGCTAGCGGGGCTCAAAGAGACCCAGTACTTC	CASSYKDGLAGLKETQYF	TRBV6-5	TRBJ2-5
TGTGCCAGTAGTCCCCAGGTCCATGAGCAGTTCTTC	CASSPQVHEQFF	TRBV19	TRBJ2-1
TGTGCCAGCAGCCCCGGGCCCTACAATGAGCAGTTCTTC	CASSPGPYNEQFF	TRBV7-2	TRBJ2-1
TGCGCCAGCAACTGCCTCGTTTTCGGGGTTGGGAACACTGAAGCTTTCTTT	CASNCLVFGVGNTEAFF	TRBV10-1	TRBJ1-1
TGTGCCAGCAGCGTAGGTTTCCTCCTCCAGGGGATGGGTAGTAGGGGAACTGAAGCTTTCTTT	CASSVGFLLQGMGSRGTEAFF	TRBV9	TRBJ1-1
TGTGCCAGTAGTATTCTCGACGACCACGAGCAGTACTTC	CASSILDDHEQYF	TRBV19	TRBJ2-7
TGTGCCAGCAGGGGTCTCGAAGGGCCCCTACGGCTAGCCAAAAACATTCAGTACTTC	CASRGLEGPLRLAKNIQYF	TRBV6-1	TRBJ2-4
TGCAGTGCTAGAGATCGAGGGGGTGTTGCTGGAAACACCATATATTTT	CSARDRGGVAGNTIYF	TRBV20-1	TRBJ1-3
