TGTGCCAATGGACCCGAGGTCTACGAGCAGTACTTC	CANGPEVYEQYF	TRBV11-3	TRBJ2-7
TGTGCCAGCAGTTTGGTGAAGAATAGGGATACGCAGTATTTT	CASSLVKNRDTQYF	TRBV27	TRBJ2-3
TGTGCCAGATTAGTGTTGACTAGGTCAGAGACCCAGTACTTC	CARLVLTRSETQYF	TRBV7-3	TRBJ2-5
TGCAGTGCTTGCACAACTAGCGGGAAGAACACCGGGGAGCTGTTTTTT	CSACTTSGKNTGELFF	TRBV20-1	TRBJ2-2
TGTGCCAGCAGCGAGTCCCCAGAGACAGGTAATGAGCAGTTCTTC	CASSESPETGNEQFF	TRBV7-3	TRBJ2-1
TGTGCCAGTAGTATCAGTGAGGGCAACAATCAGCCCCAGCATTTT	CASSISEGNNQPQHF	TRBV19	TRBJ1-5
TGTGCCAGCAGCGGTCACCAGGCGTCCACCGGGGAGCTGTTTTTT	CASSGHQASTGELFF	TRBV13	TRBJ2-2
TGCGCCAGCAGTGAAGCAAGACTTAGAGGACAGGGAGGCTCCTACGAGCAGTACTTC	CASSEARLRGQGGSYEQYF	TRBV10-1	TRBJ2-7
TGCGCCAGCAGCTTGGCCATTCTAGCGGGGGAACTCTCTCAAGGGGACGAGCAGTACTTC	CASSLAILAGELSQGDEQYF	TRBV5-1	TRBJ2-7
TGCGCCAGCAGCTTGAAACCTACGGGTGGCTACGAGCAGTACTTC	CASSLKPTGGYEQYF	TRBV5-1	TRBJ2-7
TGTGCCTGGAACCTCTTGAGCTCCTACAATGAGCAGTTCTTC	CAWNLLSSYNEQFF	TRBV30	TRBJ2-1
TGTGCCAGCAGTTCGGCCGAGGGGGCAGTTCACACGTATTTT	CASSSAEGAVHTYF	TRBV6-3	TRBJ2-3
TGTGCCAGCAGCTCAGTTCTCCCCACAGATACGCAGTATTTT	CASSSVLPTDTQYF	TRBV7-3	TRBJ2-3
TGTGCCACTCGGCAGGGGTCCCCTCTCATCGGGGAGCTGTTTTTT	CATRQGSPLIGELFF	TRBV11-2	TRBJ2-2
TGTGCCAGCAGCCCCCGGGGGGTACATAGCAATCAGCCCCAGCATTTT	CASSPRGVHSNQPQHF	TRBV13	TRBJ1-5
TGTGCCAGCAGGTGCGGGAAAGCTTTCTTT	CASRCGKAFF	TRBV2	TRBJ1-1
TGTGCCAGCAGCTACGGGGGACTGGGGAACACTGAAGCTTTCTTT	CASSYGGLGNTEAFF	TRBV5-6	TRBJ1-1
TGTGCCAGCAGTTACTCGATATCCAGGACGGGAGAGACCCAGTACTTC	CASSYSISRTGETQYF	TRBV6-5	TRBJ2-5
TGTGCCACCAGTGATGACCGGGGGGACAGGGGAGGAGAGACCCAGTACTTC	CATSDDRGDRGGETQYF	TRBV24-1	TRBJ2-5
TGCGCCAGCAGTGAGCAGCTCCTCTATCGAGGACAGGACACGAACACTGAAGCTTTCTTT	CASSEQLLYRGQDTNTEAFF	TRBV10-1	TRBJ1-1
TGTGCCAGCAGCTCGGGACTAGCGGGAGATACGCAGTATTTT	CASSSGLAGDTQYF	TRBV7-3	TRBJ2-3
TGTGCCAGCAGCCTATACCCGGGACTAGCGGGGGGAAACGATGAGCAGTTCTTC	CASSLYPGLAGGNDEQFF	TRBV9	TRBJ2-1
TGTGCCTGGACGGAGTTAATGGCAGCTTTCTTT	CAWTELMAAFF	TRBV30	TRBJ1-1
TGTGCCAGCACCCAGGGGGCGGCCTACGAGCAGTACTTC	CASTQGAAYEQYF	TRBV7-2	TRBJ2-7
TGTGCCAGCAGCACCCCCTTGGGACAGGTTTATCAGCCCCAGCATTTT	CASSTPLGQVYQPQHF	TRBV11-2	TRBJ1-5
TGTGCCAGCAGCGTAGTAATCAGGGACGAGCAGTACTTC	CASSVVIRDEQYF	TRBV9	TRBJ2-7
TGTGCCAGCCCGGGACGCTTAGTCTCAGATACGCAGTATTTT	CASPGRLVSDTQYF	TRBV19	TRBJ2-3
TGTGCCAGCAGTCAGGAAAGTGGGTTTCACTACAATGAGCAGTTCTTC	CASSQESGFHYNEQFF	TRBV6-2	TRBJ2-1
TGCAGTGCGACGGGGGGCAGGAACAATGAGCAGTTCTTC	CSATGGRNNEQFF	TRBV20-1	TRBJ2-1
TGTGCCTGGAGTCTATGTTGGGTCGGGGAACGCCAAGACTTC	CAWSLCWVGERQDF	TRBV30	TRBJ1-2
TGTGCCAGTAGGTTCCGGAGGGAAAATCAGCCCCAGCATTTT	CASRFRRENQPQHF	TRBV19	TRBJ1-5
TGTGCCAGCAGCGTCGGACTAGCGGGAGTTAAGGAGCAGTACTTC	CASSVGLAGVKEQYF	TRBV14	TRBJ2-7
TGTGCCAGCAGCCACGTCGGACAGCTCTGCAATCAGCCCCAGCATTTT	CASSHVGQLCNQPQHF	TRBV9	TRBJ1-5
TGTGCCAGCAGTACGAGCGGGAGCCATAGCAATCAGCCCCAGCATTTT	CASSTSGSHSNQPQHF	TRBV6-1	TRBJ1-5
TGTGCCAGCAGTAGGGGGACAGGCCCGAGTTTCTACGAGCAGTACTTC	CASSRGTGPSFYEQYF	TRBV12-4	TRBJ2-7
TGTGCCAGCAGTTTGGGACAGGGGGCTGCGAGCTCTGGAAACACCATATATTTT	CASSLGQGAASSGNTIYF	TRBV28	TRBJ1-3
TGTGCCAGCAAGGGAGTGGGGCAGGGAATTAACTATGGCTACACCTTC	CASKGVGQGINYGYTF	TRBV14	TRBJ1-2
TGTGCCAGCAGCCCTATCTGGGAGGGTACCACAGATACGCAGTATTTT	CASSPIWEGTTDTQYF	TRBV7-9	TRBJ2-3
TGTGCCAGCAGAGGGGACAGGGGAAGTAGACAGAATGAAAAACTGTTTTTT	CASRGDRGSRQNEKLFF	TRBV2	TRBJ1-4
TGTGCCAGCAGCCAAGATAATCCGGCTAGCTATCGGAACACTGAAGCTTTCTTT	CASSQDNPASYRNTEAFF	TRBV14	TRBJ1-1
TGTGCCAGCAGTCCTCAGGGGGCGAAACAGCCCCAGCATTTT	CASSPQGAKQPQHF	TRBV12-3	TRBJ1-5
TGTGCCAGCAGCTTACCCAGGGGGAGCAATCAGCCCCAGCATTTT	CASSLPRGSNQPQHF	TRBV7-9	TRBJ1-5
TGTGCCAGCAGCTTGGAAGTGGCGGCTGACACCGGGGAGCTGTTTTTT	CASSLEVAADTGELFF	TRBV5-6	TRBJ2-2
TGTGCCAGCAGAATAGGTATGCACTATGGCTACACCTTC	CASRIGMHYGYTF	TRBV27	TRBJ1-2
TGCAGTGCGACCGGACTCTCTTACCAAGAGACCCAGTACTTC	CSATGLSYQETQYF	TRBV20-1	TRBJ2-5
TGTGCCAGCAGCTTAGCGCTGGTCCCAGACTGGAAGGGGAACACCGGGGAGCTGTTTTTT	CASSLALVPDWKGNTGELFF	TRBV7-2	TRBJ2-2
TGCAGCGTTGGGAACCAGGGGACGGGGTGTGACAATGAGCAGTTCTTC	CSVGNQGTGCDNEQFF	TRBV29-1	TRBJ2-1
TGTGCCAGCAGTAGAACGCCTTGCCAGTACGAGCAGTACTTC	CASSRTPCQYEQYF	TRBV12-3	TRBJ2-7
TGTGCCAGCTCACCACATGTAGTCCCAGGGGGCGCAAGTTCTGGGGCCAACGTCCTGACTTTC	CASSPHVVPGGASSGANVLTF	TRBV18	TRBJ2-6
TGCGCCAGCAGTGAGCGGATACGGAGCTATGGCTACACCTTC	CASSERIRSYGYTF	TRBV10-2	TRBJ1-2
TGTGCCAGCAGCGCACTAGCGGGAGACGGAGGGGAGACCCAGTACTTC	CASSALAGDGGETQYF	TRBV9	TRBJ2-5
TGTGCCAGCAGTTTAATTACCCTCGTAGCCACCAATGAGCAGTTCTTC	CASSLITLVATNEQFF	TRBV27	TRBJ2-1
TGTGCCAGCAGCGTAGGGGCAGGGATAAACATTCAGTACTTC	CASSVGAGINIQYF	TRBV9	TRBJ2-4
TGCAGTGCTAGGGGCGAGACGGCCTACGAGCAGTACTTC	CSARGETAYEQYF	TRBV20-1	TRBJ2-7
TGTGCTAGCAGCTTAGCGAGCGGCCCGGGCTACACCTTC	CASSLASGPGYTF	TRBV7-7	TRBJ1-2
TGTGCCAGCAGTGAACATCAGACGGTGGGTCAGCCCCAGCATTTT	CASSEHQTVGQPQHF	TRBV6-1	TRBJ1-5
TGTGCCAGCAGCCATGCTCGTACCCTCCACTTT	CASSHARTLHF	TRBV13	TRBJ1-6
TGTGCTAGTGGCCTGACGTACGAGCAGTACTTC	CASGLTYEQYF	TRBV12-5	TRBJ2-7
TGTGCCATCAGTGAGTCGATTCTTTCAGGGAACCAAGAGACCCAGTACTTC	CAISESILSGNQETQYF	TRBV10-3	TRBJ2-5
TGCAGTGCTAGAGATGTCGGGGCACCCCTCCACTTT	CSARDVGAPLHF	TRBV20-1	TRBJ1-6
TGTGCCAGCAGCCAAGACAGGGGTGGGAGTAATTCACCCCTCCACTTT	CASSQDRGGSNSPLHF	TRBV14	TRBJ1-6
TGTGCCAGCAGTAGGGACTCTGGAAACACCATATATTTT	CASSRDSGNTIYF	TRBV6-2	TRBJ1-3
TGCGCCAGCAGCCCTAGTCATGCGACAGGGGGTGAAGTATCGAACACTGAAGCTTTCTTT	CASSPSHATGGEVSNTEAFF	TRBV10-1	TRBJ1-1
TGCGCCAGCAGACGAGCTGCCAATCAGCCCCAGCATTTT	CASRRAANQPQHF	TRBV5-1	TRBJ1-5
TGTGCCAGCAGCTTAAAGGCGGTGAACACTGAAGCTTTCTTT	CASSLKAVNTEAFF	TRBV7-8	TRBJ1-1
TGTGCCAGCTCGGAATCCGGGGGGATCGGAGATACGCAGTATTTT	CASSESGGIGDTQYF	TRBV18	TRBJ2-3
TGTGCCAGCAGCTTAGCGTTTAAGCCGACACAGGGGGGCGGAAACATTCAGTACTTC	CASSLAFKPTQGGGNIQYF	TRBV7-2	TRBJ2-4
TGTGCCAGCAGCTTACCCAGGCCCCGAATCGACTACGAGCAGTACTTC	CASSLPRPRIDYEQYF	TRBV9	TRBJ2-7
TGTGCCACAACCGGGACAGGGCACGAGCAGTACTTC	CATTGTGHEQYF	TRBV6-5	TRBJ2-7
TGTGCCAGCAGACAGGGGGCTGACACAGATACGCAGTATTTT	CASRQGADTDTQYF	TRBV25-1	TRBJ2-3
TGCGCCAGCAGTGAAATGACAGGGACTGGAAACACCATATATTTT	CASSEMTGTGNTIYF	TRBV10-1	TRBJ1-3
TGCGCCAGCAGTGATTCAAAATTCCCTAGCGGGAAGCGGGGCTTCTTC	CASSDSKFPSGKRGFF	TRBV10-1	TRBJ2-1
TGTGCCAGCACCACGGGGGGTAGGATTAGTGAGCAGTTCTTC	CASTTGGRISEQFF	TRBV6-4	TRBJ2-1
TGCGCCAGCGGGGGACAAGAGACCCAGTACTTC	CASGGQETQYF	TRBV10-2	TRBJ2-5
TGTGCCAGCAGTTTCCATCCACAGGGGACCAGTGATAGTGCAACTAATGAAAAACTGTTTTTT	CASSFHPQGTSDSATNEKLFF	TRBV12-3	TRBJ1-4
TGTGCCAGCAGCTTGGACAGGGAGTATGAGCAGTTCTTC	CASSLDREYEQFF	TRBV13	TRBJ2-1
TGTGCCAGCAGTTCCCCTCGCAGGGGGCAGGGCCCGAATGAGCAGTTCTTC	CASSSPRRGQGPNEQFF	TRBV6-5	TRBJ2-1
TGTGCCAGCAGCCCCCCCAGGGTGAGAGACACTGAAGCTTTCTTT	CASSPPRVRDTEAFF	TRBV12-3	TRBJ1-1
TGTGCCAGCAGCCTCCCCCGGGACAAACGGAACTTC	CASSLPRDKRNF	TRBV11-3	TRBJ2-7
TGTGCTAGTGGCAAAGGGGGCACCTCTCCGAACACCGGGGAGCTGTTTTTT	CASGKGGTSPNTGELFF	TRBV12-5	TRBJ2-2
TGTGCCAGCAGCTTGGATCAGGCGAGAGGAAACACCATATATTTT	CASSLDQARGNTIYF	TRBV5-4	TRBJ1-3
TGTGCCAGCAGTGAGGACAGTAATGAAGCTTTCTTT	CASSEDSNEAFF	TRBV6-4	TRBJ1-1
TGTGCCAGCAGCCAAGACAGGGGGCTTAAGATGAACACTGAAGCTTTCTTT	CASSQDRGLKMNTEAFF	TRBV14	TRBJ1-1
TGTGCCACCAATGACAGGGGGCCTAACTATGGCTACACCTTC	CATNDRGPNYGYTF	TRBV24-1	TRBJ1-2
TGTGCCGAACAAGGGGGGCGTACTGAAGCTTTCTTT	CAEQGGRTEAFF	TRBV19	TRBJ1-1
TGTGCCAGCAGCCACGGGGGAAACGAGGGAGAGCAGTACTTC	CASSHGGNEGEQYF	TRBV5-5	TRBJ2-7
TGTGCTAGTGGTTTCCGCCCCCGGGATAGCAATCAGCCCCAGCATTTT	CASGFRPRDSNQPQHF	TRBV12-5	TRBJ1-5
TGTGCCTGGAGTGTAGGGGGGGCCCCCAAAAACATTCAGTACTTC	CAWSVGGAPKNIQYF	TRBV30	TRBJ2-4
TGTGCCAGCAGCTTAGCGCCGGAGTCCGGCCAGTACTTC	CASSLAPESGQYF	TRBV7-9	TRBJ2-5
TGCGCCAGCGGAAACCGAGGTCGCACAGATACGCAGTATTTT	CASGNRGRTDTQYF	TRBV4-3	TRBJ2-3
TGTGCCAGCAGCTTACCGGGCCTTAACACCGGGGAGCTGTTTTTT	CASSLPGLNTGELFF	TRBV11-1	TRBJ2-2
TGTGCCAGCAGCTTGGGGGGCCGGAGGTATGGCTACACCTTC	CASSLGGRRYGYTF	TRBV5-4	TRBJ1-2
TGCAGTGCTAGAGCTTACAGCACGAATGAAAAACTGTTTTTT	CSARAYSTNEKLFF	TRBV20-1	TRBJ1-4
TGTGCCAGCAGCAACTTTCCTGGGTCAAACACTGAAGCTTTCTTT	CASSNFPGSNTEAFF	TRBV11-3	TRBJ1-1
TGTGCCAGCAGCCAAGCACCCGGAATTACCCAGTACTTC	CASSQAPGITQYF	TRBV3-1	TRBJ2-5
TGTGCCAGCAGCATTAGCACTGAAGCTTTCTTT	CASSISTEAFF	TRBV9	TRBJ1-1
TGTGCCAGCAGTGAGCCCCACCCCCGGACTCGGACGGACACTGAAGCTTTCTTT	CASSEPHPRTRTDTEAFF	TRBV6-4	TRBJ1-1
TGTGCCAGCAGCTTCTGGCGCCGGATTCAGCCCCAGCATTTT	CASSFWRRIQPQHF	TRBV5-5	TRBJ1-5
TGTGCCTGGATCCGGGTACAAGGTAACTACGAGCAGTACTTC	CAWIRVQGNYEQYF	TRBV30	TRBJ2-7
TGCAGTGCTAGAGCGATGGGAGACACAACGCGGGACAGGGGGCGCGCGCAGTATTTT	CSARAMGDTTRDRGRAQYF	TRBV20-1	TRBJ2-3
