TGTGCCAGCTCACGGAAAGCGGGAGAAATGATAACTGGAAACACCATATATTTT	CASSRKAGEMITGNTIYF	TRBV18	TRBJ1-3
TGTGCCAGCTCCCAGGGGGACTATGGCTACACCTTC	CASSQGDYGYTF	TRBV7-9	TRBJ1-2
TGTGCCAGCAGCTGGACAGGGGGGTACTATGGCTACACCTTC	CASSWTGGYYGYTF	TRBV13	TRBJ1-2
TGCGCCCACAGGGATGAGCAGTTCTTC	CAHRDEQFF	TRBV4-1	TRBJ2-1
TGCAGTGCTAGAGCCATGGGCGGCGGCTACGAGCAGTACTTC	CSARAMGGGYEQYF	TRBV20-1	TRBJ2-7
TGTGCCAGCAGCTTAGGGAGGGGGCCCTACGAGCAGTACTTC	CASSLGRGPYEQYF	TRBV11-2	TRBJ2-7
TGTGCCAGCAGGAGAAGGGTCACAGGTGGGCGGGACACTGAAGCTTTCTTT	CASRRRVTGGRDTEAFF	TRBV6-5	TRBJ1-1
TGTGCCAGCAGCCAAGGGGGGACTAGCTACGAGCAGTACTTC	CASSQGGTSYEQYF	TRBV3-1	TRBJ2-7
TGTGCCAGCAGTTTATACCTCCTAGCGGGGGATGAGCAGTTCTTC	CASSLYLLAGDEQFF	TRBV27	TRBJ2-1
TGTGCCACCAGCAGAGATCGGAGGACAGCTTGCTTTAATGAAAAACTGTTTTTT	CATSRDRRTACFNEKLFF	TRBV15	TRBJ1-4
TGTGCCTGGAGTGGGGAGGGACAGGGACAGGGGGCTCATGTTACGCAGTATTTT	CAWSGEGQGQGAHVTQYF	TRBV30	TRBJ2-3
TGTGCCAGCAGTGACAGGGGGCGGTGGCAGTACTTC	CASSDRGRWQYF	TRBV27	TRBJ2-7
TGTGCCAGCATGGCCTGGGGGGGCCACATCCCCTACGAGCAGTACTTC	CASMAWGGHIPYEQYF	TRBV6-2	TRBJ2-7
TGTGCCGACGGGGGGGACTATCCCCCTCGTGAGACCCAGTACTTC	CADGGDYPPRETQYF	TRBV10-3	TRBJ2-5
TGTGCCAGCAGTGACATCACACTCGGACTAGCGGACTACCACCCCTACGAGCAGTACTTC	CASSDITLGLADYHPYEQYF	TRBV6-4	TRBJ2-7
TGTGCCAGCACTGACCTCCCGGGACCCGGTATCGGTGATGTATCCTACGAGCAGTACTTC	CASTDLPGPGIGDVSYEQYF	TRBV27	TRBJ2-7
TGTGCTAGTGGTTTGGTAAGGGACGGACGTCCGAACATTCAGTACTTC	CASGLVRDGRPNIQYF	TRBV12-5	TRBJ2-4
TGTGCCAGCAGCTTGGACAGGGGGAGGTCTCATCAAGAGACCCAGTACTTC	CASSLDRGRSHQETQYF	TRBV11-3	TRBJ2-5
TGTGCCAGCAGCCCTGTTGAGGAAAGCTCTGGGGCCAACGTCCTGACTTTC	CASSPVEESSGANVLTF	TRBV3-1	TRBJ2-6
TGCGCCAGCAGCCAACCAGGAACAAGAGTGGCCAAAAACATTCAGTACTTC	CASSQPGTRVAKNIQYF	TRBV4-1	TRBJ2-4
TGTGCCAGCAGCGAATCGGGACCCCAGGGGGACACTGAAGCTTTCTTT	CASSESGPQGDTEAFF	TRBV9	TRBJ1-1
TGTGCCTACACTGAAGCTTTCTTT	CAYTEAFF	TRBV19	TRBJ1-1
TGTGCCAGCAGCGTAGCGGGGGTTCACTCTCGTCAGCCCCAGCATTTT	CASSVAGVHSRQPQHF	TRBV9	TRBJ1-5
TGTGCCAGCAACGTCCCCCCGGGACAGGGAGATGGCTACACCTTC	CASNVPPGQGDGYTF	TRBV7-9	TRBJ1-2
TGTGCTAGCAGCTACCTAGGGGTTGTCTACGAGCAGTACTTC	CASSYLGVVYEQYF	TRBV7-7	TRBJ2-7
TGCGCCAGCAGCCAAGAAAAAAGGGTGCGACACCTTAGACGCACAGATACGCAGTATTTT	CASSQEKRVRHLRRTDTQYF	TRBV4-3	TRBJ2-3
TGTGCCAGCAGTGAAGTCGCCCCTAGAGGGAGCTCCTACAATGAGCAGTTCTTC	CASSEVAPRGSSYNEQFF	TRBV6-1	TRBJ2-1
TGCGCCAGCAGCTTGCACCGAGGTGACGAGCAGTACTTC	CASSLHRGDEQYF	TRBV5-1	TRBJ2-7
TGTGCCAGCAGTTATTTCGGGGTTTTGAGCAATCAGCCCCAGCATTTT	CASSYFGVLSNQPQHF	TRBV6-5	TRBJ1-5
TGTGCCAGCGGACCTCTAGCGGGGGTAAGGGGGGGGGGAGCCAAAAACATTCAGTACTTC	CASGPLAGVRGGGAKNIQYF	TRBV7-2	TRBJ2-4
TGTGCCACCAGTGATTCCCACGACAGGGGTTTTTACAGAGAGACCCAGTACTTC	CATSDSHDRGFYRETQYF	TRBV24-1	TRBJ2-5
TGTGCCAGCAGCTTGGCCCCAGCCTCGGGGACCTACGAGCAGTACTTC	CASSLAPASGTYEQYF	TRBV5-4	TRBJ2-7
TGTGCCAGCAGCCAACGACACTATAATTCACCCCTCCACTTT	CASSQRHYNSPLHF	TRBV4-2	TRBJ1-6
TGTGCCAGCAGCGGCGGGGCTCAGCCCCAGCATTTT	CASSGGAQPQHF	TRBV7-4	TRBJ1-5
TGTGCCAGCAGTTATTTCCCCAGCGTTCCACCGGGGACAGGGGCTAGGGAAGTGATAGGCGTTAGCTCCTACAATGAGCAGTTCTTC	CASSYFPSVPPGTGAREVIGVSSYNEQFF	TRBV6-5	TRBJ2-1
TGCAGCGTTGAAGCAATTAATTGGGTGGGAGGGGGAAACACCATATATTTT	CSVEAINWVGGGNTIYF	TRBV29-1	TRBJ1-3
TGCGCCAGCAGTGAGTCTCATAAAGCCCAAGATACGCAGTATTTT	CASSESHKAQDTQYF	TRBV10-1	TRBJ2-3
TGTGCCAGCAGCTTAGGATGGGGGTGCGAGCAGTACTTC	CASSLGWGCEQYF	TRBV7-8	TRBJ2-7
TGCAGTGCTCAAGCAAACTATGGCTACACCTTC	CSAQANYGYTF	TRBV20-1	TRBJ1-2
TGTGCCAGCAGGCCCCCACTCCAGCGCACGGCGACTAGAGCCTACGAGCAGTACTTC	CASRPPLQRTATRAYEQYF	TRBV13	TRBJ2-7
TGTGCCACCAGCCTCGGTCGGGACTCTGGCACCGGGGAGCTGTTTTTT	CATSLGRDSGTGELFF	TRBV15	TRBJ2-2
TGTGCCAGCAGGGCACGTAGGGGATCCGACACTGAAGCTTTCTTT	CASRARRGSDTEAFF	TRBV6-1	TRBJ1-1
TGTGCCAGCAGTAGGGGGGGGATGTACAATGAGCAGTTCTTC	CASSRGGMYNEQFF	TRBV6-4	TRBJ2-1
TGTGCCAGCAGTTTAGGACTAGCGGGAGGCACAGATACGCAGTATTTT	CASSLGLAGGTDTQYF	TRBV12-3	TRBJ2-3
TGTGCCAGCAGCGTAGCCCCGGGTACCTATGAAGCTTTCTTT	CASSVAPGTYEAFF	TRBV9	TRBJ1-1
TGCGCCAGCAGCCAAGAAGCCCCAGTCCCCACTGAAGATACGCAGTATTTT	CASSQEAPVPTEDTQYF	TRBV4-1	TRBJ2-3
TGTGCCAGCAGTTTAACCGGGGGATCCGGGTTTTCACCCCTCCACTTT	CASSLTGGSGFSPLHF	TRBV27	TRBJ1-6
TGTGCCAGCAGTGAAGAAGATTTTGCGGTTCCCAATCAGCCCCAGCATTTT	CASSEEDFAVPNQPQHF	TRBV6-1	TRBJ1-5
TGTGCCAGCAGCAGGAGGTGGGGAAACACTGAAGCTTTCTTT	CASSRRWGNTEAFF	TRBV13	TRBJ1-1
TGTGCCAGCAGAAGGCCCCCGACAGGGGGGGACTATGGCTACACCTTC	CASRRPPTGGDYGYTF	TRBV6-2	TRBJ1-2
TGTGCCAGCAGCTTTCTCGGAAAGAAATCGGAGCGGGAGCTCACTGAAGCTTTCTTT	CASSFLGKKSERELTEAFF	TRBV14	TRBJ1-1
TGCAGTGCTAGAACACCACGGGTGCTCGGGGACAGTCCCCTCCACTTT	CSARTPRVLGDSPLHF	TRBV20-1	TRBJ1-6
TGTGCCAGCAGCCAGGACCCAACAGGGGATCAGCCCCAGCATTTT	CASSQDPTGDQPQHF	TRBV13	TRBJ1-5
TGTGCCAGCAGTTGTCGGACAGGCGAGCAGTACTTC	CASSCRTGEQYF	TRBV12-4	TRBJ2-7
TGTGCCAGCAGGCATCAGGCAAGGGCTATTAGGATGTCTGGAAACACCATATATTTT	CASRHQARAIRMSGNTIYF	TRBV5-6	TRBJ1-3
TGTGCCAGCATAACGGACGATGAAGCTTTCTTT	CASITDDEAFF	TRBV3-1	TRBJ1-1
TGCGCCAGCAGCCAAACTAGCGCGAATGAGCAGTTCTTC	CASSQTSANEQFF	TRBV4-3	TRBJ2-1
TGCAGCGTTGAAAAACTGCCGATCTACGAGCAGTACTTC	CSVEKLPIYEQYF	TRBV29-1	TRBJ2-7
TGTGCCAGCAGTACCCACCTCTCGGGGAGGAACAATGAGCAGTTCTTC	CASSTHLSGRNNEQFF	TRBV6-6	TRBJ2-1
TGTGCCACCAGGACCCCGTCAACGATTGTGTACACCGGGGAGCTGTTTTTT	CATRTPSTIVYTGELFF	TRBV24-1	TRBJ2-2
TGCAGTGCTAGAGCCCCCGGACTTCTTCTACCCTCCTACAATGAGCAGTTCTTC	CSARAPGLLLPSYNEQFF	TRBV20-1	TRBJ2-1
TGCGCCAGCAGCGATCAGTCCAGGGATAGCAATCAGCCCCAGCATTTT	CASSDQSRDSNQPQHF	TRBV5-1	TRBJ1-5
TGTGCTAGTGGTTTGGTATACATGCGGGAGCTTGGATGGACCCAGTACTTC	CASGLVYMRELGWTQYF	TRBV12-5	TRBJ2-5
TGTGCCAGCAGTTATCATGCCAGGGACAGGTCTAACTATGGCTACACCTTC	CASSYHARDRSNYGYTF	TRBV6-2	TRBJ1-2
TGCGCCAGCAAGGGGGCTAACTATGGCTACACCTTC	CASKGANYGYTF	TRBV5-1	TRBJ1-2
TGTGCCAGCAGCGCTCCGGAGACCGGGACTAGATGCTACAATGAGCAGTTCTTC	CASSAPETGTRCYNEQFF	TRBV9	TRBJ2-1
TGTGCCTGGAGTGTTCCAGTATACGAGCAGTACTTC	CAWSVPVYEQYF	TRBV30	TRBJ2-7
TGTGCCAGCAGCATTCCGACAGGGCAAGGGTATGGCTACACCTTC	CASSIPTGQGYGYTF	TRBV4-2	TRBJ1-2
TGCGCCAGCAGTTCCAACCGGGGAGGCTACGAGCAGTACTTC	CASSSNRGGYEQYF	TRBV10-1	TRBJ2-7
TGTGCCAGCTCACCAGGGGCAGGCTACACCTTC	CASSPGAGYTF	TRBV18	TRBJ1-2
TGTGCCAGCGGGGGGGAGCCGTCCAATGAGCAGTTCTTC	CASGGEPSNEQFF	TRBV27	TRBJ2-1
TGTGCCAGCAGTTTAAATGTCCGAATCGCCAGAGACTCTGGGGCCAACGTCCTGACTTTC	CASSLNVRIARDSGANVLTF	TRBV27	TRBJ2-6
TGTGCCACCAAAGGGACTAGCGCCCGAGATACGCAGTATTTT	CATKGTSARDTQYF	TRBV24-1	TRBJ2-3
TGTGCCAGCAGCTTCGAGGGTGCGGAAGAGACCCAGTACTTC	CASSFEGAEETQYF	TRBV5-8	TRBJ2-5
TGTGCCAGCAGCCAAGGGGACAGGAACAATAACACTGAAGCTTTCTTT	CASSQGDRNNNTEAFF	TRBV3-1	TRBJ1-1
TGTGCCAGCAGCCACGGACTAGCGTTAAAGGGGGACCATGAGCAGTTCTTC	CASSHGLALKGDHEQFF	TRBV14	TRBJ2-1
TGCAGTGCTAGGGCTCCAGCGGGAGATAAGGGAGCCAAAAACATTCAGTACTTC	CSARAPAGDKGAKNIQYF	TRBV20-1	TRBJ2-4
TGTGCCAGCAACAGGGCGGGGGGTAATGAAAAACTGTTTTTT	CASNRAGGNEKLFF	TRBV3-1	TRBJ1-4
TGTGCCTGGAGTGGCTTCAAGGGACTCTATAACTATGGCTACACCTTC	CAWSGFKGLYNYGYTF	TRBV30	TRBJ1-2
TGTGCCAGCAGCTTATACGGCTCTGGGGCCAACGTCCTGACTTTC	CASSLYGSGANVLTF	TRBV7-4	TRBJ2-6
TGTGCCGGAATAGCGGGTAATTACAATGAGCAGTTCTTC	CAGIAGNYNEQFF	TRBV6-3	TRBJ2-1
TGTGCCAGCAGCATGGCAATGGGGAACGAAGCTTTCTTT	CASSMAMGNEAFF	TRBV13	TRBJ1-1
TGTGCCAGCAGTTACACCGAGGGGGGCCACTACGAGCAGTACTTC	CASSYTEGGHYEQYF	TRBV6-3	TRBJ2-7
TGTGCCAGCAGTCGGGGCGACGACTACGAGCAGTACTTC	CASSRGDDYEQYF	TRBV28	TRBJ2-7
TGCGCCAGCAGCCTTATCGAAGCCAAAAACATTCAGTACTTC	CASSLIEAKNIQYF	TRBV4-1	TRBJ2-4
TGTGCTAGTGGTTTGGTATCCGGACAGGGGGGGACCGGAGAGACCCAGTACTTC	CASGLVSGQGGTGETQYF	TRBV12-5	TRBJ2-5
TGTGCCAGCAGGTTCACCCGTAGGAACTATGGCTACACCTTC	CASRFTRRNYGYTF	TRBV2	TRBJ1-2
TGTGCCTGGAAAAGGGGTGGAAACCAAGGCTCCTACAATGAGCAGTTCTTC	CAWKRGGNQGSYNEQFF	TRBV30	TRBJ2-1
TGTGCCAGCAGCAAGAGGGGGGACTACGAGCAGTACTTC	CASSKRGDYEQYF	TRBV7-3	TRBJ2-7
TGTGCCAGCATTTCAAACGGCTACACCTTC	CASISNGYTF	TRBV27	TRBJ1-2
TGTGCCACCAGTGATTTGTACCCCAGTCGTTCGGATTCCCGGGACAGGGGTAGCAATCAGCCCCAGCATTTT	CATSDLYPSRSDSRDRGSNQPQHF	TRBV24-1	TRBJ1-5
TGTGCCAGCAGCACCAGCGGGACAGGGGGCGCAGCTGAAGCTTTCTTT	CASSTSGTGGAAEAFF	TRBV13	TRBJ1-1
TGCAGTGGTAATGACGCATGCAATCAGCCCCAGCATTTT	CSGNDACNQPQHF	TRBV20-1	TRBJ1-5
TGTGCCAGCAGCCAGCCCCCGCGGCCTGCCTACGAGCAGTACTTC	CASSQPPRPAYEQYF	TRBV5-6	TRBJ2-7
TGCAGTGCTAGAGATCAAAGGGACAGCAATCAGCCCCAGCATTTT	CSARDQRDSNQPQHF	TRBV20-1	TRBJ1-5
TGTGCCAGCAGCTGCTTAGCGGTAGGAGCTTTCTTT	CASSCLAVGAFF	TRBV5-6	TRBJ1-1
TGCAGTGCTAGACACAGGACACCCACTGAAGCTTTCTTT	CSARHRTPTEAFF	TRBV20-1	TRBJ1-1
TGTGCCAGCAGGTACAGGGTATGCTACGAGCAGTACTTC	CASRYRVCYEQYF	TRBV27	TRBJ2-7
TGTGCCAGCAGTTACCTAGATCGGGGGTGGACAGATACGCAGTATTTT	CASSYLDRGWTDTQYF	TRBV6-6	TRBJ2-3
TGCGCCAGCAGCCAAGCATTTGACCTAGAAAGCTCCTACGAGCAGTACTTC	CASSQAFDLESSYEQYF	TRBV4-3	TRBJ2-7
