TGCGCCAGCAAAAGGGGACCTGAAGCTTTCTTT	CASKRGPEAFF	TRBV5-1	TRBJ1-1
TGTGCCAGCAGTTGGGAGTCTGAAAAACTGTTTTTT	CASSWESEKLFF	TRBV6-2	TRBJ1-4
TGCAGTGCTATCGGAAGGGAGCACTGCACTGAAGCTTTCTTT	CSAIGREHCTEAFF	TRBV20-1	TRBJ1-1
TGCAGTGCCAGAGGGAGAATTACCCCCTACAATGAGCAGTTCTTC	CSARGRITPYNEQFF	TRBV20-1	TRBJ2-1
TGTGCCAGCAGCTTACTAGGGTCTCAGCCCCAGCATTTT	CASSLLGSQPQHF	TRBV13	TRBJ1-5
TGTGCCAGCAAGCGGGGGGATGAGCAGTTCTTC	CASKRGDEQFF	TRBV27	TRBJ2-1
TGTGTGTGGGGGAAGAGTCTTCCATCTGGAAACACCATATATTTT	CVWGKSLPSGNTIYF	TRBV14	TRBJ1-3
TGTGCCAGCAGCGGCGGGTCCCTTTATAAGCGGGAGGGCTCAATCACAGATACGCAGTATTTT	CASSGGSLYKREGSITDTQYF	TRBV13	TRBJ2-3
TGTGCCAGCAACTTCCGGACTACTGAAGCTTTCTTT	CASNFRTTEAFF	TRBV6-3	TRBJ1-1
TGCAGTGCCCATAGCGGGGGGAATGAGCAGTTCTTC	CSAHSGGNEQFF	TRBV20-1	TRBJ2-1
TGTGCCAGCAGTGAAGCGTCCCACGGATTCAGGTTAAGCAATCAGCCCCAGCATTTT	CASSEASHGFRLSNQPQHF	TRBV2	TRBJ1-5
TGTGCCAGCAGTGGGCCACCCTTACCTCAAGACAATGAGCAGTTCTTC	CASSGPPLPQDNEQFF	TRBV6-1	TRBJ2-1
TGTGCCAGCAGCTTGGTAACGAGGATCCGGAGTGAAGCTTTCTTT	CASSLVTRIRSEAFF	TRBV5-6	TRBJ1-1
TGTGCCAGCAGTTTCTCCTGCGGTACCCACGAGCAGTACTTC	CASSFSCGTHEQYF	TRBV27	TRBJ2-7
TGCAGTGCTGGTGAACTGGTGGACTCTTCCTACGAGCAGTACTTC	CSAGELVDSSYEQYF	TRBV20-1	TRBJ2-7
TGCAGTGCTCCCGGACTAGCGGGTCGCACAGATACGCAGTATTTT	CSAPGLAGRTDTQYF	TRBV20-1	TRBJ2-3
TGTGCCAGCAGCTTAGTTCAAGCGGGAGATGACTACGAGCAGTACTTC	CASSLVQAGDDYEQYF	TRBV7-9	TRBJ2-7
TGCAGTGCTAGGGGGACAGGGTCTTTAACCGGGGAGCTGTTTTTT	CSARGTGSLTGELFF	TRBV20-1	TRBJ2-2
TGCGCCAGCAGCCAAGCTGGGGGAGGCACTGAAGCTTTCTTT	CASSQAGGGTEAFF	TRBV4-3	TRBJ1-1
TGTGCCAGCATCCCGGGTGGGCAGAGCTCCTACGAGCAGTACTTC	CASIPGGQSSYEQYF	TRBV6-5	TRBJ2-7
TGTGCCAGCAGTTACCCCACTCCCGCTAGCGGGCAGCCCGTGAATTCTGAGACCCAGTACTTC	CASSYPTPASGQPVNSETQYF	TRBV6-6	TRBJ2-5
TGTGCCAGTAGTTACGCCCAGGGATGGTCCTACGAGCAGTACTTC	CASSYAQGWSYEQYF	TRBV19	TRBJ2-7
TGTGCCAGCATGACAGACGGCTATCAGCCCCAGCATTTT	CASMTDGYQPQHF	TRBV25-1	TRBJ1-5
TGTGCCAGCAGCTTAGAACGGACAGCGAGGGCGCGGTCCCGGGCCAACGTCCTGACTTTC	CASSLERTARARSRANVLTF	TRBV7-9	TRBJ2-6
TGTGCCAGCAGCTTAGGGAGATCCCGTAAAGGGGGGGAAGCTTTCTTT	CASSLGRSRKGGEAFF	TRBV11-3	TRBJ1-1
TGTGCCAACTTTGTCCGGGCCTACCAAGAGACCCAGTACTTC	CANFVRAYQETQYF	TRBV27	TRBJ2-5
TGTGCCAGCAGTTTATCGGCTCCCGGGACAGGGGGCTTGGCCCAGTACCAAGAGACCCAGTACTTC	CASSLSAPGTGGLAQYQETQYF	TRBV27	TRBJ2-5
TGTGCCAGCAGTGTTCAGGGCTATGGCTACACCTTC	CASSVQGYGYTF	TRBV6-2	TRBJ1-2
TGTGCCAGCAGCTGTACGGGCTCCCAAGAGACCCAGTACTTC	CASSCTGSQETQYF	TRBV6-4	TRBJ2-5
TGTGCCAGCAGCGCAGGGAGGAAGTTCTCCAATCAGCCCCAGCATTTT	CASSAGRKFSNQPQHF	TRBV5-6	TRBJ1-5
TGTGCCACCAGTGATTCCTTGACAGGGGAGACCCAGTACTTC	CATSDSLTGETQYF	TRBV24-1	TRBJ2-5
TGTGCCACCAGCAGAGTATACCTTGGGACAGGGTACTTAGACGAGCAGTACTTC	CATSRVYLGTGYLDEQYF	TRBV15	TRBJ2-7
TGTGCCAGCAGCTTGACAGGGGCGATAGCTTTCTTT	CASSLTGAIAFF	TRBV7-6	TRBJ1-1
TGTGCCAGCAGCAGGACAGGGTACACTGGCTACACCTTC	CASSRTGYTGYTF	TRBV13	TRBJ1-2
TGTGCCAGCTCGGACAGGGCCGAGCGCTCAGATACGCAGTATTTT	CASSDRAERSDTQYF	TRBV18	TRBJ2-3
TGTGCCAGCAGCTTGGCAGGGGATCAGCCCCAGCATTTT	CASSLAGDQPQHF	TRBV7-4	TRBJ1-5
TGTGCCAGCAGCTTAGGGGACCCCGACAGGGGGGACTATGGCTACACCTTC	CASSLGDPDRGDYGYTF	TRBV11-2	TRBJ1-2
TGTGCCAGCAGCACCTCTTTAGGGCCATGCATGCCCAATCAGCCCCAGCATTTT	CASSTSLGPCMPNQPQHF	TRBV7-9	TRBJ1-5
TGCAGTGCTACTAGGCCAGGGGCGACTGAAGCTTTCTTT	CSATRPGATEAFF	TRBV20-1	TRBJ1-1
TGCGCCAGCAGCGGACCTCATGAGCAGTTCTTC	CASSGPHEQFF	TRBV5-1	TRBJ2-1
TGTGCCAGCAGCCAAGACAGATTCTACGAGCAGTACTTC	CASSQDRFYEQYF	TRBV3-1	TRBJ2-7
TGCAGTTCAAAGCGGATGGAAGGAGATACGCAGTATTTT	CSSKRMEGDTQYF	TRBV20-1	TRBJ2-3
TGTGCCAGCAGCCCAAAGACAGGCAGCACTGAAGCTTTCTTT	CASSPKTGSTEAFF	TRBV7-3	TRBJ1-1
TGTGCCATCAGTGACCACTTACCCCCACCAGGCCGGGGACACAGCTCCTACAATGAGCAGTTCTTC	CAISDHLPPPGRGHSSYNEQFF	TRBV10-3	TRBJ2-1
TGCGCCAGCAGCTTGCCGAGACAGGGTGGAAACACCATATATTTT	CASSLPRQGGNTIYF	TRBV5-1	TRBJ1-3
TGTGCCAGCAGCTTAACGGGACAGTTGCCCCAGCATTTT	CASSLTGQLPQHF	TRBV7-9	TRBJ1-5
TGTGCCAGCAGCAGAGCGGGAGGGGGTCAGGAACGCACAGATACGCAGTATTTT	CASSRAGGGQERTDTQYF	TRBV7-3	TRBJ2-3
TGTGCCAGCAGCAGAGGCAGGGGGATGTACGAGCAGTACTTC	CASSRGRGMYEQYF	TRBV11-2	TRBJ2-7
TGTGCCAGCAGCGGGGGGCCCAGGGCCCCTTACACTGAAGCTTTCTTT	CASSGGPRAPYTEAFF	TRBV12-4	TRBJ1-1
TGCGCCAGCAGCTGGACTAGCGGGGAAGGGGAGCTGTTTTTT	CASSWTSGEGELFF	TRBV4-1	TRBJ2-2
TGTGCCAGCACCTGGTGGGGGGTAGTTAGCAATCAGCCCCAGCATTTT	CASTWWGVVSNQPQHF	TRBV6-6	TRBJ1-5
TGTGCCAGCAGTTTACATTGGGCAGGGTCTGAAGCTTTCTTT	CASSLHWAGSEAFF	TRBV12-4	TRBJ1-1
TGCAGTGCTGGGCCGGACGACTCTGGAAACACCATATATTTT	CSAGPDDSGNTIYF	TRBV20-1	TRBJ1-3
TGTGCCAGGCCGGGACAGGGCACCCAGTACTTC	CARPGQGTQYF	TRBV28	TRBJ2-5
TGTGCCAGCAGCCCCCGAGGGACTTTATTCACGAGCACAGATACGCAGTATTTT	CASSPRGTLFTSTDTQYF	TRBV4-2	TRBJ2-3
TGCGCCAGCAGCTTGTGGATGGACCCGGGACAGGGTGAAGCTTTCTTT	CASSLWMDPGQGEAFF	TRBV5-1	TRBJ1-1
TGTGCCATAAGGGGAAAGACCACCGGGACTAGACAAAGAAGCACAGATACGCAGTATTTT	CAIRGKTTGTRQRSTDTQYF	TRBV6-3	TRBJ2-3
TGTGCCAGCAGTTACAAATCTGGACGATTCTCCTACGAGCAGTACTTC	CASSYKSGRFSYEQYF	TRBV6-5	TRBJ2-7
TGTGCCAGCAGAGGTTTACAGGGGACGCGGAGGTGTCGTTATAATTCACCCCTCCACTTT	CASRGLQGTRRCRYNSPLHF	TRBV27	TRBJ1-6
TGTGCCAGCAGCTTACGAAGGCCCTACGAGCAGTACTTC	CASSLRRPYEQYF	TRBV11-3	TRBJ2-7
TGTGCCAGCAGCAGGGGTGGACTAGCCAAAAACATTCAGTACTTC	CASSRGGLAKNIQYF	TRBV7-4	TRBJ2-4
TGCGCCAGCAGCCAAGTTGCGCGGGAGCCCTACGAGCAGTACTTC	CASSQVAREPYEQYF	TRBV4-1	TRBJ2-7
TGTGCCAGCAGTAACGGGGGAGGAGGCACAGATACGCAGTATTTT	CASSNGGGGTDTQYF	TRBV27	TRBJ2-3
TGTGCCAGCAGAGAGGGACAGTTCTATGGCTACACCTTC	CASREGQFYGYTF	TRBV6-4	TRBJ1-2
TGTGCCAGCAGCCGGGACAGGGGGCTGGGGGACACTGAAGCTTTCTTT	CASSRDRGLGDTEAFF	TRBV7-3	TRBJ1-1
TGTGCCAGCTGGGGTGACACTGAAGCTTTCTTT	CASWGDTEAFF	TRBV7-2	TRBJ1-1
TGCGCCAGCAGACAGGGCCAGGAGCGTCAGCCCCAGCATTTT	CASRQGQERQPQHF	TRBV5-1	TRBJ1-5
TGCGCCAGCAGCTTGCGGCGCTCCTACGAGCAGTACTTC	CASSLRRSYEQYF	TRBV5-1	TRBJ2-7
TGTGCCAGCAGGCGGGGGTCCACTGAAGCTTTCTTT	CASRRGSTEAFF	TRBV6-1	TRBJ1-1
TGTGCCAGCAGCTTATCCGGAGAGACCCAGTACTTC	CASSLSGETQYF	TRBV11-3	TRBJ2-5
TGTGCCAACCAACTGTTATTAATACAGGGGAGCACAGATACGCAGTATTTT	CANQLLLIQGSTDTQYF	TRBV7-9	TRBJ2-3
TGTGCCAGCAGTGACTCGATCCCCCGGACAGGGGATGATTATGAGCAGTTCTTC	CASSDSIPRTGDDYEQFF	TRBV6-4	TRBJ2-1
TGCGCCAGCAGCGTCGCGGGAGGGGAGAATGAGCAGTTCTTC	CASSVAGGENEQFF	TRBV5-1	TRBJ2-1
TGTGCCAGCAGTGAAGCGTACGTTCCGACAGGTGTTAGCTATGGCTACACCTTC	CASSEAYVPTGVSYGYTF	TRBV6-1	TRBJ1-2
TGTGCCAGCAGTCGAAAGGACTTGTTAGGAATGGAAAAACTGTTTTTT	CASSRKDLLGMEKLFF	TRBV6-4	TRBJ1-4
TGTGCCAGCAGCATAAAGACTGGGACAGGGGGGAAAGGGAGCTCCTACGAGCAGTACTTC	CASSIKTGTGGKGSSYEQYF	TRBV7-9	TRBJ2-7
TGTGCCAGTAGTATCGGCGGACAGCTGGATCAGCCCCAGCATTTT	CASSIGGQLDQPQHF	TRBV19	TRBJ1-5
TGTGCCAGCAGTTTGGACGGGGCAGGAAGTGAAAAACTGTTTTTT	CASSLDGAGSEKLFF	TRBV27	TRBJ1-4
TGTGCCAGCAGTTTATTAGGGGGACCGGAAGAGACCCAGTACTTC	CASSLLGGPEETQYF	TRBV28	TRBJ2-5
TGTGCCAGCAGCTTAGGTCCTTCGGGAACCCGCAATCAGCCCCAGCATTTT	CASSLGPSGTRNQPQHF	TRBV7-9	TRBJ1-5
TGCGCCAGTGTATCGGACTTCAGAGTCTTTTCCAAAAACATTCAGTACTTC	CASVSDFRVFSKNIQYF	TRBV5-1	TRBJ2-4
TGTGCCAGCTCACCAAGCCCCGGGACAGGCGCAAACGAGCAGTACTTC	CASSPSPGTGANEQYF	TRBV18	TRBJ2-7
TGTGAACAGGGTTTCACTGAAGCTTTCTTT	CEQGFTEAFF	TRBV6-4	TRBJ1-1
TGTGCCAGCAGCTTAGTAAACGAGCTGGCGTCCCGGGACAGGGGGCTAGTGTTAGGGCAGTACTTC	CASSLVNELASRDRGLVLGQYF	TRBV11-3	TRBJ2-7
TGTGCCAGCAGCGTAGCCCCCCGGGCCGGGGAGTCCTACAATGAGCAGTTCTTC	CASSVAPRAGESYNEQFF	TRBV9	TRBJ2-1
TGTGCCAGTAGTAGGGGTATGGCCTACGAGCAGTACTTC	CASSRGMAYEQYF	TRBV19	TRBJ2-7
TGTGCCAGCAGGTCGACAGGGGGTTTTGTCTCTGGGGCCAACGTCCTGACTTTC	CASRSTGGFVSGANVLTF	TRBV2	TRBJ2-6
TGTGCCAGCAATCGCTCCCGGGGGAAGAGGAATGAGCAGTTCTTC	CASNRSRGKRNEQFF	TRBV6-3	TRBJ2-1
TGCGCCAGCAGCTTGCTGGGGGTAGGAGCGGACACTAAAAAGCCCCAGCATTTT	CASSLLGVGADTKKPQHF	TRBV5-1	TRBJ1-5
TGCGCCAGCAGTTATGGACAGACGAGCTCCTACGAGCAGTACTTC	CASSYGQTSSYEQYF	TRBV10-1	TRBJ2-7
TGCGCCAGCAGCTTGACACGAAGGGGGCCGAATGAAAAACTGTTTTTT	CASSLTRRGPNEKLFF	TRBV5-1	TRBJ1-4
TGTGCCAGCAACCCGACTAGCGGGATTGACTCCTACGAGCAGTACTTC	CASNPTSGIDSYEQYF	TRBV6-5	TRBJ2-7
TGTGCCAGCAGCGTAGCGTGGCCCGGACAGTACGAGCAGTACTTC	CASSVAWPGQYEQYF	TRBV9	TRBJ2-7
TGTGCCAGTAGTATAGCCACGCGGGAACTAGCGGGAGTCCGAGGCATGAACACTGAAGCTTTCTTT	CASSIATRELAGVRGMNTEAFF	TRBV19	TRBJ1-1
TGTGCCAGCAGTTGCTCGTCCCCGCGGGGGCGACTCGAGACCCAGTACTTC	CASSCSSPRGRLETQYF	TRBV28	TRBJ2-5
TGTGCCAGCAGTCCGAACTGGTCTGAAGCTTTCTTT	CASSPNWSEAFF	TRBV6-5	TRBJ1-1
TGTGCCAGCAGCCAAGGAATTGGACAGGGCTCACCCCTCCACTTT	CASSQGIGQGSPLHF	TRBV13	TRBJ1-6
TGTGCCAGCAGTTTATCCGGGGACGGTTGCGAAGCTTTCTTT	CASSLSGDGCEAFF	TRBV27	TRBJ1-1
TGTGCCAGCAGTGGGGGGGGTGGGGAAATCACTGAAGCTTTCTTT	CASSGGGGEITEAFF	TRBV2	TRBJ1-1
TGTGCCAGCGAAGCGGGATCGAACACTGAAGCTTTCTTT	CASEAGSNTEAFF	TRBV11-2	TRBJ1-1
