TGTGCCAGCAGTTACAGTCACAGGGAAGGCTACGAGCAGTACTTC	CASSYSHREGYEQYF	TRBV6-3	TRBJ2-7
TGTGCCAGCAGCTTAGCCGGGAGGGATAGGGAATACGAGCAGTACTTC	CASSLAGRDREYEQYF	TRBV7-2	TRBJ2-7
TGTGCCACAGGGTATCATCACACCGGGGAGCTGTTTTTT	CATGYHHTGELFF	TRBV24-1	TRBJ2-2
TGCAGTGCTCGGCGGCAAAGGGCCAAAAACATTCAGTACTTC	CSARRQRAKNIQYF	TRBV20-1	TRBJ2-4
TGCGCCAGCAGCTTGTCCCGGAGCTTAGCGGGCATTAGCTCCTACAATGAGCAGTTCTTC	CASSLSRSLAGISSYNEQFF	TRBV5-1	TRBJ2-1
TGTGCCAGCAGCGTAGGTAGTCCACTAGGGCCCCAGCATTTT	CASSVGSPLGPQHF	TRBV9	TRBJ1-5
TGTGCCAGCAGTCGGGATGCAGATGAGAGGAAAACCTACGAGCAGTACTTC	CASSRDADERKTYEQYF	TRBV6-5	TRBJ2-7
TGTGCCAGCAGTTATCGAGCGGTGCCCAATGAGCAGTTCTTC	CASSYRAVPNEQFF	TRBV6-5	TRBJ2-1
TGTGCCAGCAGTGGACAGGCCACTGAAGCTTTCTTT	CASSGQATEAFF	TRBV6-5	TRBJ1-1
TGCGCCAGCAGCTGTAAGAAGGGGACGGGTGGGCCCTACGAGCAGTACTTC	CASSCKKGTGGPYEQYF	TRBV5-1	TRBJ2-7
TGTGCCAGGAACGGACTAGCGGGGGGTACCCACGAGCAGTACTTC	CARNGLAGGTHEQYF	TRBV6-4	TRBJ2-7
TGCGCCAGCCCCTATGGAGAGGGGTATGGCTACACCTTC	CASPYGEGYGYTF	TRBV5-1	TRBJ1-2
TGCAGTGGACTAGGCCGAAAGACCCAGTACTTC	CSGLGRKTQYF	TRBV20-1	TRBJ2-5
TGTGCCAGCAGCGTGACAGGAAGCACAGATACGCAGTATTTT	CASSVTGSTDTQYF	TRBV9	TRBJ2-3
TGTGCCAGCAGTTTACGGACATTCACAGATACGCAGTATTTT	CASSLRTFTDTQYF	TRBV6-5	TRBJ2-3
TGCAGTGCTAGTAGTTGTCTAGGTCAAGAGACCCAGTACTTC	CSASSCLGQETQYF	TRBV20-1	TRBJ2-5
TGTGCCAGCGGCCCCGAGAAAAAGGAGGAAGCTTTCTTT	CASGPEKKEEAFF	TRBV11-2	TRBJ1-1
TGTGCCAGCAGCTTCCGGGGGGGGACTAACTATGGCTACACCTTC	CASSFRGGTNYGYTF	TRBV7-9	TRBJ1-2
TGTGCCAGCAGTGACCCGGAGGGGGGGGGTAATGAAAAACTGTTTTTT	CASSDPEGGGNEKLFF	TRBV6-4	TRBJ1-4
TGTGGGCCCTACACAGAGACCCAGTACTTC	CGPYTETQYF	TRBV28	TRBJ2-5
TGTGCCAGCAGCCCCCGTAGTAGACTAGCGGGGCGTAGCTCCTACGAGCAGTACTTC	CASSPRSRLAGRSSYEQYF	TRBV7-3	TRBJ2-7
TGTGCCAGCAGTGCAACGGCCCACAGTTCACCCCTCCACTTT	CASSATAHSSPLHF	TRBV6-6	TRBJ1-6
TGTGCCAGCAGTGGAGTCCGATCGAAAACCTACGAGCAGTACTTC	CASSGVRSKTYEQYF	TRBV2	TRBJ2-7
TGTGCCAGCAGTGCCCCCCCCCCCCGGGACAGGGCAAACACTGAAGCTTTCTTT	CASSAPPPRDRANTEAFF	TRBV6-1	TRBJ1-1
TGTGCCATCAGTGAGTCTGGGACAGGGAAGCAGTACTTC	CAISESGTGKQYF	TRBV10-3	TRBJ2-7
TGTGCCAGCACCCCTCGGGTCTCCTACGAGCAGTACTTC	CASTPRVSYEQYF	TRBV6-3	TRBJ2-7
TGTGCCAGCTTCGAGAGCTACGAGCAGTACTTC	CASFESYEQYF	TRBV12-3	TRBJ2-7
TGTGCCACCAGTGATTTGCGGTCAGGTCGGAACACTGAAGCTTTCTTT	CATSDLRSGRNTEAFF	TRBV24-1	TRBJ1-1
TGCGCCAGCAGCCAAGAATACCGGGAGACCCAGTACTTC	CASSQEYRETQYF	TRBV4-1	TRBJ2-5
TGCGCCAGCAAGGAGACTGACGAGCAGTACTTC	CASKETDEQYF	TRBV10-1	TRBJ2-7
TGTGCCTGGCTGGAAGGCACAGATACGCAGTATTTT	CAWLEGTDTQYF	TRBV30	TRBJ2-3
TGTGCCAGCACCTATAAGTATCACCGGGGCACCTTC	CASTYKYHRGTF	TRBV28	TRBJ1-2
TGTGCCAGCAGCTTGAAGGGGACTAGCGGGACTACCGCAGATACGCAGTATTTT	CASSLKGTSGTTADTQYF	TRBV5-6	TRBJ2-3
TGTGCCAGCAGCAAGGGGCAGAGCAATCAGCCCCAGCATTTT	CASSKGQSNQPQHF	TRBV13	TRBJ1-5
TGTGCCAGCAGCTTAGATTGCTGCGTGAGGGACGAAGAGAGGTACAATGAGCAGTTCTTC	CASSLDCCVRDEERYNEQFF	TRBV11-2	TRBJ2-1
TGCAGTGCTAGAGATTGCGAGGGGGATGAGCAGTTCTTC	CSARDCEGDEQFF	TRBV20-1	TRBJ2-1
TGTGCCAGCAGCCATCAGGGAATAGGATGGGATCAGCCCCAGCATTTT	CASSHQGIGWDQPQHF	TRBV5-6	TRBJ1-5
TGTGCCAGCAGCAATCTACGGAGCAATCAGCCCCAGCATTTT	CASSNLRSNQPQHF	TRBV13	TRBJ1-5
TGTGCCAGCAACTCTAGCGGCTCTGGGGCCAACGTCCTGACTTTC	CASNSSGSGANVLTF	TRBV7-2	TRBJ2-6
TGCGCCAGCAAAAACTGGACAGGGTATGGCTACACCTTC	CASKNWTGYGYTF	TRBV5-1	TRBJ1-2
TGTGCCAGCAGCCCGGAGGTAGTCTCCTACGAGCAGTACTTC	CASSPEVVSYEQYF	TRBV5-4	TRBJ2-7
TGTGCCAGCAGCTCCCGTAGAGGCACTAATGAAAAACTGTTTTTT	CASSSRRGTNEKLFF	TRBV9	TRBJ1-4
TGCGCCAGCAGCTTAGACACGGGACAGCGTAACTATGGCTACACCTTC	CASSLDTGQRNYGYTF	TRBV5-1	TRBJ1-2
TGTGCCAGCAGCTATTCCACGGGGCTAGGGGGCGTTCAAGAGACCCAGTACTTC	CASSYSTGLGGVQETQYF	TRBV7-4	TRBJ2-5
TGTGCCAGCAGCCTTAAAATTCTAGGGGGCTACGAGCAGTACTTC	CASSLKILGGYEQYF	TRBV7-7	TRBJ2-7
TGTGCCAGCAGAGTTGTAGCGGGATCTGGGGCCAACGTCCTGACTTTC	CASRVVAGSGANVLTF	TRBV6-8	TRBJ2-6
TGTGCCAGCATCAGGCCGGGGCGCCTAAAGAGCTCCTACGAGCAGTACTTC	CASIRPGRLKSSYEQYF	TRBV7-9	TRBJ2-7
TGTGCCAGCAGTTACTCGGGACTAGCGGGGACAATGGGCAATGAGCAGTTCTTC	CASSYSGLAGTMGNEQFF	TRBV6-5	TRBJ2-1
TGCGCCAGCAAACGGGGGAAGCCGAGCTACGAGCAGTACTTC	CASKRGKPSYEQYF	TRBV5-1	TRBJ2-7
TGTGCTGGGGCGGGGCCCCAGCATTTT	CAGAGPQHF	TRBV2	TRBJ1-5
TGTGCCAGCAGGGTAACAGGGAATCTAGGAGCCAAAAACATTCAGTACTTC	CASRVTGNLGAKNIQYF	TRBV6-1	TRBJ2-4
TGTGCCAGCAGTTACTCGCCGAGGTCATTCATAGCCGGTATTCAGCCCCAGCATTTT	CASSYSPRSFIAGIQPQHF	TRBV6-2	TRBJ1-5
TGTGCCAGCAGTCCGAACCCGCGGGGAGGGCCTGGAAACACCATATATTTT	CASSPNPRGGPGNTIYF	TRBV6-1	TRBJ1-3
TGTGCCAGCAGCCATAGATGCACGGGACAGCGGGAGTCGGATAATCAGCCCCAGCATTTT	CASSHRCTGQRESDNQPQHF	TRBV7-3	TRBJ1-5
TGTGCCAGCAGCGGGCCGGGGGGGCGTAAGGGGACAGATACGCAGTATTTT	CASSGPGGRKGTDTQYF	TRBV12-3	TRBJ2-3
TGCGCCAGCAGCCAAGGGGGGCTACTAGCGGGAGAGGTGGGAAACACCATATATTTT	CASSQGGLLAGEVGNTIYF	TRBV4-1	TRBJ1-3
TGTGCCGTTGCCCCTAACCTCTCCTATAGCAATCAGCCCCAGCATTTT	CAVAPNLSYSNQPQHF	TRBV27	TRBJ1-5
TGTGCCAGCAGCCCACAGGGTAACTATGGCTACACCTTC	CASSPQGNYGYTF	TRBV7-3	TRBJ1-2
TGCGCCAGCAGCTTGATGGGGGGGGGCAGGGCTGTTTGCTACAATGAGCAGTTCTTC	CASSLMGGGRAVCYNEQFF	TRBV5-1	TRBJ2-1
TGTGCCAGCAGCCAGGGGGACAGGGGCCTCGTAGCTTTCTTT	CASSQGDRGLVAFF	TRBV7-3	TRBJ1-1
TGCGCCAGCAGCTTGGACCGGGACGGAAACACCATATATTTT	CASSLDRDGNTIYF	TRBV5-1	TRBJ1-3
TGCGCCAGCAGCGATTACGGGGGCGATGGGTATGGCTACACCTTC	CASSDYGGDGYGYTF	TRBV5-1	TRBJ1-2
TGTGCCAGCAGCAGGAGCTATGCCAATTCTGAAGCTTTCTTT	CASSRSYANSEAFF	TRBV7-4	TRBJ1-1
TGTGCCTGGAGTGTGAGCGGGCGGCGTTCCTACGAGCAGTACTTC	CAWSVSGRRSYEQYF	TRBV30	TRBJ2-7
TGTGCCAGCGGGATCCTCTGGAATCAGCCCCAGCATTTT	CASGILWNQPQHF	TRBV2	TRBJ1-5
TGTGCCACCAGTGCCGAGCCCGGGGCTTCCTACGAGCAGTACTTC	CATSAEPGASYEQYF	TRBV24-1	TRBJ2-7
TGTGCCAGCAGTGAGCCCGCACGAGGTTTGGCCTCCTACGAGCAGTACTTC	CASSEPARGLASYEQYF	TRBV2	TRBJ2-7
TGCAGTGCTAGAGGCCAACCGGGACTAGCGGGGGGGGCGAACACCGGGGAGCTGTTTTTT	CSARGQPGLAGGANTGELFF	TRBV20-1	TRBJ2-2
TGCAGCGTTGAGGGGGGGAACACTGAAGCTTTCTTT	CSVEGGNTEAFF	TRBV29-1	TRBJ1-1
TGTGCCAGCCCCAAAACAAAAGCAGCAGCACCACTCCCTAATGAAAAACTGTTTTTT	CASPKTKAAAPLPNEKLFF	TRBV6-4	TRBJ1-4
TGTGCCAGTAGTATCACCAAAAGGAAAGTATGGGAGTACACTGAAGCTTTCTTT	CASSITKRKVWEYTEAFF	TRBV19	TRBJ1-1
TGTGCCAGCAGCCTAGCGGTTCTATTCAGCCATGAGCAGTTCTTC	CASSLAVLFSHEQFF	TRBV9	TRBJ2-1
TGTGCCAGCCCTTTGGACAATGAGCAGTTCTTC	CASPLDNEQFF	TRBV7-3	TRBJ2-1
TGTGCTAGTGGTAGGAGGGAAGAGACCCAGTACTTC	CASGRREETQYF	TRBV12-5	TRBJ2-5
TGCAGTGCTAGGACAGGGGTTTGGAACACTGAAGCTTTCTTT	CSARTGVWNTEAFF	TRBV20-1	TRBJ1-1
TGTGCCAGCAGCACGTCACCTATTGAGACAGGGCTCGGGTACTCTGGGGCCAACGTCCTGACTTTC	CASSTSPIETGLGYSGANVLTF	TRBV6-4	TRBJ2-6
TGTGCCAGCAGCCCCTTAGGGGACTCCAAGTGGTCAGATACGCAGTATTTT	CASSPLGDSKWSDTQYF	TRBV5-6	TRBJ2-3
TGTGCCAGCAGCCGGGACAGGGGGCACAACTATGGCTACACCTTC	CASSRDRGHNYGYTF	TRBV7-2	TRBJ1-2
TGTGCCAGCAGCGGGGGACACGCAACTAATGAAAAACTGTTTTTT	CASSGGHATNEKLFF	TRBV9	TRBJ1-4
TGTGCCAGCAGTTCCCACCTAGCGGGTTCCTATCTTCGCACAGATACGCAGTATTTT	CASSSHLAGSYLRTDTQYF	TRBV28	TRBJ2-3
TGTGCCAGCAGTGAAAATACGCTTTACAGGGGGAAAGCCGAGCAGTACTTC	CASSENTLYRGKAEQYF	TRBV6-4	TRBJ2-7
TGTGCCAGCAGCTTGTCCGACAGGGCGGGCTACAATGAGCAGTTCTTC	CASSLSDRAGYNEQFF	TRBV5-6	TRBJ2-1
TGTGCCAGCAGTTTAAAGGGCGGGAGTTTCACAGATACGCAGTATTTT	CASSLKGGSFTDTQYF	TRBV27	TRBJ2-3
TGTGCCAGCAGGAGAGACGGGGCCGGGGAGCTGTTTTTT	CASRRDGAGELFF	TRBV6-4	TRBJ2-2
TGTGCCAGCACCGGGACTAGCGGGATAGGCTACACCTTC	CASTGTSGIGYTF	TRBV25-1	TRBJ1-2
TGTGCCAGCTTTTTGGGCTCAGGTCTCTACGAGCAGTACTTC	CASFLGSGLYEQYF	TRBV9	TRBJ2-7
TGCAGCGTTGACGCAGGAACAGATACGCAGTATTTT	CSVDAGTDTQYF	TRBV29-1	TRBJ2-3
TGTGCCAGCAGCACCGGGGCTATGGACACTGAAGCTTTCTTT	CASSTGAMDTEAFF	TRBV7-9	TRBJ1-1
TGTGCCAGCACTGAATCCGGGACAGGGAAATCCTACGAGCAGTACTTC	CASTESGTGKSYEQYF	TRBV6-1	TRBJ2-7
TGTGCCAGCAGCTACCCGGGACTAGGGATTCCGACCTACAATGAGCAGTTCTTC	CASSYPGLGIPTYNEQFF	TRBV5-6	TRBJ2-1
TGTGCCAGCAGCTGCTTTAGTACTGAAGCTTTCTTT	CASSCFSTEAFF	TRBV7-9	TRBJ1-1
TGTGCCAGCAGCTCAAATGGACTAGCGGGGGGGCTTCGAAGGTACGAGCAGTACTTC	CASSSNGLAGGLRRYEQYF	TRBV11-3	TRBJ2-7
TGTGCCAGCAGCGGCAGGGAGAGGTACAATCAGCCCCAGCATTTT	CASSGRERYNQPQHF	TRBV7-3	TRBJ1-5
TGCACCCAAGTCCTGAGGGTGGGGAACGAGCAGTACTTC	CTQVLRVGNEQYF	TRBV29-1	TRBJ2-7
TGTGCCAGCACCCCTTTCAGGCGGAACACCGGGGAGCTGTTTTTT	CASTPFRRNTGELFF	TRBV7-9	TRBJ2-2
TGTGCCAGCAGCGTCGACAGCCGGGACAGGGTTGTTAGCTCTGGGGCCAACGTCCTGACTTTC	CASSVDSRDRVVSSGANVLTF	TRBV9	TRBJ2-6
TGTGCCACCAGCAGAGATCCCAGCGGAAGGGTTCCCCGCCACAATGAGCAGTTCTTC	CATSRDPSGRVPRHNEQFF	TRBV15	TRBJ2-1
TGTGCCAGCAGTTTATGGCTAGCGGACAGAAAAGTGAAAAGCTCCTACAATGAGCAGTTCTTC	CASSLWLADRKVKSSYNEQFF	TRBV27	TRBJ2-1
TGTGCCAGCAGCTCGGACGCACGGTACTTC	CASSSDARYF	TRBV14	TRBJ2-7
TGTGCCAGCAGCGCGGGAGGCGGCTACGAGCAGTACTTC	CASSAGGGYEQYF	TRBV7-3	TRBJ2-7
