TGTGCCAGCCCCGGGAACGGAGTGAACACTGAAGCTTTCTTT	CASPGNGVNTEAFF	TRBV12-3	TRBJ1-1
TGTGCCAGCAGGTTCCCTACAGGGGGCACGTTCAGCTCTGGGGCCAACGTCCTGACTTTC	CASRFPTGGTFSSGANVLTF	TRBV11-3	TRBJ2-6
TGTGCCAGCAGCGGAATGAACTTGGGGAGGGGGGGGTGGGGCAGGTCCTACGAGCAGTACTTC	CASSGMNLGRGGWGRSYEQYF	TRBV7-3	TRBJ2-7
TGTGCCAGCAGCCACGGACCGACAGGTGGACGGAGCAATCAGCCCCAGCATTTT	CASSHGPTGGRSNQPQHF	TRBV3-1	TRBJ1-5
TGTGCCAGCAGCTTAGGGTTGGCCAAGAAGTTCACAGATACGCAGTATTTT	CASSLGLAKKFTDTQYF	TRBV7-9	TRBJ2-3
TGTGCCAGCAGCGTAGTCATTCAGGGGGGTGAAGGTGGCTACACCTTC	CASSVVIQGGEGGYTF	TRBV9	TRBJ1-2
TGTGCCAGCAGTGACTCGAAACCCGACGGGACAGCGGAGGAGGGTGAGCAGTTCTTC	CASSDSKPDGTAEEGEQFF	TRBV6-4	TRBJ2-1
TGTGCCATCGCTAAGGGAGGCTCCTACAATGAGCAGTTCTTC	CAIAKGGSYNEQFF	TRBV10-3	TRBJ2-1
TGCGCCAGCAGCTTGGTTCCCGACAGGGGGGGCTACACCTTC	CASSLVPDRGGYTF	TRBV5-1	TRBJ1-2
TGTGCCAGCTCACCACTAGAGACCCAGTACTTC	CASSPLETQYF	TRBV18	TRBJ2-5
TGTGCCAGCAGCATGGACAGGGGTCATCAGCCCCAGCATTTT	CASSMDRGHQPQHF	TRBV7-8	TRBJ1-5
TGTGCCAGCAGCCGGATACAGGGGCTCGGCTACACCTTC	CASSRIQGLGYTF	TRBV11-2	TRBJ1-2
TGTGCCCAATTTCACGACCTCCTCTCCTACAATGAGCAGTTCTTC	CAQFHDLLSYNEQFF	TRBV19	TRBJ2-1
TGCAGTGCTAGAAATCGGGCCGGGACTGGCGACATGAACACCGGGGAGCTGTTTTTT	CSARNRAGTGDMNTGELFF	TRBV20-1	TRBJ2-2
TGTGCCTTCTTGCGCGGACTCACTACGCAGTATTTT	CAFLRGLTTQYF	TRBV14	TRBJ2-3
TGTGCCAGCAGTGACCCATGGGGGGGACCCCGTGTCACTGAAGCTTTCTTT	CASSDPWGGPRVTEAFF	TRBV6-4	TRBJ1-1
TGTGCCAGCAGTTTAACAGCCCACTCTGGAAACACCATATATTTT	CASSLTAHSGNTIYF	TRBV27	TRBJ1-3
TGTGCCAGCAGTTACGTCAGGGGGCGCCAAATTGGTAGCAATCAGCCCCAGCATTTT	CASSYVRGRQIGSNQPQHF	TRBV6-8	TRBJ1-5
TGCGCCAGCAGCCAGGGGCAGGGCCGACAGGGGGCTCACACAAAATACTATGGCTACACCTTC	CASSQGQGRQGAHTKYYGYTF	TRBV4-1	TRBJ1-2
TGTGCCAGCAGCGCATCTGACAGCACCGGGGAGCTGTTTTTT	CASSASDSTGELFF	TRBV5-8	TRBJ2-2
TGTGCCAGCAGCCCGAAACCCTATCCGGACTCTTGGGATGGCTACACCTTC	CASSPKPYPDSWDGYTF	TRBV9	TRBJ1-2
TGTGCCAGCAGCGGACCGAAAGGGGGGGGCACAGATACGCAGTATTTT	CASSGPKGGGTDTQYF	TRBV13	TRBJ2-3
TGTGCCAGCACCAGGCCAACCGGGGAGCTGTTTTTT	CASTRPTGELFF	TRBV6-2	TRBJ2-2
TGTGCCAGCAGTTCGAGATCCTCTCCAGGCTCTGAAGCTTTCTTT	CASSSRSSPGSEAFF	TRBV27	TRBJ1-1
TGTGCCAGCAGCGCGGGACTTGGGGTGAGCTACGAGCAGTACTTC	CASSAGLGVSYEQYF	TRBV7-3	TRBJ2-7
TGTGCCAGCTCACAGCGGGGGGGGCCAATTTATGGCTACACCTTC	CASSQRGGPIYGYTF	TRBV18	TRBJ1-2
TGTGCCAGCAGACATATTTATAGCAATCAGCCCCAGCATTTT	CASRHIYSNQPQHF	TRBV7-2	TRBJ1-5
TGTGCCAGCAGTTTACGGGGGCAGGGGGCGGGAATCAATCAGCCCCAGCATTTT	CASSLRGQGAGINQPQHF	TRBV27	TRBJ1-5
TGTGCCAGCAGTTTAATCCGCCAGGAAGACTACACCTTC	CASSLIRQEDYTF	TRBV27	TRBJ1-2
TGTGCCAGCAGCCCCCGAGAGGAGGGGAACAATCAGCCCCAGCATTTT	CASSPREEGNNQPQHF	TRBV11-2	TRBJ1-5
TGCAGTGCTTTGGGGGGGCCCGATACGAACACCGGGGAGCTGTTTTTT	CSALGGPDTNTGELFF	TRBV20-1	TRBJ2-2
TGTGCCAGCAGTTATGGGACTAGACTCGTGTGCTTC	CASSYGTRLVCF	TRBV27	TRBJ2-7
TGTGCCAGCAGCTTCGGCTGGTATAAGGGACAGGGAATTTCTAGCACAGATACGCAGTATTTT	CASSFGWYKGQGISSTDTQYF	TRBV5-5	TRBJ2-3
TGTGCCAGCAGCCAGAAAGGACGTGATCAGCCCCAGCATTTT	CASSQKGRDQPQHF	TRBV3-1	TRBJ1-5
TGCGCCAGCACCCTTAGGGTCGAGACCCAGTACTTC	CASTLRVETQYF	TRBV10-2	TRBJ2-5
TGTGCCAGCAGCCTTAGTCGGGCGGGAGCCATCTCCTATGGCTACACCTTC	CASSLSRAGAISYGYTF	TRBV9	TRBJ1-2
TGTGCCACCAGAGGGTCAAGGGGTGCCCGGAGGTACGAGCAGTACTTC	CATRGSRGARRYEQYF	TRBV24-1	TRBJ2-7
TGTGCCAGCAGCTCCAATGACGGCACAGATACGCAGTATTTT	CASSSNDGTDTQYF	TRBV11-2	TRBJ2-3
TGTGCCAGTAGCGTTCCGAGACGGCTAAACTCCTACGAGCAGTACTTC	CASSVPRRLNSYEQYF	TRBV19	TRBJ2-7
TGTTGGAAAGGAATCCGGGACAGAGAGACCCAGTACTTC	CWKGIRDRETQYF	TRBV10-3	TRBJ2-5
TGTGCCAGCAGCTTAAGACGCGGCTTGTTTCGCTCCTACGAGCAGTACTTC	CASSLRRGLFRSYEQYF	TRBV7-3	TRBJ2-7
TGTGCCAGCAGTGACCCCGGACAGGGTCGCAATCAGCCCCAGCATTTT	CASSDPGQGRNQPQHF	TRBV25-1	TRBJ1-5
TGTGCCAGCAGCCAAGATTCGGACGGCCCCGGCTACACCTTC	CASSQDSDGPGYTF	TRBV3-1	TRBJ1-2
TGTGCCAGCAGCTTAGACAGGGTGGAGGGGAACGAGCAGTACTTC	CASSLDRVEGNEQYF	TRBV7-9	TRBJ2-7
TGCGCCAGCAGCCACTCCGACATGAGGAACACCGGGGAGCTGTTTTTT	CASSHSDMRNTGELFF	TRBV4-3	TRBJ2-2
TGTGCCAGCAGGGGGGGGTTGACCACTCCGCCGGGACTAGCGGTCGTGAGCAAAAACATTCAGTACTTC	CASRGGLTTPPGLAVVSKNIQYF	TRBV12-4	TRBJ2-4
TGTGCCAGCAGCCAAGATGGGGACAGAGACGAGCAGTACTTC	CASSQDGDRDEQYF	TRBV3-1	TRBJ2-7
TGCAGTGCTAGAGAGGATAGGGGGCCAGTGAACACTGAAGCTTTCTTT	CSAREDRGPVNTEAFF	TRBV20-1	TRBJ1-1
TGTGCCAGCAGCGGACTAGCGGGAGATTCCCAGTACTTC	CASSGLAGDSQYF	TRBV11-3	TRBJ2-5
TGCGCCAGCAGCGTCCGGGGTAAGGGAAGCGCCCACGAGCAGTACTTC	CASSVRGKGSAHEQYF	TRBV5-1	TRBJ2-7
TGTGCCAGCAGCGTAGCTGGAGTGAGCCGCACTGAAGCTTTCTTT	CASSVAGVSRTEAFF	TRBV9	TRBJ1-1
TGTGCCAGCAGCCCCCCGATCATAGGGTATGGCTACACCTTC	CASSPPIIGYGYTF	TRBV4-2	TRBJ1-2
TGTGCCAGCAGCTCCCCCCTCATGGACAGGGAAAGCTCCTACGAGCAGTACTTC	CASSSPLMDRESSYEQYF	TRBV28	TRBJ2-7
TGTGCCACGGCAGGGGGGAGGAACACTGAAGCTTTCTTT	CATAGGRNTEAFF	TRBV6-4	TRBJ1-1
TGTGCCAGCAAGGGGGTTTTTACTGAAGCTTTCTTT	CASKGVFTEAFF	TRBV6-2	TRBJ1-1
TGTGCCAGCAGCTTGGGCTTAGGCAATCAGCCCCAGCATTTT	CASSLGLGNQPQHF	TRBV5-5	TRBJ1-5
TGTGCCATAAATCCCACCCTCCGGGACAGGGGAGGTGGCTACACCTTC	CAINPTLRDRGGGYTF	TRBV13	TRBJ1-2
TGTGCCAGCAGAACCTGGGACTATTTGTACAATGAGCAGTTCTTC	CASRTWDYLYNEQFF	TRBV6-6	TRBJ2-1
TGTGCCAGCAGCACCGGGTTCTGCAATCAGCCCCAGCATTTT	CASSTGFCNQPQHF	TRBV7-9	TRBJ1-5
TGTGCCACCAGCAGGTCCCAGACCCTTCAGCCCCAGCATTTT	CATSRSQTLQPQHF	TRBV15	TRBJ1-5
TGCGCCAGCACAGCCGGGACAGGACATGACAATCAGCCCCAGCATTTT	CASTAGTGHDNQPQHF	TRBV5-1	TRBJ1-5
TGTGCCAGCAGTTACTTTGGGGGTTGGGACTCCTACGAGCAGTACTTC	CASSYFGGWDSYEQYF	TRBV6-2	TRBJ2-7
TGTGCCAACGTGGGGGAGGCTGGAAACACCATATATTTT	CANVGEAGNTIYF	TRBV2	TRBJ1-3
TGCAGCGCCCTGGGACAGGCGAGCGAGCAGTACTTC	CSALGQASEQYF	TRBV29-1	TRBJ2-7
TGTGCCAGCAGCCTTCCCACAGATACGCAGTATTTT	CASSLPTDTQYF	TRBV7-9	TRBJ2-3
TGTGCCAGCATTTTGATACTGCCGGGACAGGGACCCTACGAGCAGTACTTC	CASILILPGQGPYEQYF	TRBV9	TRBJ2-7
TGTGCCAGCCCCTTTTACGAGCAGTACTTC	CASPFYEQYF	TRBV6-3	TRBJ2-7
TGCGCCAGCAGCTTGGAGCTAGACCAAACTGAGCAGTTCTTC	CASSLELDQTEQFF	TRBV5-1	TRBJ2-1
TGTGCCAGCAGTCGCCGGACTAGCGGGGAGTCTTGCAATGAGCAGTTCTTC	CASSRRTSGESCNEQFF	TRBV27	TRBJ2-1
TGCGCCAGACCTGGGGGCCCCTACTACAATGAGCAGTTCTTC	CARPGGPYYNEQFF	TRBV10-1	TRBJ2-1
TGTGCCAGCAGCTTAGTTAGGAACACCTTC	CASSLVRNTF	TRBV7-2	TRBJ1-2
TGTGCCATCAGTGAAGGGTGTCCGGGGGGGGACCAAGAGACCCAGTACTTC	CAISEGCPGGDQETQYF	TRBV10-3	TRBJ2-5
TGTGCCAGCAGCACCCGGGGGGGAGGGGCCTACGAGCAGTACTTC	CASSTRGGGAYEQYF	TRBV13	TRBJ2-7
TGCGCCAGCAGCCGAAAGGGGACAACCTACGAGCAGTACTTC	CASSRKGTTYEQYF	TRBV10-2	TRBJ2-7
TGTGCCAGTAGTAGATATGAAAGGGACGGGAAGTACTTC	CASSRYERDGKYF	TRBV19	TRBJ2-7
TGCAGTGCTAGAGTTCCCCCCTACAGGGACAGGGGGCTGGGCACCGGGGAGCTGTTTTTT	CSARVPPYRDRGLGTGELFF	TRBV20-1	TRBJ2-2
TGTGCCACCAGCAGAGATCCTAGTGCGGGGTTAGGGAGTGGGTTGTCTCACACCGGGGAGCTGTTTTTT	CATSRDPSAGLGSGLSHTGELFF	TRBV15	TRBJ2-2
TGTGCCAGCAGCTTGGATACAGGTCATGAAAAACTGTTTTTT	CASSLDTGHEKLFF	TRBV5-6	TRBJ1-4
TGTGCCAGCAGCTTAGAGCCGGGACCCCAGTACTTC	CASSLEPGPQYF	TRBV11-2	TRBJ2-5
TGTGCCAGTAGTATAAGCCCAGGGGCAAGGCTCAAGTATGGCTACACCTTC	CASSISPGARLKYGYTF	TRBV19	TRBJ1-2
TGTGCCAGCTTGAGTTTCACCGAAAATCAGCCCCAGCATTTT	CASLSFTENQPQHF	TRBV7-3	TRBJ1-5
TGTGCCACCACTTTCGGACAGGGCAGGGATGGCTACACCTTC	CATTFGQGRDGYTF	TRBV24-1	TRBJ1-2
TGTGCCAGCAGTGCTTCTTGGACCCACTGGGGACAGGGTGTTCAGCCCCAGCATTTT	CASSASWTHWGQGVQPQHF	TRBV2	TRBJ1-5
TGTGCCAGCAGCGTAGGGGAAGGAGGGGCGGACTCTGGAAACACCATATATTTT	CASSVGEGGADSGNTIYF	TRBV9	TRBJ1-3
TGTGCTAGTGCAGAATACGAGCAGTACTTC	CASAEYEQYF	TRBV12-5	TRBJ2-7
TGTGCCAGCAGAAACCTAAGACAGGGTGGACTAGTGCCCCAGCATTTT	CASRNLRQGGLVPQHF	TRBV6-3	TRBJ1-5
TGTGCCAGCAGTCCCGGGCCCCGACAGTCCGCTCGCTACGAGCAGTACTTC	CASSPGPRQSARYEQYF	TRBV28	TRBJ2-7
TGTGCCAGCAGCGAGGGCAAGGGTCTCAGCTACGAGCAGTACTTC	CASSEGKGLSYEQYF	TRBV7-9	TRBJ2-7
TGTGCCACCAGTGATATGCGGGACAGGGATCCTGGCTACACCTTC	CATSDMRDRDPGYTF	TRBV24-1	TRBJ1-2
TGCAGTGCTAGGACGTCCTACGAGCAGTACTTC	CSARTSYEQYF	TRBV20-1	TRBJ2-7
TGTGCCAGCACCGGACTAGCGGGAGGAACAGATACGCAGTATTTT	CASTGLAGGTDTQYF	TRBV27	TRBJ2-3
TGTGCCAGCAGTTTGAATAGGGAGGGACAAGAGACCCAGTACTTC	CASSLNREGQETQYF	TRBV12-3	TRBJ2-5
TGTGCCAGCAGCTTGGGGGCAGGGAGCAATCAGCCCCAGCATTTT	CASSLGAGSNQPQHF	TRBV11-2	TRBJ1-5
TGTGCCACCAGTGACAGGGGCATGAACACTGAAGCTTTCTTT	CATSDRGMNTEAFF	TRBV24-1	TRBJ1-1
TGTGCCAGCAGCGGACAGGGGGTCTACGAGCAGTACTTC	CASSGQGVYEQYF	TRBV11-3	TRBJ2-7
TGTGCCAGCAGAGAGCTTGAAGGGGGGTTCTACGAGCAGTACTTC	CASRELEGGFYEQYF	TRBV6-4	TRBJ2-7
TGCGCCAGACCCGAGGGGACAGGCAATCAGCCCCAGCATTTT	CARPEGTGNQPQHF	TRBV5-1	TRBJ1-5
TGTGCCTGGAGTGTACGCCACCCTAGACAAGAGACCCAGTACTTC	CAWSVRHPRQETQYF	TRBV30	TRBJ2-5
TGTGCCAGCAGCCTACTGCCTAAGCCCGGGAACACTGAAGCTTTCTTT	CASSLLPKPGNTEAFF	TRBV13	TRBJ1-1
TGTGCTTCTGGACGGTATGAATATGGCTACACCTTC	CASGRYEYGYTF	TRBV5-4	TRBJ1-2
