TGTGCCAGCAGCGGAAAGGGGAGACCGAACTATGGCTACACCTTC	CASSGKGRPNYGYTF	TRBV9	TRBJ1-2
TGTGCCAGCAGAACTTGGGGACTAGCGGGCCACTACAATGAGCAGTTCTTC	CASRTWGLAGHYNEQFF	TRBV28	TRBJ2-1
TGTGCCACCAGCAGACAAACCCACAGGGGGCATGAAGCTTTCTTT	CATSRQTHRGHEAFF	TRBV15	TRBJ1-1
TGTGCCAGCAGTGTTACAGGGGGCGAAGCTTTCTTT	CASSVTGGEAFF	TRBV25-1	TRBJ1-1
TGTGCCAGCAGCTTAACAGGGACAGATGAGACCCAGTACTTC	CASSLTGTDETQYF	TRBV7-9	TRBJ2-5
TGTGCCACCCAGATTCGAGGACTCTACAATGAGCAGTTCTTC	CATQIRGLYNEQFF	TRBV24-1	TRBJ2-1
TGCAGCCTGCGGGGGGTCCCGGACGAGCAGTACTTC	CSLRGVPDEQYF	TRBV29-1	TRBJ2-7
TGTGCCAGCAGTGTATACAAGGGGGGGCAAAATATGGACGAGCAGTACTTC	CASSVYKGGQNMDEQYF	TRBV6-2	TRBJ2-7
TGCAGTGCTTTAATGTATGCGACAGGGTGTCGGAAAGAGGTTTACACTGAAGCTTTCTTT	CSALMYATGCRKEVYTEAFF	TRBV20-1	TRBJ1-1
TGTGCCACCAGTGATATTAGGCGGGAGGGAGAAGGCTACACCTTC	CATSDIRREGEGYTF	TRBV24-1	TRBJ1-2
TGTGCCAGCAGCTTAGGATCCGTAGCGGGACTTACCCAGCATTTT	CASSLGSVAGLTQHF	TRBV11-3	TRBJ1-5
TGCGCCAGCAGCTCAGCGGGGAGCTATGGCTACACCTTC	CASSSAGSYGYTF	TRBV5-1	TRBJ1-2
TGTGCCAGCAGTCCCGCTCGCGGGACAGGGGTCAGTGAGCAGTACTTC	CASSPARGTGVSEQYF	TRBV6-4	TRBJ2-7
TGTGCCAGCAGTTCCAGGGCCAGCACAGATACGCAGTATTTT	CASSSRASTDTQYF	TRBV6-3	TRBJ2-3
TGTGCCAGCAGTTACCCCAGCGGTTTGAGCGGGGACAATGAGCAGTTCTTC	CASSYPSGLSGDNEQFF	TRBV6-5	TRBJ2-1
TGTGCCAGCAGTTTATTAGCAGGGGTCTTTGGCTACACCTTC	CASSLLAGVFGYTF	TRBV27	TRBJ1-2
TGTGCCAGCAGCCAAGTGCAAGGGGGGCAGCCCCAGCATTTT	CASSQVQGGQPQHF	TRBV11-2	TRBJ1-5
TGTGCCAGCAAGCGGACAAATGAGCAGTTCTTC	CASKRTNEQFF	TRBV28	TRBJ2-1
TGTGCCAGGGGGACAGCCGACACTGAAGCTTTCTTT	CARGTADTEAFF	TRBV27	TRBJ1-1
TGCAGCGTTGAGGGGGCCTTACCTAACTATGGCTACACCTTC	CSVEGALPNYGYTF	TRBV29-1	TRBJ1-2
TGCAGTGCTAGAGGCCCCGAGAACCCTTCACCCCTCCACTTT	CSARGPENPSPLHF	TRBV20-1	TRBJ1-6
TGTGCCAGCAGCGTAGGAATCCTCAGGGGACAGCCGGAATCTAACTATGGCTACACCTTC	CASSVGILRGQPESNYGYTF	TRBV9	TRBJ1-2
TGTGCCATCGCCACGGGCCCAGAAGAGACCCAGTACTTC	CAIATGPEETQYF	TRBV10-3	TRBJ2-5
TGTGCCAGCAGCGCCACCCCCGGGACAGGGTGCGGGGAGCTGTTTTTT	CASSATPGTGCGELFF	TRBV9	TRBJ2-2
TGTGCCAGTAGGACTTCAGGGGTGAACACTGAAGCTTTCTTT	CASRTSGVNTEAFF	TRBV19	TRBJ1-1
TGTGCCAGCAGCTTAGGAGGGGACCGCAATCAGCCCCAGCATTTT	CASSLGGDRNQPQHF	TRBV7-6	TRBJ1-5
TGCGCCAGCAGCCCCGGTCAGCCCCAGCATTTT	CASSPGQPQHF	TRBV5-1	TRBJ1-5
TGCAGTGCTAGACATGGGGCGAGGTACGCCTACGAGCAGTACTTC	CSARHGARYAYEQYF	TRBV20-1	TRBJ2-7
TGCGCCAGCAGACCCGGATTCGGGAGGGCGGCGGGCTACGAGCAGTACTTC	CASRPGFGRAAGYEQYF	TRBV10-1	TRBJ2-7
TGTGCCAGCAGCTGCAGGGAGTATTCCAAGTACTTC	CASSCREYSKYF	TRBV7-7	TRBJ2-5
TGCAGTGCTGCGGGGGTAGGGGATCAGCCCCAGCATTTT	CSAAGVGDQPQHF	TRBV20-1	TRBJ1-5
TGTGCCACCAGCAGAACGAAACGACTGGTTAGCACAGATACGCAGTATTTT	CATSRTKRLVSTDTQYF	TRBV15	TRBJ2-3
TGTGCCAGCACGGGTAGTGGGGCAGGGGGTTTACCCTATAATTCACCCCTCCACTTT	CASTGSGAGGLPYNSPLHF	TRBV6-8	TRBJ1-6
TGTGCCAGCAGCTCCCCATCCCACAGGGCCACCCTCACAGATACGCAGTATTTT	CASSSPSHRATLTDTQYF	TRBV11-1	TRBJ2-3
TGTGCCAGCAGCTCCAGCAGCTCAACATACAATGAGCAGTTCTTC	CASSSSSSTYNEQFF	TRBV11-3	TRBJ2-1
TGTGCCAGTAGTACAACGGACGGGGCCGGACCGAACACTGAAGCTTTCTTT	CASSTTDGAGPNTEAFF	TRBV19	TRBJ1-1
TGTGCCAGCAGTTTACTTCCAGGGTGGACGGATGAAAAACTGTTTTTT	CASSLLPGWTDEKLFF	TRBV27	TRBJ1-4
TGTGCCAGCAGCGGGAGGTCCTACGAGCAGTACTTC	CASSGRSYEQYF	TRBV13	TRBJ2-7
TGTGCCAGCAGCGCCGCTTCTTCCCGGTTCGGACTAGCGGGAGAAAACATTCAGTACTTC	CASSAASSRFGLAGENIQYF	TRBV7-3	TRBJ2-4
TGTGCCAGCAGCTTAACAGGGACAGTCGGCGAGTACGAGCAGTACTTC	CASSLTGTVGEYEQYF	TRBV11-2	TRBJ2-7
TGTGCCAGCAGCAGAGGGACCGAAACTAGCACAGATACGCAGTATTTT	CASSRGTETSTDTQYF	TRBV13	TRBJ2-3
TGTGCCAGCAGCGTTTCCGGAAGCTCCTACAATGAGCAGTTCTTC	CASSVSGSSYNEQFF	TRBV11-2	TRBJ2-1
TGTGCCAGCAGCGGTGGACAGGGAGTGGCTGAAGCTTTCTTT	CASSGGQGVAEAFF	TRBV13	TRBJ1-1
TGTGCCACCGGGGACGGCCAGGCCAAAAACATTCAGTACTTC	CATGDGQAKNIQYF	TRBV24-1	TRBJ2-4
TGCAGTGCTAGCCCAAAGGCGGGAGCGAACTATGGCTACACCTTC	CSASPKAGANYGYTF	TRBV20-1	TRBJ1-2
TGCAGTGCGGATAGGGACAGGGTACTGAACACTGAAGCTTTCTTT	CSADRDRVLNTEAFF	TRBV20-1	TRBJ1-1
TGTGCCAGCAGTTATAAACCCCCGGGACAGTCTGCTTCGGTGCACACTGAAGCTTTCTTT	CASSYKPPGQSASVHTEAFF	TRBV6-2	TRBJ1-1
TGCAGTGAACTCTCACTAGCGGGAGGTGAAAAACTGTTTTTT	CSELSLAGGEKLFF	TRBV20-1	TRBJ1-4
TGTGCTAGTGCCCTCCATAATATCCAAGAGACCCAGTACTTC	CASALHNIQETQYF	TRBV12-5	TRBJ2-5
TGCGCCAGCAGGGTTGCAACTAATGAAAAACTGTTTTTT	CASRVATNEKLFF	TRBV10-1	TRBJ1-4
TGCAGTGCCATGCCGAGCACTGAAGCTTTCTTT	CSAMPSTEAFF	TRBV20-1	TRBJ1-1
TGTGCCAGCAGTTACTCGCCGACTAGCGGGTACGAGCAGTACTTC	CASSYSPTSGYEQYF	TRBV6-3	TRBJ2-7
TGTGCCAGCTCACGGAGGACTAGCGGGGATTCTAGCTCCTACAATGAGCAGTTCTTC	CASSRRTSGDSSSYNEQFF	TRBV18	TRBJ2-1
TGTGCCAGCACGCTCCAGAGAGGGAACACCGGGGAGCTGTTTTTT	CASTLQRGNTGELFF	TRBV27	TRBJ2-2
TGTGCCAGCAGCTTCTTGACCACCGGGACAGGGCTCAATGAAAAACTGTTTTTT	CASSFLTTGTGLNEKLFF	TRBV7-4	TRBJ1-4
TGTATAAAAGGGACAGGGGATTCCTATGGCTACACCTTC	CIKGTGDSYGYTF	TRBV27	TRBJ1-2
TGTGCCAGCAGCGGATTACCACGGCGACTGTTTTTT	CASSGLPRRLFF	TRBV13	TRBJ1-4
TGTGCCAGCAGCTTAGCGACAGGTGCAACTAATGAAAAACTGTTTTTT	CASSLATGATNEKLFF	TRBV7-3	TRBJ1-4
TGTGCCAGCAGTTACTCGACTGTAACGGACAGGACGGAGCAGTACTTC	CASSYSTVTDRTEQYF	TRBV6-5	TRBJ2-7
TGTGCCAGCAGTTACTCGGGGACAGGGTTTCCCACTGAAGCTTTCTTT	CASSYSGTGFPTEAFF	TRBV6-5	TRBJ1-1
TGTGCCAGCAGCCTCTCATGGGGAGGGTGGAGTAGCAATCAGCCCCAGCATTTT	CASSLSWGGWSSNQPQHF	TRBV7-3	TRBJ1-5
TGTGCCACCACAGGGGGAAACACCATATATTTT	CATTGGNTIYF	TRBV6-4	TRBJ1-3
TGTGCCCGACAGGGGGAGCAGTACTTC	CARQGEQYF	TRBV27	TRBJ2-7
TGTGCCAGCAGCGCGGGGGGCAGCACAGATACGCAGTATTTT	CASSAGGSTDTQYF	TRBV9	TRBJ2-3
TGCGCCAGCAGCTTGGGGCTAGCGGGCTTCGAGGTCACAGATACGCAGTATTTT	CASSLGLAGFEVTDTQYF	TRBV5-1	TRBJ2-3
TGTGCCTGGAGTGGGGGTGACACTGAAGCTTTCTTT	CAWSGGDTEAFF	TRBV30	TRBJ1-1
TGTGCCAGCAGTATAATGAAACTGAGGGCTGAAGAGACCCAGTACTTC	CASSIMKLRAEETQYF	TRBV27	TRBJ2-5
TGTGCCAGCAGCTTAGTCCGACGGGGTTCGACCCAGTACTTC	CASSLVRRGSTQYF	TRBV11-3	TRBJ2-5
TGCAGTGCTAGGGACAGGGGGGACGGAAACACCATATATTTT	CSARDRGDGNTIYF	TRBV20-1	TRBJ1-3
TGTGCCAGCAGCCACCCCGGGGGACAGTTAGAGCAGTTCTTC	CASSHPGGQLEQFF	TRBV5-6	TRBJ2-1
TGTGCCAGCAGTTTCCTTCAGGCTAGTAATTCACCCCTCCACTTT	CASSFLQASNSPLHF	TRBV6-5	TRBJ1-6
TGTGCCAGCAGCCCCAGGGGCTCCTACGAGCAGTACTTC	CASSPRGSYEQYF	TRBV13	TRBJ2-7
TGCGCCAGCAGACCAGGCACCGCACGCTACGAGCAGTACTTC	CASRPGTARYEQYF	TRBV10-1	TRBJ2-7
TGTCGACAGGGGGAGGATCAGCCCCAGCATTTT	CRQGEDQPQHF	TRBV10-3	TRBJ1-5
TGCGCCAGCAGCGGCTCGTACGAGCAGTACTTC	CASSGSYEQYF	TRBV5-1	TRBJ2-7
TGTGCCAGCAGTCCCAAAAGGGGTGGCACTGAAGCTTTCTTT	CASSPKRGGTEAFF	TRBV6-5	TRBJ1-1
TGTGCCACCAAGGCGGTAAGAGGTCCCGACGGCTACACCTTC	CATKAVRGPDGYTF	TRBV24-1	TRBJ1-2
TGTGCCAGCAGTAACCACCGGGACAGGATGAACACTGAAGCTTTCTTT	CASSNHRDRMNTEAFF	TRBV27	TRBJ1-1
TGTGCCAGCAGCTTGGTGACGGAAAAACTGTTTTTT	CASSLVTEKLFF	TRBV5-8	TRBJ1-4
TGCAGTGCAGGGAGGGACAGGGCATGGAGAGGGGAGACCCAGTACTTC	CSAGRDRAWRGETQYF	TRBV20-1	TRBJ2-5
TGCGCCAGCAGATGCAGGGGGGTGAACACTGAAGCTTTCTTT	CASRCRGVNTEAFF	TRBV10-1	TRBJ1-1
TGTGCCACTGAGACCGGGACAGGGGTCATGAACACTGAAGCTTTCTTT	CATETGTGVMNTEAFF	TRBV24-1	TRBJ1-1
TGTGCCAGCAGCTTACTTGTAAGAGACAGGGGCTACGAGCAGTACTTC	CASSLLVRDRGYEQYF	TRBV5-6	TRBJ2-7
TGTGCCAGCAGTGTTTATAGTCCGGGGCGAGCTGAAGCTTTCTTT	CASSVYSPGRAEAFF	TRBV6-5	TRBJ1-1
TGTGCCAGCAGCGTAACCGGTTACGATCCCCTTTTAACTGAAGCTTTCTTT	CASSVTGYDPLLTEAFF	TRBV11-2	TRBJ1-1
TGTGCCAGCAGCAACTCCCCACTAGCGGGAGAGAATTTTTTGCCCTATAATTCACCCCTCCACTTT	CASSNSPLAGENFLPYNSPLHF	TRBV11-2	TRBJ1-6
TGTGCCAGCAGCAATAACCAGCGGGAGGATCAGCCCCAGCATTTT	CASSNNQREDQPQHF	TRBV9	TRBJ1-5
TGTGCCACGGAGACAGGGAACTATGGCTACACCTTC	CATETGNYGYTF	TRBV24-1	TRBJ1-2
TGCAGCGGGGAGACAGTTAGGTGGGGCTACACCTTC	CSGETVRWGYTF	TRBV29-1	TRBJ1-2
TGTGCCACCAGTGAAATCAGGGGGCGCACAGATACGCAGTATTTT	CATSEIRGRTDTQYF	TRBV24-1	TRBJ2-3
TGTGCCAGCAGCCAAGATAGATATAACAGGGCCTACGAGCAGTACTTC	CASSQDRYNRAYEQYF	TRBV14	TRBJ2-7
TGTGCCAGTTTAACTGAGTTCAACACCGGGGAGCTGTTTTTT	CASLTEFNTGELFF	TRBV19	TRBJ2-2
TGTGCCAGCAGTTTAGAGGGGACCGGGACAGTGCAGTACTTC	CASSLEGTGTVQYF	TRBV12-3	TRBJ2-7
TGTGCCAGCAGGTTGGGGGGAGGTGGAAACACCATATATTTT	CASRLGGGGNTIYF	TRBV7-8	TRBJ1-3
TGTGCCAGCAGCTTAGGAAGGAGGGCGAACAATGAGCAGTTCTTC	CASSLGRRANNEQFF	TRBV7-9	TRBJ2-1
TGTGCCAGCAAGGCCCCCGGGACAGGGTTAGCCGGGGAGCTGTTTTTT	CASKAPGTGLAGELFF	TRBV13	TRBJ2-2
TGTGCCAGCAGTTACTCGAGACCGGTTGAGAGCTACGAGCAGTACTTC	CASSYSRPVESYEQYF	TRBV6-2	TRBJ2-7
TGTGCCATCAGCAGGCAACAGGGTTGGTGGGCATTTCAAGAGACCCAGTACTTC	CAISRQQGWWAFQETQYF	TRBV10-3	TRBJ2-5
TGTGCCAGCAGTGGACCGGGACAGCTCACTAACTATGGCTACACCTTC	CASSGPGQLTNYGYTF	TRBV2	TRBJ1-2
TGTGCCAGCAGTTCCCGTCATCCGAATAATTCACCCCTCCACTTT	CASSSRHPNNSPLHF	TRBV27	TRBJ1-6
