TGTGCCAGCAGTGTGACAGGGTTAGGAAACACCATATATTTT	CASSVTGLGNTIYF	TRBV6-5	TRBJ1-3
TGTGCCAGCAGTGTGGACAGGAATGAAAAACTGTTTTTT	CASSVDRNEKLFF	TRBV2	TRBJ1-4
TGTGCCAGCAGCGCGACAGGGCGGAATTCACCCCTCCACTTT	CASSATGRNSPLHF	TRBV9	TRBJ1-6
TGCGCCAGCAGCCCCCTCAGGGGAGGCTCTGGAAACACCATATATTTT	CASSPLRGGSGNTIYF	TRBV5-1	TRBJ1-3
TGTGCCAGCAGTTGGGCAGACTACGAGCAGTACTTC	CASSWADYEQYF	TRBV6-4	TRBJ2-7
TGTGCCAGCAGTTGGGAGCTTGGGGCTGGGGCCAACGTCCTGACTTTC	CASSWELGAGANVLTF	TRBV6-5	TRBJ2-6
TGTGCCAGCAGCGTATACGTTACAGGGGGGGGGTTCTCCTACGAGCAGTACTTC	CASSVYVTGGGFSYEQYF	TRBV9	TRBJ2-7
TGCAGTGCTAGCCCCCGGGACAGGGGAAATGAGCAGTTCTTC	CSASPRDRGNEQFF	TRBV20-1	TRBJ2-1
TGTGCCATCAGTGATGGTCTGGGTCCCACTGAAGCTTTCTTT	CAISDGLGPTEAFF	TRBV10-3	TRBJ1-1
TGTGCCTGGAGTGAGCCGCTCCGACTAGCCGCCTACGAGCAGTACTTC	CAWSEPLRLAAYEQYF	TRBV30	TRBJ2-7
TGTGCCAGCAGCGAGAGACTACATCAAGAGACCCAGTACTTC	CASSERLHQETQYF	TRBV9	TRBJ2-5
TGTGCCAGCAGCTTGGCCCCGTGCTACAATGAGCAGTTCTTC	CASSLAPCYNEQFF	TRBV5-4	TRBJ2-1
TGTGCCTGGATCGAGGACAGTCAGCCCCAGCATTTT	CAWIEDSQPQHF	TRBV30	TRBJ1-5
TGCGCCAGCAGTGCGATGGGGACAGGGGTCCCGGAAGGCTACACCTTC	CASSAMGTGVPEGYTF	TRBV10-1	TRBJ1-2
TGTGCCAGCAGTTACACCCAGGTAAAACTGTTTTTT	CASSYTQVKLFF	TRBV6-2	TRBJ1-4
TGTGCCTGGAGTGCAAACAACGGACTGCTCTCCTACAATGAGCAGTTCTTC	CAWSANNGLLSYNEQFF	TRBV30	TRBJ2-1
TGCGCCAGCAGCGAAGGGACAGGAGTGTGTTATACCTCCTACGAGCAGTACTTC	CASSEGTGVCYTSYEQYF	TRBV5-1	TRBJ2-7
TGCGCCAGCAGCTTGGGGACATTCTACGAGCAGTACTTC	CASSLGTFYEQYF	TRBV5-1	TRBJ2-7
TGTGCCACCCCGACGGGGCTTGAGCAGTACTTC	CATPTGLEQYF	TRBV24-1	TRBJ2-7
TGTGCCAGCAGTTCCCAACAGGGGGCTGAGCAGTACTTC	CASSSQQGAEQYF	TRBV12-4	TRBJ2-7
TGCGAGGCGTTTTTTGGTAATGAGCAGTTCTTC	CEAFFGNEQFF	TRBV5-1	TRBJ2-1
TGTGCCAGCACTCCATGCACTAGCGGGAGGTTGATCTACGAGCAGTACTTC	CASTPCTSGRLIYEQYF	TRBV27	TRBJ2-7
TGTGCCAGCAGCGTAGGACACCAGGTCAAGCTCACAGATACGCAGTATTTT	CASSVGHQVKLTDTQYF	TRBV9	TRBJ2-3
TGTGCCAGTAGTGAATTGAGGGATAGCAATCAGCCCCAGCATTTT	CASSELRDSNQPQHF	TRBV19	TRBJ1-5
TGCGCCAGCAGGGACCGTAAAGAGACCCAGTACTTC	CASRDRKETQYF	TRBV5-1	TRBJ2-5
TGTGCCGCCCAGGGGAACCAAGAGACCCAGTACTTC	CAAQGNQETQYF	TRBV15	TRBJ2-5
TGTGCCAGCAGTTACCCCGTAGGGGCCGGGGAGCTGTTTTTT	CASSYPVGAGELFF	TRBV6-5	TRBJ2-2
TGTGCCAGCAGCTGCGCGGGAGGTGTGCAGTACTTC	CASSCAGGVQYF	TRBV11-3	TRBJ2-7
TGTGCCAGTAGTATAACCGGGACAGAGGTCGGCCTTGATGGCTACACCTTC	CASSITGTEVGLDGYTF	TRBV19	TRBJ1-2
TGTGCCAGCAGCGGGACAGTTGGCACCAATCAGCCCCAGCATTTT	CASSGTVGTNQPQHF	TRBV7-2	TRBJ1-5
TGCGCCAGGGGGACGAACTATGGCTACACCTTC	CARGTNYGYTF	TRBV5-1	TRBJ1-2
TGTGCCAGCAGCTTAAGAGTAGGTTACAGGGGGGATCTACCCCTTTCACCCCTCCACTTT	CASSLRVGYRGDLPLSPLHF	TRBV7-3	TRBJ1-6
TGTGGCCTACCGGGACAGGGGACGCTGAACACTGAAGCTTTCTTT	CGLPGQGTLNTEAFF	TRBV28	TRBJ1-1
TGTGCCAGCTCACCAGGAGAGTGGGGGGGGGGCGGGCGGTTAGGTGACAATGAGCAGTTCTTC	CASSPGEWGGGGRLGDNEQFF	TRBV18	TRBJ2-1
TGTGCCAGCAGCTTAGCGAGTCCAACCGGGACGTTTCATTCCTACGAGCAGTACTTC	CASSLASPTGTFHSYEQYF	TRBV7-9	TRBJ2-7
TGTGCCACCGAATTGACTAGCGGGGTACCCTACGAGCAGTACTTC	CATELTSGVPYEQYF	TRBV24-1	TRBJ2-7
TGCGCCAACTCTGTCCTCTGGGGGAAGGGAGGCTACGAGCAGTACTTC	CANSVLWGKGGYEQYF	TRBV10-1	TRBJ2-7
TGTGCCAGCAGCTATAAGGCAGGGCCCTACGAGCAGTACTTC	CASSYKAGPYEQYF	TRBV5-6	TRBJ2-7
TGCGCCAGCAGTGAGAATATCTTAGGGGGCCCCCAATTAAAGAACACTGAAGCTTTCTTT	CASSENILGGPQLKNTEAFF	TRBV10-1	TRBJ1-1
TGTGCCAGCAGCTTAGAAGCCCGTACCGGGGAGCTGTTTTTT	CASSLEARTGELFF	TRBV11-3	TRBJ2-2
TGTGCCAGCAGGATCGGAGGGTTCCGCTACAATGAGCAGTTCTTC	CASRIGGFRYNEQFF	TRBV28	TRBJ2-1
TGCGCCAGCACGCTAGCGGGGAACACCGGGGAGCTGTTTTTT	CASTLAGNTGELFF	TRBV4-3	TRBJ2-2
TGTGCCAGCAGTGGACAGCAACGAGGCGACGAGCAGTACTTC	CASSGQQRGDEQYF	TRBV2	TRBJ2-7
TGTGCCAGCAGTCAGGTAAACAAGGTGGGACGGGATGGCTACACCTTC	CASSQVNKVGRDGYTF	TRBV28	TRBJ1-2
TGTGCCAGCAGGTCCGGGACTAGCGGGAGGGAAACGGACTACGAGCAGTACTTC	CASRSGTSGRETDYEQYF	TRBV2	TRBJ2-7
TGTGCCAGCAGCCTTCACCCCGGGGGGCCCTCCTACGAGCAGTACTTC	CASSLHPGGPSYEQYF	TRBV5-4	TRBJ2-7
TGCGCCAGCAGCGTCGGGACAGGTGAGACCCAGTACTTC	CASSVGTGETQYF	TRBV4-1	TRBJ2-5
TGTGCCAGCAGCGTAGGGCCAGCGGCTAGCAATGAGCAGTTCTTC	CASSVGPAASNEQFF	TRBV9	TRBJ2-1
TGCAGTGCTCTCAGGGTAGACTACGAGCAGTACTTC	CSALRVDYEQYF	TRBV20-1	TRBJ2-7
TGTGCCAGCACTAAGGGGAGCGCAGCTTTCTTT	CASTKGSAAFF	TRBV6-5	TRBJ1-1
TGCAGTGCTACCAGTGCCGGGAGTAGCGATGAGCAGTTCTTC	CSATSAGSSDEQFF	TRBV20-1	TRBJ2-1
TGTGCCAGCAGTTACTCGTCCCCCCCGGGACAGAATAATGGCTACACCTTC	CASSYSSPPGQNNGYTF	TRBV6-5	TRBJ1-2
TGTGCCACCAGTGATAACCTAGGTCGGTACTACGAGCAGTACTTC	CATSDNLGRYYEQYF	TRBV24-1	TRBJ2-7
TGTGCCAGCAGCACACCGAACACTGAAGCTTTCTTT	CASSTPNTEAFF	TRBV11-2	TRBJ1-1
TGTGCCAGCAGCCGAGCAGCCATTACTGGAAACACCATATATTTT	CASSRAAITGNTIYF	TRBV7-3	TRBJ1-3
TGCAGTGCTAGAGTGGATTTTTTATCGGGGGGCTATGGCTACACCTTC	CSARVDFLSGGYGYTF	TRBV20-1	TRBJ1-2
TGTGCCAGCAGCGGACGCGGGAGCCCCAGGACTGAAGCTTTCTTT	CASSGRGSPRTEAFF	TRBV9	TRBJ1-1
TGCGCCAGCATTTGGGACAGGGTTTCGAAACTGTTTTTT	CASIWDRVSKLFF	TRBV10-1	TRBJ1-4
TGTGCCAGCAGCTTCGGCGGAAATAAGGGAGAGACCCAGTACTTC	CASSFGGNKGETQYF	TRBV7-8	TRBJ2-5
TGTGCCAGCAGCCAAGCAGAGGGTTCCAATAATCAGCCCCAGCATTTT	CASSQAEGSNNQPQHF	TRBV14	TRBJ1-5
TGCGCCAGCAGCCTAACTAGCGGGAGTTGGAGGGACTATGGCTACACCTTC	CASSLTSGSWRDYGYTF	TRBV5-1	TRBJ1-2
TGTGCCAGCAGCGCTGGACAGCGGGCCTGCTGCAATCAGCCCCAGCATTTT	CASSAGQRACCNQPQHF	TRBV5-6	TRBJ1-5
TGTGCCAGCAGCGCGGACTTACCTACCGAGCAGTACTTC	CASSADLPTEQYF	TRBV13	TRBJ2-7
TGTGCCAGCAGTGACTCGAGGGGGGGACAGGGGGGAAGTAGCAATCAGCCCCAGCATTTT	CASSDSRGGQGGSSNQPQHF	TRBV6-4	TRBJ1-5
TGTGCCAGCAGCTCTAATTCATTCAGGGAAAATCAGCCCCAGCATTTT	CASSSNSFRENQPQHF	TRBV7-9	TRBJ1-5
TGTGCCAGCAGTGAAGCGGATAGCGGGAAACCAGAGACCCAGTACTTC	CASSEADSGKPETQYF	TRBV6-1	TRBJ2-5
TGTGCCAGCAGCCAAGAGCTGGTTACTAGCGGGTGTGGGTACCAAGAGACCCAGTACTTC	CASSQELVTSGCGYQETQYF	TRBV3-1	TRBJ2-5
TGCGCCAGCAGTGAATCCGGACATGGCTACGAGCAGTACTTC	CASSESGHGYEQYF	TRBV10-2	TRBJ2-7
TGTGCCAGCAGCACCGGACAGCTAGGGTACGAGCAGTACTTC	CASSTGQLGYEQYF	TRBV5-4	TRBJ2-7
TGTGCCAGCAGCGAAGACCTGGACAGGGGCCTAGCTGGTAATGAAAAACTGTTTTTT	CASSEDLDRGLAGNEKLFF	TRBV5-6	TRBJ1-4
TGTGCCAGCTCACCACAAAGCGGGAGCTACGAGCAGTACTTC	CASSPQSGSYEQYF	TRBV18	TRBJ2-7
TGTGCCAGCGGGTCGGGACTAGCGGGGGGGCCGGGCGCCGAGACCCAGTACTTC	CASGSGLAGGPGAETQYF	TRBV9	TRBJ2-5
TGTGCCAGCAGTCTAGACCCAGAGACCCAGTACTTC	CASSLDPETQYF	TRBV12-4	TRBJ2-5
TGTGCCAGCAGTTTACCCCGGGCGCCCTGGAGCCAGGAGCAGTACTTC	CASSLPRAPWSQEQYF	TRBV12-3	TRBJ2-7
TGTGCCAGCAGGATCCGGGACCCCTACGAGCAGTACTTC	CASRIRDPYEQYF	TRBV25-1	TRBJ2-7
TGCAGTGCTAGAACCGGAGGGTCCGAAAAACTGTTTTTT	CSARTGGSEKLFF	TRBV20-1	TRBJ1-4
TGCAGTGCGATCCGGGACAGGGTATCCGGCAATCAGCCCCAGCATTTT	CSAIRDRVSGNQPQHF	TRBV20-1	TRBJ1-5
TGTGCCAGCAGCCTCTTAGTAAGCTCCTACGAGCAGTACTTC	CASSLLVSSYEQYF	TRBV13	TRBJ2-7
TGTGCCAGCTCGAGGCCAAGGGGGGTCGGGGAGGGCTATGGAAACACCATATATTTT	CASSRPRGVGEGYGNTIYF	TRBV28	TRBJ1-3
TGCGCCAGCAGTCCCCTTTCAGTCGCCCAGCACTTCTACGAGCAGTACTTC	CASSPLSVAQHFYEQYF	TRBV10-1	TRBJ2-7
TGTGCCTGGACAGGGAGGAGTGGGGCCAACGTCCTGACTTTC	CAWTGRSGANVLTF	TRBV6-5	TRBJ2-6
TGCGCCAGCAGGGCGGAGGGGGGGGTACATGAGCAGTTCTTC	CASRAEGGVHEQFF	TRBV10-1	TRBJ2-1
TGTGCCTGGAAGGAGCGGGACTATGGCTACACCTTC	CAWKERDYGYTF	TRBV30	TRBJ1-2
TGCATAGGGGGGGGGCGGCAGTACTTC	CIGGGRQYF	TRBV20-1	TRBJ2-7
TGTGCCAGTGAGGCTCTAGCGGGCAAGACTTACAATGAGCAGTTCTTC	CASEALAGKTYNEQFF	TRBV27	TRBJ2-1
TGTGCCAGCTCACAGAGGGAAGGGGGTAAAAGGTACAATGAGCAGTTCTTC	CASSQREGGKRYNEQFF	TRBV18	TRBJ2-1
TGTGCCTGGGTCCGGGACAGGCCAGGGGCCAACGTCCTGACTTTC	CAWVRDRPGANVLTF	TRBV30	TRBJ2-6
TGCGCCAGCAGTGGGTGGGGGTTCCGCTACGAGCAGTACTTC	CASSGWGFRYEQYF	TRBV10-2	TRBJ2-7
TGTGCCCCGGGACGGAAGAACACTGAAGCTTTCTTT	CAPGRKNTEAFF	TRBV6-5	TRBJ1-1
TGTGCCAGCAGTCCAGCCTCGGTTGGGGCTGACGAGCAGTACTTC	CASSPASVGADEQYF	TRBV28	TRBJ2-7
TGTGCCACTCAGGGACTAGCGGCGGACGAGCAGTACTTC	CATQGLAADEQYF	TRBV14	TRBJ2-7
TGTGCCAGCAGTGACAGGGGTTCCGAGCAGTACTTC	CASSDRGSEQYF	TRBV27	TRBJ2-7
TGTGCCAGCAGTTCAGAACGGGGCTACACCTTC	CASSSERGYTF	TRBV27	TRBJ1-2
TGCGCCAGCAGCCAAGGGCAGGGCGCGGAATTGCGGAGAGCCTTCAATCAGCCCCAGCATTTT	CASSQGQGAELRRAFNQPQHF	TRBV4-3	TRBJ1-5
TGTGCCAGCAGCATCGGTACTTGTTTCCAGCAGATTGGCTACACCTTC	CASSIGTCFQQIGYTF	TRBV7-9	TRBJ1-2
TGTGCCAGCAGTGAACGTCTTAGGGGCGGAATCTATGGCTACACCTTC	CASSERLRGGIYGYTF	TRBV6-1	TRBJ1-2
TGTGCCAGCAGCACAACTAGCGGGAGGGTTAATCAGCCCCAGCATTTT	CASSTTSGRVNQPQHF	TRBV13	TRBJ1-5
TGTGCCAGCAGCCTTTCAAATCCCGTTCTTCCCAGGGACACCTATGGCTACACCTTC	CASSLSNPVLPRDTYGYTF	TRBV5-6	TRBJ1-2
TGCGCCAGCCCTCACAGGGTCTACTTAAGCACAGATACGCAGTATTTT	CASPHRVYLSTDTQYF	TRBV10-1	TRBJ2-3
TGTGCCAGCAGTTACTCGAAAACCGGGACAGGTAAGAGCCTTGGAAACACCGGGGAGCTGTTTTTT	CASSYSKTGTGKSLGNTGELFF	TRBV6-5	TRBJ2-2
