TGCAGTGCTAGAGGGGGGACAGGGCCGGGTAGCACTGAAGCTTTCTTT	CSARGGTGPGSTEAFF	TRBV20-1	TRBJ1-1
TGTGCCACCCCTAGCGGGTCCTCCTACGAGCAGTACTTC	CATPSGSSYEQYF	TRBV24-1	TRBJ2-7
TGTGCCAGCAGCGCCCCCCCAAGGGCGGGGGGAAATGAAAAACTGTTTTTT	CASSAPPRAGGNEKLFF	TRBV7-3	TRBJ1-4
TGTGCCAGCAAGGAAACCCCGACAGGGAACACTGAAGCTTTCTTT	CASKETPTGNTEAFF	TRBV7-9	TRBJ1-1
TGCAGTGCTAGAGGAGAAGCGGAAACCAAACCCTACGAGCAGTACTTC	CSARGEAETKPYEQYF	TRBV20-1	TRBJ2-7
TGTGCCTGGACAGGGTACCACCAAGAGACCCAGTACTTC	CAWTGYHQETQYF	TRBV30	TRBJ2-5
TGTGCCAGCAGCGTCACGCGGAATTCACCCCTCCACTTT	CASSVTRNSPLHF	TRBV7-9	TRBJ1-6
TGTGCCAGCACCCCCCCGACAGGCACGAGCTACACCTTC	CASTPPTGTSYTF	TRBV7-2	TRBJ1-2
TGTGCCAGCAGCTTAACGCTGGACAGTGGGGCAAGGTATGGCTACACCTTC	CASSLTLDSGARYGYTF	TRBV7-3	TRBJ1-2
TGTGCCACCAGTGACAAGTCCCACGGTCTGACCTATGGCTACACCTTC	CATSDKSHGLTYGYTF	TRBV24-1	TRBJ1-2
TGCAGCGTTCGTTCCAGGGCGTTCAATTCACCCCTCCACTTT	CSVRSRAFNSPLHF	TRBV29-1	TRBJ1-6
TGTGCCAGCAGCCGGGTAGTCTGGAACACCGGGGAGCTGTTTTTT	CASSRVVWNTGELFF	TRBV4-2	TRBJ2-2
TGTGCCAGCACCCAGCCTCGGGGTTCACCCCTCCACTTT	CASTQPRGSPLHF	TRBV25-1	TRBJ1-6
TGCAGTGCGGAGTTTGGCTACACCTTC	CSAEFGYTF	TRBV20-1	TRBJ1-2
TGTGCCAGCGGGAGCACAGATACGCAGTATTTT	CASGSTDTQYF	TRBV6-4	TRBJ2-3
TGCGCCAGCAGGGGCAGGGGGATACTAGAAGAGCAGTACTTC	CASRGRGILEEQYF	TRBV10-1	TRBJ2-7
TGTGCCAGCAGCCCCACATGGGGGTTTGGAAACACCATATATTTT	CASSPTWGFGNTIYF	TRBV7-6	TRBJ1-3
TGTGCCTGGGAGGCAGGGGGGGAGGGTTCCTACAATGAGCAGTTCTTC	CAWEAGGEGSYNEQFF	TRBV30	TRBJ2-1
TGTGCCATTTGCGGGAGAAAAGGTTACAATGAGCAGTTCTTC	CAICGRKGYNEQFF	TRBV7-9	TRBJ2-1
TGTGCCAGTAGTGCGGGGGGGGGCTACGGCACAGATACGCAGTATTTT	CASSAGGGYGTDTQYF	TRBV19	TRBJ2-3
TGTGCCAGCAGCGAGGGGACAGGGGGAAGCCGGTATTTT	CASSEGTGGSRYF	TRBV7-3	TRBJ2-3
TGTGCCAGCAGTGACCCGGGGAAAAATTCACCCCTCCACTTT	CASSDPGKNSPLHF	TRBV6-1	TRBJ1-6
TGTGCCAGCAGCTTAGATAAACTAGGGGGACAGCGCGGCTCTGGAAACACCATATATTTT	CASSLDKLGGQRGSGNTIYF	TRBV11-2	TRBJ1-3
TGTGCCAGCAGAGCGGACCGGTTAGGGGATTCAGGGTTGAATGAGCAGTTCTTC	CASRADRLGDSGLNEQFF	TRBV2	TRBJ2-1
TGCGCCAGCAGGAGGCCGACAGGGCCTAAGAACTATGGCTACACCTTC	CASRRPTGPKNYGYTF	TRBV5-1	TRBJ1-2
TGTGCCAGCAGTGCTGGGGGAAGAGAGACCCAGTACTTC	CASSAGGRETQYF	TRBV6-4	TRBJ2-5
TGTGCCACCAGTGATTTCAGGGTAGCCTACAATGAGCAGTTCTTC	CATSDFRVAYNEQFF	TRBV24-1	TRBJ2-1
TGTGCCAGCAGCTTGTTTCCTCGAGGACTAGGGAATCAGCCCCAGCATTTT	CASSLFPRGLGNQPQHF	TRBV7-2	TRBJ1-5
TGCAGTGCGTTAGGGACTAGCGGGGGCGATACGCAGTATTTT	CSALGTSGGDTQYF	TRBV20-1	TRBJ2-3
TGTGCCAGCAGTGCGGAAGCGGCCTGCTACGAGCAGTACTTC	CASSAEAACYEQYF	TRBV12-3	TRBJ2-7
TGCAGTGCCCCACCCATGGACAGGGATCAGCCCCAGCATTTT	CSAPPMDRDQPQHF	TRBV20-1	TRBJ1-5
TGTGCCAGCAGTGACGACAGGGGGCCCACCTCTGAAGCTTTCTTT	CASSDDRGPTSEAFF	TRBV6-4	TRBJ1-1
TGTGCCAGCTCCTGTGGTGAAGCTTTCTTT	CASSCGEAFF	TRBV5-6	TRBJ1-1
TGTGCCAGCAGCTTAGAGACAGGGCCCCCCACCGGAAACACCATATATTTT	CASSLETGPPTGNTIYF	TRBV7-8	TRBJ1-3
TGTGCCAGCAGCAAAGGGCGGGGGGGGGGAAAGGGCTACACCTTC	CASSKGRGGGKGYTF	TRBV7-9	TRBJ1-2
TGTGCCAGCAGCTCCCATAGGGGGGTGGAGCAGTACTTC	CASSSHRGVEQYF	TRBV13	TRBJ2-7
TGTGCCAGCAGCCCGGGCGGACAGGGGGAAAAACTGTTTTTT	CASSPGGQGEKLFF	TRBV11-1	TRBJ1-4
TGCGCCAGCGGCGGGGACGAGGGATCTAATGAAAAACTGTTTTTT	CASGGDEGSNEKLFF	TRBV10-1	TRBJ1-4
TGTGCCTCGTGGACAGGACCAAACATTCAGTACTTC	CASWTGPNIQYF	TRBV5-6	TRBJ2-4
TGCAGTGCCCAGGGACCCGGGACTAGCGGGGGGGCGGGAAATGAGCAGTTCTTC	CSAQGPGTSGGAGNEQFF	TRBV20-1	TRBJ2-1
TGTGCCAGCAGCCAAGATTATACCCCCAGGGGGCCACTGCAGTTCTTC	CASSQDYTPRGPLQFF	TRBV14	TRBJ2-1
TGTGCCAGCTCACCAGGGCTAGGCAAAAACATTCAGTACTTC	CASSPGLGKNIQYF	TRBV18	TRBJ2-4
TGTGCCAGCACCAGGACAGAGCGCCAAGAGACCCAGTACTTC	CASTRTERQETQYF	TRBV9	TRBJ2-5
TGTGCCAGCAGCTTGGGACAGGTAGAGCCCCAGCATTTT	CASSLGQVEPQHF	TRBV7-3	TRBJ1-5
TGCAGTGCTAGATACCTAGGGACAGATACGCAGTATTTT	CSARYLGTDTQYF	TRBV20-1	TRBJ2-3
TGTGCCAGCAGCACAGGGGGCATTAGGGTTTATCGGAACACTGAAGCTTTCTTT	CASSTGGIRVYRNTEAFF	TRBV7-2	TRBJ1-1
TGCAGTGCACAGGGCAATGAGCAGTTCTTC	CSAQGNEQFF	TRBV20-1	TRBJ2-1
TGCGCCAGCAGCTTTACCGCCAGGGGCTATGGCTACACCTTC	CASSFTARGYGYTF	TRBV5-1	TRBJ1-2
TGTGCCAGCAGCTTGACGGCACTAGCGCCGGATTCCAATGAGCAGTTCTTC	CASSLTALAPDSNEQFF	TRBV5-6	TRBJ2-1
TGCGCCAGCCGTATGGAGGAGTTTACGGGTGAAGCTTTCTTT	CASRMEEFTGEAFF	TRBV10-1	TRBJ1-1
TGTGCCAGGGACAGGGAATGTTGGATCGGCTCGCAGCCCCAGCATTTT	CARDRECWIGSQPQHF	TRBV12-3	TRBJ1-5
TGTGCCATCAGTGAAAGACGCTTTGTGAATACTGGAAACACCATATATTTT	CAISERRFVNTGNTIYF	TRBV10-3	TRBJ1-3
TGTGCCTGGAGTGTACTAGAGGTGGGCCTTACGAACACCGGGGAGCTGTTTTTT	CAWSVLEVGLTNTGELFF	TRBV30	TRBJ2-2
TGTGCCAGCAGTGACTGGGGCCCCCCCAGCCGGAACACTGAAGCTTTCTTT	CASSDWGPPSRNTEAFF	TRBV6-4	TRBJ1-1
TGCAGCGACGGACAGGTTTCCGAGCAGTACTTC	CSDGQVSEQYF	TRBV29-1	TRBJ2-7
TGCGCCAGCAGTGACTCAGGGCACTACGAGCAGTACTTC	CASSDSGHYEQYF	TRBV5-1	TRBJ2-7
TGCGCCAGCAGCCCCAGGGCCCCTAACTATGGCTACACCTTC	CASSPRAPNYGYTF	TRBV4-1	TRBJ1-2
TGTGCCAGCAGTTTGGAAGTGGGGGGGTCCTATAATTCACCCCTCCACTTT	CASSLEVGGSYNSPLHF	TRBV6-5	TRBJ1-6
TGTGCCAGCAGCTTTAATTGGGCGGCCAATCAGCCCCAGCATTTT	CASSFNWAANQPQHF	TRBV7-2	TRBJ1-5
TGTGCCACCAGTGAGCCGGGACAGGGACCAAGGAAACTGTTTTTT	CATSEPGQGPRKLFF	TRBV24-1	TRBJ1-4
TGTGCCGCTGCCCGGACAGACAATGAGCAGTTCTTC	CAAARTDNEQFF	TRBV11-2	TRBJ2-1
TGTGCCAGCAGTCCAGGGTCACCCCTCCACTTT	CASSPGSPLHF	TRBV2	TRBJ1-6
TGCGCCAGCCCTCGGGGGGCGAACACCGGGGAGCTGTTTTTT	CASPRGANTGELFF	TRBV5-1	TRBJ2-2
TGTGCCAGCAGCGTAGGGGCGGGACTACCGCAGCCCCAGCATTTT	CASSVGAGLPQPQHF	TRBV9	TRBJ1-5
TGTGCCAGCAGCCTGACTAGGGTGCCGTACAATGAGCAGTTCTTC	CASSLTRVPYNEQFF	TRBV9	TRBJ2-1
TGTGCCAGCAGCATGGGACAGGGACGTAGCAATCAGCCCCAGCATTTT	CASSMGQGRSNQPQHF	TRBV5-5	TRBJ1-5
TGCAGTGCTACTCCATCCCCCCCGGGAGAGAACCAAGAGACCCAGTACTTC	CSATPSPPGENQETQYF	TRBV20-1	TRBJ2-5
TGTGCCAGCTCACCCCTTTATCACCCCTACGAGCAGTACTTC	CASSPLYHPYEQYF	TRBV18	TRBJ2-7
TGTGCCAGCAGTTTATGGGGGCCCCCAAATCAGCCCCAGCATTTT	CASSLWGPPNQPQHF	TRBV28	TRBJ1-5
TGCAGTGCTAAGCGGGGGAACCCTATTGCCTACGAGCAGTACTTC	CSAKRGNPIAYEQYF	TRBV20-1	TRBJ2-7
TGTGCCAGCAGCCGGCATCCCGCGCGCACAGATACGCAGTATTTT	CASSRHPARTDTQYF	TRBV11-1	TRBJ2-3
TGTGCCAGCAGCTTGGACCGGCAGATTAACTATGGCTACACCTTC	CASSLDRQINYGYTF	TRBV11-2	TRBJ1-2
TGTGCCAGCAGCTTAGGATTTCAGAAGCCTGAAAAACTGTTTTTT	CASSLGFQKPEKLFF	TRBV7-9	TRBJ1-4
TGTGCCAGCAGTGTAAACAGGTATGGCTACACCTTC	CASSVNRYGYTF	TRBV27	TRBJ1-2
TGCAACCCCGGGTCCCCCTCTCATTCACCCCTCCACTTT	CNPGSPSHSPLHF	TRBV20-1	TRBJ1-6
TGCAGTGCTAGATCCGGTCAGGGGCTGAGCAATCAGCCCCAGCATTTT	CSARSGQGLSNQPQHF	TRBV20-1	TRBJ1-5
TGTGCCAGCAGCCTTTTCCAGGAGTACTATGGCTACACCTTC	CASSLFQEYYGYTF	TRBV3-1	TRBJ1-2
TGCGCCAGCAGCAATGGTTGGGGGGACGAGCAGTTCTTC	CASSNGWGDEQFF	TRBV5-1	TRBJ2-1
TGCGCCAGAGTGGACTTAGGGGCGGAAAACATTCAGTACTTC	CARVDLGAENIQYF	TRBV4-3	TRBJ2-4
TGTGCCAGCAGTTTATTATCAGGGGGCGACGAGCAGTACTTC	CASSLLSGGDEQYF	TRBV27	TRBJ2-7
TGTGCCAGCAAAAGGGCGAGCTATGGCTACACCTTC	CASKRASYGYTF	TRBV9	TRBJ1-2
TGCATCAAGGGGTGGGTTACCCAGTACTTC	CIKGWVTQYF	TRBV20-1	TRBJ2-5
TGTGCCAGTGCTATATTAAGCGGACAGGGGGGTAGCTCCTACAATGAGCAGTTCTTC	CASAILSGQGGSSYNEQFF	TRBV19	TRBJ2-1
TGTGCCAGCCCCCCGGGACTAGGAATTAGCTCCTACGAGCAGTACTTC	CASPPGLGISSYEQYF	TRBV6-5	TRBJ2-7
TGCGCCAGCAGCCAAGAATGGCTGACAGGCGGGGGGCGAGAGACCCAGTACTTC	CASSQEWLTGGGRETQYF	TRBV4-3	TRBJ2-5
TGTGCCAGCAGCTTATACAGAAGCCCGCCGCGGGGGCACAGCAATCAGCCCCAGCATTTT	CASSLYRSPPRGHSNQPQHF	TRBV7-8	TRBJ1-5
TGTGCCAGCAGAAAAGCGGGAGGAGCCCGCGAGCAGTACTTC	CASRKAGGAREQYF	TRBV12-3	TRBJ2-7
TGTGCCAGCAGCGATGGGGGAGACGACGAGAACACTGAAGCTTTCTTT	CASSDGGDDENTEAFF	TRBV12-3	TRBJ1-1
TGTGCCAGCAGCTACGTCCCGGGGGGCTTAAATAGTCGGACCACAGATACGCAGTATTTT	CASSYVPGGLNSRTTDTQYF	TRBV11-2	TRBJ2-3
TGTGCCAGCAGTTATCGACAGGGAGGAGAGCAGTACTTC	CASSYRQGGEQYF	TRBV28	TRBJ2-7
TGTGCCAGCAAACGAATTCGCATTAGGTTAGGAGAAAAACTGTTTTTT	CASKRIRIRLGEKLFF	TRBV12-4	TRBJ1-4
TGTGCCAGCAGTGAAGGGGGTTATGAAGCTTTCTTT	CASSEGGYEAFF	TRBV6-2	TRBJ1-1
TGTGCCAGCAGTTATGTGGGGGGGGACAGGGGAGGGGCCCGTAATAGCAATCAGCCCCAGCATTTT	CASSYVGGDRGGARNSNQPQHF	TRBV6-6	TRBJ1-5
TGTGCCACCAGTGATTTGCTCAGAATAGGGCCAAGCAATCAGCCCCAGCATTTT	CATSDLLRIGPSNQPQHF	TRBV24-1	TRBJ1-5
TGTGCCAGCAGACTTAGGTTAAGCACCGGGGAGCTGTTTTTT	CASRLRLSTGELFF	TRBV6-6	TRBJ2-2
TGTGCCAGCAGCGTGTGCGACAGGGGGGGCTCCTACAATGAGCAGTTCTTC	CASSVCDRGGSYNEQFF	TRBV7-9	TRBJ2-1
TGTGCCAGCAGCCAAGATGAGAAGGGTAACTATGGCTACACCTTC	CASSQDEKGNYGYTF	TRBV3-1	TRBJ1-2
TGTGCCAGCCCGTCTACCGGGGAGCTGTTTTTT	CASPSTGELFF	TRBV6-4	TRBJ2-2
TGTGCCATTCCAGCGAAGGGACCGGGCTTGGAGCCGAAAGAGACCCAGTACTTC	CAIPAKGPGLEPKETQYF	TRBV12-3	TRBJ2-5
TGTGCCAGCAGTTTCCGACGGGGGCCAACTTGTACGCAGTATTTT	CASSFRRGPTCTQYF	TRBV27	TRBJ2-3
